base_fee_per_gas,block_time,gas_limit,gas_price,gas_used,max_fee_per_gas,max_priority_fee_per_gas,priority_fee_per_gas
165094807639,1642194503,67634,166594807639,67634,224037282277,1500000000,1500000000
65938785228,1643980649,60862,67438785228,56062,72722202402,1500000000,1500000000
89859741320,1644941765,343743,91359741320,343743,91628830702,1500000000,1500000000
401442227688,1642121070,55717,403382227688,50917,549210835959,1940000000,1940000000
181159196113,1642178594,55696,182659196113,50896,230112719194,1500000000,1500000000
33136692482,1644913780,55636,34636692482,50836,47345095292,1500000000,1500000000
97961952878,1641606708,331648,99461952878,331648,119908549427,1500000000,1500000000
52005234109,1648166661,336859,53505234109,336859,54067669480,1500000000,1500000000
114462127315,1641611787,49495,115962127315,49495,159288841033,1500000000,1500000000
112286932502,1642159532,64717,113786932502,64717,138208147912,1500000000,1500000000
138735574168,1642158434,55717,140235574168,50917,185187394478,1500000000,1500000000
28358109931,1648183742,316606,29858109931,316606,33267863380,1500000000,1500000000
118652139802,1641682151,55580,120152139802,50780,146173054434,1500000000,1500000000
74792409245,1641634413,55705,76292409245,50905,87097429692,1500000000,1500000000
74792409245,1641634413,331189,76792409245,331189,91021326879,2000000000,2000000000
63883747155,1641648496,67634,65383747155,62834,84274077278,1500000000,1500000000
58264862236,1649947820,326835,59764862236,320366,84152894398,1500000000,1500000000
69887604151,1643979443,67646,71387604151,62846,82378823342,1500000000,1500000000
117462032501,1643992794,67646,119462032501,62846,153245373337,2000000000,2000000000
65750543468,1641634242,340063,67250543468,340063,70431885903,1500000000,1500000000
62653072663,1641655363,325040,64153072663,325040,68960249913,1500000000,1500000000
34760851599,1649923636,55705,36260851599,50905,38562671533,1500000000,1500000000
88502945491,1643950059,330671,90002945491,330671,92870716209,1500000000,1500000000
134105158671,1642147121,60862,136105158671,56062,198177549575,2000000000,2000000000
33907065877,1649911462,54724,35557065877,49924,36200000000,1650000000,1650000000
60852510941,1649966676,67634,62623096561,62834,82979491472,1770585620,1770585620
60852510941,1649966676,48603,62677856941,43803,77304499025,1825346000,1825346000
99288229429,1649956370,67646,100788229429,62846,126398208607,1500000000,1500000000
26401539959,1649895933,64741,27901539959,59941,37437873614,1500000000,1500000000
73639238286,1649966949,326107,75159700403,326107,90220765635,1520462117,1520462117
156178479746,1643990767,55612,157678479746,55612,199565358422,1500000000,1500000000
187629459692,1641673177,54848,189417713200,50048,280892788855,1788253508,1788253508
115246539964,1641601511,67634,116746539964,62834,151507235592,1500000000,1500000000
122969457649,1642150707,60114,124469457649,55314,127538764748,1500000000,1500000000
116841344995,1641608915,60862,118341344995,56062,121370676298,1500000000,1500000000
69509574627,1641627480,333730,71009574627,333730,94340183975,1500000000,1500000000
69509574627,1641627480,334332,71009574627,334332,97240017294,1500000000,1500000000
188291819715,1642170958,66814,189791819715,57214,266102084030,1500000000,1500000000
29007626458,1649927722,60030,30507626458,60030,32015190553,1500000000,1500000000
137089430433,1643993443,60862,138589430433,56062,180396290329,1500000000,1500000000
123424712104,1641657029,67646,124924712104,62846,140357579039,1500000000,1500000000
115272812684,1641684499,122029,116772812684,122029,122678160034,1500000000,1500000000
134283851913,1642151241,60862,136636101913,56062,187926333895,2352250000,2352250000
27427888559,1648184205,55580,28927888559,55580,39535604728,1500000000,1500000000
77259073935,1649899980,55680,78759073935,50880,85739070680,1500000000,1500000000
142601076657,1642191661,319795,144101076657,319795,182628552258,1500000000,1500000000
186897551146,1642195047,67634,188397551146,62834,194030695475,1500000000,1500000000
47309435193,1648166640,321873,48809435193,321873,52338083528,1500000000,1500000000
109975766238,1641680738,326123,111475766238,326123,178331332487,1500000000,1500000000
81260371774,1641641168,52940,82760371774,48140,83442254592,1500000000,1500000000
132514771624,1642130844,67634,135014771624,62834,143289065218,2500000000,2500000000
32251534476,1649927443,60862,33751534476,60862,35616975482,1500000000,1500000000
64652136163,1649910164,60838,66152136163,56038,77824111192,1500000000,1500000000
108023990641,1641647990,327385,109523990641,327385,126529753060,1500000000,1500000000
126516618128,1642139102,67646,128016618128,62846,203056865185,1500000000,1500000000
201733222103,1642170908,60862,203233222103,56062,225679665444,1500000000,1500000000
155861895505,1641675352,54322,157361895505,49522,178761381259,1500000000,1500000000
81411196149,1641625383,55592,82911196149,50792,127706302578,1500000000,1500000000
136504723638,1642161166,60850,138004723638,56050,166677133110,1500000000,1500000000
38566798532,1648251989,328815,40066798532,328815,49825122659,1500000000,1500000000
43125900459,1644910289,316712,44625900459,316712,53838029319,1500000000,1500000000
151176496200,1641680074,67634,152676496200,62834,161912162195,1500000000,1500000000
36236449936,1649895469,54921,37736449936,50121,100000000000,1500000000,1500000000
24506233805,1649917199,55693,26058718805,50893,30934119403,1552485000,1552485000
48759579723,1644892194,55705,50259579723,50905,54937277378,1500000000,1500000000
166473931745,1642189336,67634,167973931745,67634,170000000000,1500000000,1500000000
135497122772,1642130959,60850,136997122772,56050,185550487058,1500000000,1500000000
36725551194,1649935454,59970,38225551194,55170,52966141958,1500000000,1500000000
74610216293,1643946085,55644,77110216293,55644,171973473512,2500000000,2500000000
160403616727,1642136138,67646,161903616727,62846,169938956397,1500000000,1500000000
108074556074,1643996577,330545,109574556074,330545,118322528104,1500000000,1500000000
191514232065,1642180344,60850,193014232065,60850,226400203175,1500000000,1500000000
173484651842,1642173662,67634,174984651842,67634,242314430935,1500000000,1500000000
188103050909,1642187459,60838,189603050909,60838,263713835860,1500000000,1500000000
55082763975,1649970432,67634,56582763975,67634,61390740167,1500000000,1500000000
77356493227,1644944797,52916,78856493227,52916,89081755063,1500000000,1500000000
121770078833,1641657655,67646,123270078833,62846,133218203334,1500000000,1500000000
124084957992,1642190358,55636,126584957992,55636,259079027670,2500000000,2500000000
41417833783,1649901488,60862,42917833783,56062,50700366134,1500000000,1500000000
81772547274,1643939827,329913,83272547274,329913,116800287313,1500000000,1500000000
42387942723,1649901434,56492,43887942723,51692,62497556682,1500000000,1500000000
41418184730,1649967323,66862,42918184730,62062,54922453299,1500000000,1500000000
201965693759,1642180545,60874,203465693759,56074,211927705232,1500000000,1500000000
201965693759,1642180545,60874,205000000000,56074,,,
33273721768,1649916076,60838,34773721768,56038,41227866182,1500000000,1500000000
48495300635,1649969809,67622,49995300635,67622,64765094340,1500000000,1500000000
44350008416,1648173783,334356,46350008416,334356,57701728218,2000000000,2000000000
99105288152,1642154292,54921,100605288152,50121,124071028955,1500000000,1500000000
162938157782,1642172887,67622,164763503782,67622,220509884764,1825346000,1825346000
162938157782,1642172887,55648,165438157782,55648,311613152362,2500000000,2500000000
146168807426,1642161687,327982,147668807426,327982,194847765748,1500000000,1500000000
74908181070,1643974684,336899,76408181070,336899,102499269050,1500000000,1500000000
148987952570,1642142074,55705,150487952570,50905,206256833542,1500000000,1500000000
40137429390,1649912327,55717,41637429390,50917,49284733277,1500000000,1500000000
48750619790,1649903918,54676,49470112950,49876,,,
107582986498,1643978929,55632,109082986498,55632,115513312473,1500000000,1500000000
173777243043,1641670010,60838,175277243043,60838,200422219612,1500000000,1500000000
198513617892,1642180591,67634,200013617892,62834,254323423617,1500000000,1500000000
35967046598,1648233238,333690,46708762715,333690,,,
27483248252,1644925568,71175,37483248252,59905,76753171352,10000000000,10000000000
659927964262,1642122130,331155,662304464262,331155,708154288589,2376500000,2376500000
57841678035,1649949234,54748,59341678035,49948,80906614098,1500000000,1500000000
121117285737,1643990150,311088,122617285737,311088,135996097733,1500000000,1500000000
121117285737,1643990150,55717,122617285737,50917,135996097733,1500000000,1500000000
60306689398,1643963160,326856,61806689398,326856,81332775543,1500000000,1500000000
153550799187,1642146762,67634,155050799187,67634,192561121098,1500000000,1500000000
23945327144,1648209717,67646,25445327144,62846,31591619359,1500000000,1500000000
44230396122,1649901025,67634,45730396122,62834,63131025258,1500000000,1500000000
51339657710,1649940731,67634,52839657710,62834,62258780645,1500000000,1500000000
59561037571,1649946735,63200,61061037571,63200,110391989874,1500000000,1500000000
133147752647,1641662933,67646,134647752647,62846,182487057605,1500000000,1500000000
83781978346,1641645885,66718,85281978346,66718,102283642949,1500000000,1500000000
47542784829,1649955497,55592,70916907909,50792,,,
52802665359,1649959261,60862,54302665359,56062,58239216430,1500000000,1500000000
175185553510,1643995022,337470,176685553510,337470,209535751393,1500000000,1500000000
174022901637,1642175406,55580,175522901637,50780,202605958250,1500000000,1500000000
31145053440,1648217668,67646,32645053440,67646,46004926512,1500000000,1500000000
185788774068,1642180110,60850,187288774068,56050,263827917373,1500000000,1500000000
30200854661,1648212508,67646,31850854661,62846,33000000000,1650000000,1650000000
41790361454,1649969770,66706,43290361454,66706,64035707012,1500000000,1500000000
153930185641,1642127719,55705,155430185641,50905,229115049305,1500000000,1500000000
40043901000,1649895494,51428,41543901000,51428,73972899872,1500000000,1500000000
162413271784,1642191450,333201,163913271784,333201,179538223138,1500000000,1500000000
186613203053,1642197983,56516,188613203053,51716,216134547848,2000000000,2000000000
35330947225,1648176076,60862,36830947225,56062,51640689229,1500000000,1500000000
93161584725,1649965201,67634,94661584725,67634,120840359673,1500000000,1500000000
128668399811,1643932923,55648,131168399811,55648,276522504796,2500000000,2500000000
45341709519,1644909868,67646,46841709519,62846,53838331039,1500000000,1500000000
34647838327,1644908168,337478,36147838327,337478,46721919627,1500000000,1500000000
58324086776,1644890383,337466,59824086776,337466,73162528943,1500000000,1500000000
79825017056,1641630106,336239,81325017056,336239,84564953748,1500000000,1500000000
89093811409,1641646087,327345,90593811409,327345,118486326219,1500000000,1500000000
127156619342,1641656168,67634,128656619342,62834,164316213534,1500000000,1500000000
33281938910,1649912507,60862,34281938910,56062,40000000000,1000000000,1000000000
144355015334,1641680063,63825,145855015334,59025,151031652758,1500000000,1500000000
118793505991,1641677138,333718,120293505991,333718,148086937425,1500000000,1500000000
232659391894,1642125230,55705,234159391894,50905,312358454342,1500000000,1500000000
138869422552,1642148051,328016,140369422552,328016,175563750152,1500000000,1500000000
20445862270,1649933066,60850,21945862270,56050,25249421180,1500000000,1500000000
27985813654,1649922788,340629,29485813654,340629,40120750652,1500000000,1500000000
64195088006,1644961427,307058,65255733637,307058,65255733637,1500000000,1060645631
207593457618,1641658413,334276,209093457618,334276,266944833289,1500000000,1500000000
551734816717,1642119589,67622,554087796717,67622,767566570009,2352980000,2352980000
27216465461,1649937117,66766,28716465461,66766,35036423380,1500000000,1500000000
154964222491,1643995388,323067,156464222491,316598,156671145823,1500000000,1500000000
77202153407,1641621934,55705,78702153407,50905,90816516887,1500000000,1500000000
171778683475,1642195060,319767,173278683475,319767,175000000000,1500000000,1500000000
171778683475,1642195060,334350,173278683475,334350,175532791897,1500000000,1500000000
30248331204,1649924782,66754,31748331204,61954,44577260454,1500000000,1500000000
37456432746,1649971904,66730,38956432746,66730,50266939682,1500000000,1500000000
62041850698,1644954918,66754,63541850698,61954,89926307595,1500000000,1500000000
196037820858,1641670917,60850,197537820858,56050,206357129958,1500000000,1500000000
150199739373,1642138462,40838,151609739373,40838,198473504510,1410000000,1410000000
191399413659,1641663414,52916,192899413659,48116,219183033852,1500000000,1500000000
178189501298,1642171975,60862,179689501298,56062,219120762753,1500000000,1500000000
30718167704,1648215851,54332,32218167704,49532,44563680878,1500000000,1500000000
31950346989,1649914825,55592,33684089556,50792,,,
84443094613,1641638468,60850,85943094613,60850,108063080713,1500000000,1500000000
170420066488,1642177981,67634,171920066488,62834,203051793838,1500000000,1500000000
51599386913,1648237509,67634,53099386913,62834,68347809597,1500000000,1500000000
72118613635,1641637575,55705,73618613635,50905,88339605452,1500000000,1500000000
49493636811,1649949262,59946,50993636811,55146,71161873074,1500000000,1500000000
119307285152,1643995736,60850,120807285152,56050,123608123538,1500000000,1500000000
119307285152,1643995736,67634,120807285152,62834,123608123538,1500000000,1500000000
81777299154,1641650716,60850,83277299154,56050,108977353864,1500000000,1500000000
75193611850,1641626409,67634,76693611850,67634,104640154969,1500000000,1500000000
21623878111,1648194367,319745,23123878111,319745,27441416467,1500000000,1500000000
27428476605,1649925147,55592,28928476605,50792,35633970325,1500000000,1500000000
125461899719,1642145345,60838,127461899719,60838,201236781063,2000000000,2000000000
158133613647,1642181497,60850,159633613647,56050,204997466023,1500000000,1500000000
81972841047,1641610682,60850,83472841047,56050,92587908458,1500000000,1500000000
145156529609,1642182572,55648,147656529609,55648,318395048402,2500000000,2500000000
155860712258,1642171811,67646,157360712258,62846,171280998224,1500000000,1500000000
23427640353,1648170416,328252,25000000000,328252,25000000000,1881800000,1572359647
144349707114,1642146047,67646,145849707114,62846,155000000000,1500000000,1500000000
31271520786,1649898984,64741,32771520786,59941,42670779692,1500000000,1500000000
168935195599,1642183781,67634,170435195599,62834,188463129013,1500000000,1500000000
54159961316,1649967450,49571,55659961316,44771,66346708079,1500000000,1500000000
98482811416,1641604151,60850,99982811416,56050,123351261007,1500000000,1500000000
280106349423,1642176524,55717,282046349423,50917,377267720017,1940000000,1940000000
37215305801,1648218351,55681,38715305801,55681,48608273794,1500000000,1500000000
67229081123,1641650146,60850,68729081123,56050,73305305220,1500000000,1500000000
111556570802,1641618639,54848,113056570802,50048,129123478107,1500000000,1500000000
115804570269,1642168271,64741,117304570269,59941,167094856684,1500000000,1500000000
74877704409,1643941393,321883,76377704409,321883,88000000000,1500000000,1500000000
55843724508,1641635551,64729,57843724508,59929,82677614605,2000000000,2000000000
137733718784,1641659190,316566,139733718784,316566,212356035363,2000000000,2000000000
207840162122,1642203381,55592,209340162122,50792,249385508993,1500000000,1500000000
159474985852,1642186906,56504,160974985852,51704,178699145023,1500000000,1500000000
52646852061,1643973670,59934,54146852061,59934,60000133907,1500000000,1500000000
105083912705,1641656032,66754,106583912705,61954,113719174750,1500000000,1500000000
180426429107,1641678082,55693,181926429107,50893,207349096862,1500000000,1500000000
25110809417,1649938968,60874,26610809417,56074,30223030983,1500000000,1500000000
62427357644,1649900518,55668,63927357644,50868,74704899898,1500000000,1500000000
117982452239,1643986249,64729,119482452239,59929,149089347329,1500000000,1500000000
87562621299,1641623855,60862,89062621299,56062,117254054817,1500000000,1500000000
105929490382,1641661304,60862,107429490382,56062,119651295552,1500000000,1500000000
130700531091,1642147179,54739,132200531091,49939,153060545279,1500000000,1500000000
125276952738,1642137141,54848,126776952738,50048,171120274382,1500000000,1500000000
53202319769,1649951545,67634,54702319769,62834,59654624610,1500000000,1500000000
51067906369,1644928598,60850,52567906369,56050,54374871118,1500000000,1500000000
48099071370,1644901694,340073,49599071370,340073,57069406933,1500000000,1500000000
87085483289,1641606687,328680,88585483289,328680,155108857212,1500000000,1500000000
137311824419,1649963206,343779,138811824419,343779,184603172858,1500000000,1500000000
25075004288,1649932286,60862,26575004288,56062,31629224635,1500000000,1500000000
186910870241,1642178042,67634,188410870241,67634,229607970274,1500000000,1500000000
144427107413,1642148847,59934,145927107413,55134,149000000000,1500000000,1500000000
97054601602,1643937030,55648,99554601602,55648,227445470640,2500000000,2500000000
56600782215,1643967816,334350,58100782215,334350,69563188618,1500000000,1500000000
134123180479,1642179585,60838,135623180479,60838,178427626444,1500000000,1500000000
57648714485,1649946030,60926,59148714485,60926,66942662978,1500000000,1500000000
30027948566,1649913743,60850,31527948566,60850,36732551788,1500000000,1500000000
33354252151,1649923599,67710,34854252151,67710,42072536773,1500000000,1500000000
33354252151,1649923599,67634,34854252151,62834,36707725188,1500000000,1500000000
107982890067,1643989164,54861,110482890067,54861,215159354268,2500000000,2500000000
144912095300,1642185627,59934,146412095300,59934,174147563967,1500000000,1500000000
144912095300,1642185627,66742,146412095300,61942,182118947568,1500000000,1500000000
23187857969,1648203954,67634,25187857969,62834,35411003395,2000000000,2000000000
34978509116,1649912495,67634,36478509116,67634,48996057605,1500000000,1500000000
60001319390,1649968091,67646,61501319390,62846,80261962630,1500000000,1500000000
60001319390,1649968091,67646,61501319390,67646,78490315447,1500000000,1500000000
78595184675,1649956575,329218,80095184675,329218,82258860170,1500000000,1500000000
157661918299,1642193322,60862,205000000000,56062,,,
162639453361,1642130682,60850,164139453361,56050,187975186233,1500000000,1500000000
38005105514,1648240923,336863,39330505514,336863,39980110544,1325400000,1325400000
77899720791,1643945109,340021,79399720791,340021,104969257272,1500000000,1500000000
170543504545,1641664776,316604,172043504545,316604,243860501615,1500000000,1500000000
266763452845,1642124643,67646,268263452845,62846,279428491538,1500000000,1500000000
28902623818,1649908390,63200,30402623818,63200,59257684780,1500000000,1500000000
129777943378,1643997229,67622,131277943378,67622,180132632980,1500000000,1500000000
36715604063,1644915339,54296,38715604063,49496,61653444528,2000000000,2000000000
106979400789,1643989815,54861,109479400789,54861,231276327692,2500000000,2500000000
91854041233,1641655072,60838,93354041233,60838,122446791099,1500000000,1500000000
77843107473,1641655454,60850,79343107473,60850,95915868714,1500000000,1500000000
33837887932,1648217815,319741,35337887932,319741,39870119740,1500000000,1500000000
26919496778,1649934282,55705,28419496778,50905,31411561683,1500000000,1500000000
137536484513,1642196586,60862,139036484513,56062,176184049663,1500000000,1500000000
30587082582,1648207166,67634,32087082582,67634,45935343609,1500000000,1500000000
26657888545,1649905625,60850,28157888545,56050,38629507739,1500000000,1500000000
119515658191,1642188397,55693,121015658191,50893,208587120378,1500000000,1500000000
127934056930,1642141856,320785,129434056930,320785,133354097964,1500000000,1500000000
41725907429,1649973737,67634,42634856263,62834,42634856263,1410000000,908948834
32784471855,1649909892,67634,34284471855,67634,40421151282,1500000000,1500000000
63078528789,1643977097,337496,64578528789,337496,81612894970,1500000000,1500000000
113331063632,1642146924,60862,114831063632,56062,125000000000,1500000000,1500000000
72335453154,1641645101,60862,73835453154,56062,84111628400,1500000000,1500000000
103041306915,1642173912,319785,105000000000,319785,105000000000,2000000000,1958693085
34205165176,1649897126,340663,35705165176,340663,40908699370,1500000000,1500000000
34205165176,1649897126,340081,35705165176,340081,40908699370,1500000000,1500000000
73356161333,1649952224,55580,74856161333,55580,101361273385,1500000000,1500000000
50024233635,1649894428,59970,51524233635,55170,60836167019,1500000000,1500000000
67931853745,1644954404,67646,69431853745,62846,70447343862,1500000000,1500000000
90584513573,1641624394,67646,92084513573,67646,111947726299,1500000000,1500000000
76592013835,1641627451,54896,77000000000,50096,77000000000,1000000000,407986165
84777320679,1649960620,67722,86277320679,62922,123020071269,1500000000,1500000000
74235696486,1641622576,64741,79235696486,59941,115995020624,5000000000,5000000000
40141890259,1648219565,67634,41641890259,62834,48130365953,1500000000,1500000000
86741992558,1641644748,60850,88241992558,56050,97636410979,1500000000,1500000000
181058868804,1642179458,67622,182558868804,67622,186695255757,1500000000,1500000000
198101256054,1642180064,67634,199601256054,67634,211523486420,1500000000,1500000000
116423335123,1642193036,60862,117923335123,56062,173159352064,1500000000,1500000000
186859025231,1642198356,67634,188359025231,62834,236409836665,1500000000,1500000000
54290511625,1649959426,60862,55790511625,56062,71981751572,1500000000,1500000000
66931233535,1643957226,60850,68431233535,56050,84300991829,1500000000,1500000000
96897851518,1641613747,322915,98397851518,322915,104236990819,1500000000,1500000000
137527953696,1641675993,316600,139027953696,316600,153479030842,1500000000,1500000000
153539338908,1642181403,60850,154949338908,56050,155700689674,1410000000,1410000000
24292327302,1648194930,56604,25792327302,51804,26634734642,1500000000,1500000000
47438489243,1649971306,60862,48938489243,56062,60145671289,1500000000,1500000000
132906718123,1641669237,333708,134556718123,333708,135000000000,1650000000,1650000000
172725661835,1642202558,122041,174225661835,122041,207065645657,1500000000,1500000000
92281636581,1641623808,54860,92661881624,54860,92661881624,1500000000,380245043
155228739337,1642191971,66730,156570080613,66730,156570080613,1500000000,1341341276
207734077456,1641658387,330477,209234077456,330477,262576592899,1500000000,1500000000
42925172252,1649915120,338344,44925172252,338344,57938163873,2000000000,2000000000
517409926497,1642120652,67646,519669027397,62846,642305611439,2259100900,2259100900
147114212577,1642175032,48579,148614212577,48579,189208877459,1500000000,1500000000
180227493794,1642186421,320402,181727493794,320402,213489041194,1500000000,1500000000
61144725543,1643972217,62139,62644725543,57339,84970511817,1500000000,1500000000
115655527184,1642154704,313395,117155527184,313395,117557982358,1500000000,1500000000
140647741177,1642140193,59970,142147741177,55170,148279183702,1500000000,1500000000
117748058442,1642161588,52842,119248058442,48042,126067195732,1500000000,1500000000
101140502028,1641618829,317326,102640502028,317326,136636228649,1500000000,1500000000
101140502028,1641618829,55592,102640502028,55592,140125869370,1500000000,1500000000
37042985300,1649978794,323580,38542985300,323580,41587341963,1500000000,1500000000
23765765567,1649927184,52396,25265765567,42796,31626660059,1500000000,1500000000
205224017190,1641665144,60862,206724017190,56062,229527294934,1500000000,1500000000
133215370530,1642174110,60850,163000000000,60850,,,
142872132663,1642146193,330002,144372132663,330002,174613560990,1500000000,1500000000
169541054258,1642193392,60850,171041054258,56050,208768877773,1500000000,1500000000
182366145764,1642127551,67646,184366145764,62846,271132608374,2000000000,2000000000
22528981065,1649928474,48627,24028981065,43827,35139448719,1500000000,1500000000
52442480444,1649969037,67646,54442480444,62846,68795789799,2000000000,2000000000
22136452627,1649930490,52928,23636452627,48128,34000000000,1500000000,1500000000
122710639038,1642158486,60850,124210639038,56050,191807959154,1500000000,1500000000
331698262290,1642176411,67646,333780692302,62846,396083642078,2082430012,2082430012
28210545107,1649940369,343221,29710545107,343221,38196607563,1500000000,1500000000
95667912944,1643992494,55612,97167912944,55612,129425907525,1500000000,1500000000
95667912944,1643992494,55648,98167912944,55648,197841126254,2500000000,2500000000
48147133511,1644892743,67634,49647133511,67634,52851842442,1500000000,1500000000
37492238274,1644917880,55705,38992238274,50905,54155583327,1500000000,1500000000
74337684985,1641651698,64741,75837684985,59941,93615788937,1500000000,1500000000
427923186543,1642119923,60862,430228391543,56062,500000000000,2305205000,2305205000
151194995965,1642128953,60850,152694995965,60850,251447734212,1500000000,1500000000
48501172589,1648237611,319777,51000000000,319777,51000000000,3300000000,2498827411
61232874158,1649979273,63188,62732874158,63188,110373573272,1500000000,1500000000
97791211537,1643987629,319939,99291211537,319939,138870141650,1500000000,1500000000
117074366058,1641683688,67634,128574366058,67634,158643661017,11500000000,11500000000
24196844315,1648170773,317288,25000000000,317288,25000000000,1000000000,803155685
155321412802,1642131528,55693,156821412802,50893,175271851397,1500000000,1500000000
52831513452,1649970784,55680,54331513452,50880,68110640975,1500000000,1500000000
50596375439,1649965685,330511,52096375439,330511,72635016970,1500000000,1500000000
107241998756,1642159636,66766,108741998756,61966,156898476193,1500000000,1500000000
43121125249,1648244616,323050,44621125249,323050,49069468318,1500000000,1500000000
254281028496,1642124412,54322,255781028496,54322,256981249602,1500000000,1500000000
68724104919,1649955463,49583,70224104919,49583,88709602908,1500000000,1500000000
30096401965,1649907714,333684,32096401965,245009,40100271681,2000000000,2000000000
66236121345,1649946459,55717,68236121345,50917,88391317725,2000000000,2000000000
131163705730,1642148931,316590,132663705730,316590,154972701820,1500000000,1500000000
160867568103,1641674278,60862,162367568103,56062,228413054890,1500000000,1500000000
150893281304,1642184082,49507,152393281304,44707,191091124088,1500000000,1500000000
430501468297,1642120776,54836,432563288693,54836,511070866979,2061820396,2061820396
180226548674,1642204460,54969,181726548674,50169,196002556037,1500000000,1500000000
91997795987,1643955006,60850,93497795987,56050,115024462802,1500000000,1500000000
85347288267,1641605050,319799,86847288267,319799,109471485425,1500000000,1500000000
32564775304,1649977856,336865,34064775304,336865,36000000000,1500000000,1500000000
50647862760,1643971303,330507,52147862760,330507,80372001859,1500000000,1500000000
59574185074,1643963268,54861,62074185074,54861,123272642552,2500000000,2500000000
161881195210,1642183332,55648,164381195210,55648,356841048464,2500000000,2500000000
167868301603,1642142382,67646,169368301603,62846,219318700878,1500000000,1500000000
168031111234,1642173522,55592,169531111234,50792,215166932935,1500000000,1500000000
168031111234,1642173522,55648,170531111234,55648,301235781574,2500000000,2500000000
64162716024,1649957398,55592,65662716024,50792,70938464310,1500000000,1500000000
78409177543,1644956816,55804,80409177543,55804,95008419007,2000000000,2000000000
254349156390,1642169461,305945,256190953285,305945,259677665690,1841796895,1841796895
41076289279,1644921867,55636,42576289279,50836,52968568680,1500000000,1500000000
137176763216,1642196232,49483,138676763216,44683,188551174188,1500000000,1500000000
156882241143,1642174060,339999,158532241143,339999,173423234258,1650000000,1650000000
173084440803,1642176839,60850,174584440803,60850,185319550747,1500000000,1500000000
182145878429,1642178317,55644,183645878429,55644,240406390525,1500000000,1500000000
27487057329,1649929246,55717,28987057329,50917,31607643589,1500000000,1500000000
27487057329,1649929246,48579,28987057329,48579,31607643589,1500000000,1500000000
130870258654,1641683183,66802,132370258654,62002,143167472054,1500000000,1500000000
45695535207,1649950570,60950,47195535207,56150,61173608524,1500000000,1500000000
91567639702,1641652779,331141,93067639702,331141,137968255137,1500000000,1500000000
155329512594,1642153279,60850,156829512594,56050,198267791397,1500000000,1500000000
249503747189,1642125641,60862,251003747189,56062,260714221640,1500000000,1500000000
169916789075,1642139033,60838,171135705492,56038,171135705492,1410000000,1218916417
122608429046,1642189597,337514,124108429046,337514,156138803293,1500000000,1500000000
203393956394,1642177199,60850,204893956394,56050,263482237509,1500000000,1500000000
28668154698,1648201254,336859,30168154698,336859,30716752548,1500000000,1500000000
139572461151,1641662544,319321,141072461151,319321,177694941275,1500000000,1500000000
97781196536,1641642624,60850,99281196536,56050,124000674569,1500000000,1500000000
171122641578,1642177768,55696,172622641578,50896,220323488630,1500000000,1500000000
37746009232,1649941141,310281,39246009232,310281,53011808959,1500000000,1500000000
25463169749,1649932469,67622,26963169749,67622,29370442890,1500000000,1500000000
75334327677,1643962828,67634,77334327677,62834,103984072268,2000000000,2000000000
106439610144,1641616833,60862,107939610144,56062,131301746904,1500000000,1500000000
155164847625,1642187264,67634,156664847625,67634,212867292978,1500000000,1500000000
23775849391,1649926230,59982,25275849391,59982,35407643045,1500000000,1500000000
66149004586,1649956466,64717,68149004586,59917,105515610551,2000000000,2000000000
112104635594,1641600096,60862,113604635594,56062,135636075283,1500000000,1500000000
80515028039,1641627678,322947,82015028039,322947,113293645725,1500000000,1500000000
386956910550,1642121160,60850,388782256550,56050,487101252658,1825346000,1825346000
27091479676,1649940127,67634,28591479676,62834,30000000000,1500000000,1500000000
130229529402,1643935058,55632,132729529402,55632,280946696376,2500000000,2500000000
112958437760,1641685472,67634,114458437760,62834,129022342397,1500000000,1500000000
178843129239,1641674996,60850,180343129239,56050,182952691555,1500000000,1500000000
135751613115,1642148899,337502,137251613115,337502,157427068528,1500000000,1500000000
44914423964,1649967857,67634,54914423964,62834,300000000000,10000000000,10000000000
183977784470,1642178090,67634,185477784470,67634,235138587802,1500000000,1500000000
171478136810,1642198873,67622,172978136810,67622,250033682097,1500000000,1500000000
33360963326,1649931173,67634,34860963326,67634,36115438022,1500000000,1500000000
111086063231,1641656950,67634,112586063231,62834,136549340673,1500000000,1500000000
30757593844,1649895596,67634,32257593844,62834,42724521973,1500000000,1500000000
159231939504,1641668129,67646,160731939504,62846,194108632730,1500000000,1500000000
160057606972,1641662467,313421,161557606972,313421,210771446895,1500000000,1500000000
175461596479,1642195451,67634,176961596479,62834,225014956705,1500000000,1500000000
150469952089,1642181445,60862,151969952089,56062,188515877329,1500000000,1500000000
59262802334,1649902488,55592,79000000000,50792,,,
72327643441,1643965097,310846,73827643441,310846,88414496384,1500000000,1500000000
185957085951,1642203516,55648,188457085951,55648,402713293036,2500000000,2500000000
141570689653,1642174126,316580,143070689653,316580,209260378339,1500000000,1500000000
79588140905,1649963553,67634,81088140905,67634,110231625908,1500000000,1500000000
182207765828,1643988789,60850,183707765828,56050,210612171875,1500000000,1500000000
53070047111,1643964879,60838,54570047111,56038,66126061409,1500000000,1500000000
118055170528,1641654062,67646,119555170528,62846,149651618425,1500000000,1500000000
69095491602,1641629696,67634,70595491602,62834,93215502795,1500000000,1500000000
130431266174,1642152073,60862,131931266174,56062,158405118437,1500000000,1500000000
39006274759,1648243944,323660,40506274759,323660,42627712244,1500000000,1500000000
38751460561,1649912551,60850,40251460561,60850,47087257355,1500000000,1500000000
67623466607,1649962328,67622,69123466607,62822,84099266288,1500000000,1500000000
64453311975,1641643977,55705,65953311975,50905,69691060424,1500000000,1500000000
33136749892,1649927914,55717,36136749892,50917,57249276985,3000000000,3000000000
47931943134,1649941631,67646,49431943134,62846,50414380864,1500000000,1500000000
47931943134,1649941631,60938,49431943134,56138,50414380864,1500000000,1500000000
36117309331,1648241901,319751,37617309331,319751,46148434298,1500000000,1500000000
54607872182,1649948651,313427,56107872182,313427,72218064445,1500000000,1500000000
101460416273,1641609048,336845,102960416273,336845,146966084733,1500000000,1500000000
132857939423,1649956108,52360,134747154280,52360,151549447683,1889214857,1889214857
37809276485,1649906824,54921,39691076485,50121,200000000000,1881800000,1881800000
191022171193,1642194658,60006,192522171193,55206,226526174049,1500000000,1500000000
71583624969,1649952237,66754,73083624969,66754,96885901547,1500000000,1500000000
78795110370,1641654772,60850,80295110370,56050,107749017512,1500000000,1500000000
215156449414,1642129579,67646,216656449414,62846,229938045725,1500000000,1500000000
17896545751,1649928451,66778,21583505384,66778,,,
17896545751,1649928451,67634,22674041516,62834,,,
79202546241,1649945810,54861,80461084598,50061,80461084598,2000000000,1258538357
80825970594,1644888959,67646,82325970594,62846,105369710740,1500000000,1500000000
102396597008,1642159487,55636,103896597008,50836,120767600320,1500000000,1500000000
102396597008,1642159487,67646,103896597008,62846,110935236920,1500000000,1500000000
36951034074,1649913308,60838,38451034074,60838,42278544203,1500000000,1500000000
173088811556,1642197085,55648,175588811556,55648,367513320310,2500000000,2500000000
109913525115,1641600978,60850,111413525115,56050,118998878674,1500000000,1500000000
146145381708,1642134348,67634,147645381708,62834,171316353238,1500000000,1500000000
23403379148,1648201852,67634,24903379148,62834,26848957138,1500000000,1500000000
22689294694,1648194385,337474,24189294694,337474,25529545964,1500000000,1500000000
25902354648,1649928061,54825,27402354648,50025,35164794654,1500000000,1500000000
128042136763,1644966766,333636,129542136763,333636,169739261142,1500000000,1500000000
177548246271,1642198040,67646,179048246271,62846,219816501348,1500000000,1500000000
31070512823,1649929367,60850,32570512823,60850,36245506053,1500000000,1500000000
50199975878,1641635528,336829,51609975878,336829,52000000000,1410000000,1410000000
182486376219,1642178030,55648,184986376219,55648,353070925778,2500000000,2500000000
26858105145,1648198560,55580,28358105145,50780,34511919434,1500000000,1500000000
239360573332,1642125646,60862,241785573332,56062,370930995565,2425000000,2425000000
72909995981,1648227079,60862,74409995981,56062,92747329710,1500000000,1500000000
34950133205,1644919128,67634,36450133205,67634,41812594704,1500000000,1500000000
71424994164,1641616617,310273,74000000000,310273,,,
127874653663,1642163984,67622,129374653663,67622,140595877169,1500000000,1500000000
323821595723,1642168847,316151,326173845723,316151,341101749414,2352250000,2352250000
34209789685,1648215778,331147,35709789685,331147,48720010067,1500000000,1500000000
49084922363,1648173820,334320,50584922363,334320,59434128930,1500000000,1500000000
60329166784,1649951583,54884,61829166784,54884,68002899712,1500000000,1500000000
111937202698,1641609580,60850,113437202698,56050,133713023319,1500000000,1500000000
39216322530,1648240560,320459,40716322530,320459,52142427993,1500000000,1500000000
74536901718,1643957065,67634,76036901718,62834,89222163215,1500000000,1500000000
38545175939,1644921522,327289,39955175939,327289,41924544222,1410000000,1410000000
102040035485,1641609191,320475,103540035485,320475,114891439312,1500000000,1500000000
102040035485,1641609191,67646,103540035485,62846,118767924592,1500000000,1500000000
76139662762,1648221180,60850,77639662762,56050,90631665394,1500000000,1500000000
61094920785,1648222298,54332,62594920785,49532,79085444274,1500000000,1500000000
126802636983,1642199020,67646,128302636983,62846,162202806283,1500000000,1500000000
156201440068,1642200293,67646,157701440068,62846,191783170530,1500000000,1500000000
141422756829,1642200357,66778,142922756829,61978,206079039628,1500000000,1500000000
154549845195,1642145711,64705,156049845195,59905,165957595610,1500000000,1500000000
63768660430,1648229234,67646,65268660430,62846,72364211972,1500000000,1500000000
81138243797,1649942701,66814,82638243797,62014,89238517080,1500000000,1500000000
23848350557,1649937106,67646,25348350557,62846,29166566062,1500000000,1500000000
62298813616,1649965899,67622,64298813616,67622,81405683607,2000000000,2000000000
172378903626,1642178993,64741,173878903626,59941,205905883234,1500000000,1500000000
29562390472,1649936433,55580,31562390472,55580,36243374359,2000000000,2000000000
37008382519,1649921762,343847,38508382519,343847,40757855220,1500000000,1500000000
24173049665,1649928660,63200,25673049665,63200,59966384808,1500000000,1500000000
57292342610,1649949723,55680,58792342610,50880,88809925317,1500000000,1500000000
34762891270,1644927143,60850,36262891270,56050,47916824342,1500000000,1500000000
176309895627,1642179932,60862,177809895627,56062,218098389180,1500000000,1500000000
32897107856,1649897970,332559,34397107856,332559,42292998268,1500000000,1500000000
43653512179,1649904822,64741,45153512179,59941,62434128132,1500000000,1500000000
24412152442,1649927517,64741,25912152442,59941,200000000000,1500000000,1500000000
83037020852,1643955332,310295,84537020852,310295,113741200140,1500000000,1500000000
105368207674,1642155097,322492,106868207674,322492,153852408869,1500000000,1500000000
396604905217,1642119942,63200,399104905217,63200,402146382192,2500000000,2500000000
39564625673,1648177280,348321,41064625673,348321,51450441899,1500000000,1500000000
63870294036,1649966719,310269,65587762087,310269,77783106728,1717468051,1717468051
41179755721,1649949399,55680,42679755721,50880,63609644393,1500000000,1500000000
41179755721,1649949399,67646,42679755721,62846,65847234183,1500000000,1500000000
94574277967,1644005116,66934,96074277967,62134,139552217289,1500000000,1500000000
90655075199,1641603653,60850,92155075199,56050,120990903618,1500000000,1500000000
91952761183,1641616701,67646,93452761183,62846,98587006742,1500000000,1500000000
142186285664,1642132856,340057,143686285664,340057,143721307385,1500000000,1500000000
169626883495,1642204245,60850,171126883495,56050,210807731885,1500000000,1500000000
176612142331,1642195371,67646,178112142331,62846,235771330018,1500000000,1500000000
24580040782,1649927328,48567,26080040782,48567,32955949647,1500000000,1500000000
24580040782,1649927328,59922,26080040782,59922,40000000000,1500000000,1500000000
24580040782,1649927328,48567,26080040782,48567,54408856657,1500000000,1500000000
24580040782,1649927328,48603,26080040782,34738,45302880547,1500000000,1500000000
130309815180,1642185601,54836,131809815180,50036,221829317070,1500000000,1500000000
22359689400,1648215264,67622,23859689400,67622,32323612565,1500000000,1500000000
55027669782,1644960787,319717,56527669782,319717,66884134853,1500000000,1500000000
31080852287,1648170660,330553,33080852287,330553,48122909220,2000000000,2000000000
42299896894,1644928382,305390,44299896894,305390,61468962986,2000000000,2000000000
102262536651,1642159366,67634,103762536651,67634,159667438663,1500000000,1500000000
170271278798,1642181275,67622,171771278798,67622,172175541674,1500000000,1500000000
61123140269,1649956833,48627,62623140269,43827,76519335898,1500000000,1500000000
204384999681,1642124363,55592,206690204681,50792,529916041028,2305205000,2305205000
94708845611,1641671466,67646,96208845611,67646,100649924439,1500000000,1500000000
94708845611,1641671466,60862,96208845611,56062,100567150704,1500000000,1500000000
175020956707,1642198641,67634,176520956707,67634,202856161728,1500000000,1500000000
175020956707,1642198641,55592,176520956707,50792,202856161728,1500000000,1500000000
87559305133,1644004703,55648,90059305133,55648,188005280106,2500000000,2500000000
43561891022,1644905817,326675,45061891022,326675,45749794000,1500000000,1500000000
24435265808,1649929218,63200,25935265808,63200,53157516764,1500000000,1500000000
158600799219,1642196018,323335,160100799219,323335,167660681172,1500000000,1500000000
158600799219,1642196018,56516,160600799219,51716,220649431674,2000000000,2000000000
140289998938,1642182083,67646,141789998938,62846,192449342752,1500000000,1500000000
65851978439,1649900166,60862,67351978439,60862,85739070680,1500000000,1500000000
65851978439,1649900166,60862,67351978439,60862,69318250883,1500000000,1500000000
51380842963,1641640805,67634,52880842963,62834,85943408875,1500000000,1500000000
192284105451,1642180141,60862,193784105451,56062,233735967585,1500000000,1500000000
150098318289,1642174104,67622,151598318289,67622,197602801429,1500000000,1500000000
65181914978,1648250121,325068,66681914978,325068,80218024650,1500000000,1500000000
56357653080,1649941795,66802,57857653080,62002,61414928918,1500000000,1500000000
116357882170,1641622737,64741,118357882170,59941,128098566726,2000000000,2000000000
70525096566,1641626804,320962,72025096566,320962,94130250485,1500000000,1500000000
372982164838,1642121404,54771,374941523237,49971,477881496449,1959358399,1959358399
65492240284,1644890948,67634,66992240284,62834,72971850764,1500000000,1500000000
136392873386,1642203720,67646,137892873386,62846,151926621784,1500000000,1500000000
35298524881,1648168482,319763,36798524881,319763,50680960347,1500000000,1500000000
58424384922,1649949226,60850,59924384922,56050,79652552249,1500000000,1500000000
24873794008,1649916596,66802,26873794008,62002,37972426489,2000000000,2000000000
172780866785,1643933312,330535,174280866785,330535,197855606230,1500000000,1500000000
49266704652,1644929086,326230,50766704652,326230,69371375579,1500000000,1500000000
182553306345,1642180595,67646,184053306345,67646,273549098543,1500000000,1500000000
148332566869,1642187168,340009,149832566869,340009,212070313669,1500000000,1500000000
27348824945,1649931589,54676,28848824945,49876,41373808474,1500000000,1500000000
30818294697,1649915160,324184,32318294697,324184,57997048702,1500000000,1500000000
26656209127,1649925447,48591,28156209127,48591,31140492612,1500000000,1500000000
36329187522,1649895338,60850,37829187522,60850,60375854832,1500000000,1500000000
157166661088,1641663852,67634,158666661088,62834,208140325187,1500000000,1500000000
101166849029,1641661450,54872,103666849029,54872,221486467960,2500000000,2500000000
72163251066,1641629581,60862,73663251066,56062,99857799430,1500000000,1500000000
204892792810,1642127478,67634,206892792810,67634,231878748207,2000000000,2000000000
160625383607,1642155382,316656,161625383607,316656,178331126007,1000000000,1000000000
155455840786,1643995641,52904,156955840786,52904,192126379644,1500000000,1500000000
63079923445,1649966867,67646,73079923445,67646,300000000000,10000000000,10000000000
29591080187,1649922773,64741,31091080187,59941,34382908163,1500000000,1500000000
196669657786,1641664028,343213,198169657786,343213,204952954525,1500000000,1500000000
130422736571,1642158363,60862,131922736571,56062,139308311922,1500000000,1500000000
154549855477,1641664510,317230,156049855477,317230,196323342054,1500000000,1500000000
41026692010,1649894870,333151,42038204017,316051,42038204017,1500000000,1011512007
25018645068,1649907245,67634,27018645068,62834,34238297497,2000000000,2000000000
27181810256,1649928860,59946,28681810256,55146,35152039134,1500000000,1500000000
38903882279,1644912706,55580,39903882279,55580,53880292289,1000000000,1000000000
38903882279,1644912706,332287,40403882279,332287,54618269797,1500000000,1500000000
68921741517,1644935773,323177,70421741517,323177,85143071418,1500000000,1500000000
66283426008,1649949877,60862,67783426008,56062,73277590877,1500000000,1500000000
54918911104,1648223094,309429,55918911104,309429,56000000000,1000000000,1000000000
24626985822,1649937260,60862,26126985822,56062,35266958209,1500000000,1500000000
24626985822,1649937260,67634,26626985822,67634,39887073562,2000000000,2000000000
30291984427,1649923333,49507,31791984427,44707,40021404783,1500000000,1500000000
67096796520,1641642438,53276,68596796520,43676,88309830713,1500000000,1500000000
211710925308,1642195146,55648,214210925308,55648,381471701856,2500000000,2500000000
89599034756,1641612178,67622,91099034756,67622,148619083722,1500000000,1500000000
115760955910,1642190231,331165,117260955910,331165,170401578505,1500000000,1500000000
220701917380,1642138936,67622,222201917380,67622,273685867549,1500000000,1500000000
63250699482,1648231303,314009,64750699482,314009,73009766317,1500000000,1500000000
23149026914,1649933554,66730,24649026914,61930,33013185189,1500000000,1500000000
94343165627,1649942356,67646,95843165627,62846,124380677729,1500000000,1500000000
27705655313,1644924743,332519,29205655313,332519,47897653353,1500000000,1500000000
162795591731,1642196081,60850,164295591731,60850,252396416767,1500000000,1500000000
36602332563,1649935689,60862,38102332563,56062,51209217679,1500000000,1500000000
73463005078,1644949299,67634,74963005078,67634,102506510007,1500000000,1500000000
100035176271,1641620813,67646,101535176271,62846,139920655475,1500000000,1500000000
29050435321,1648195804,336877,30550435321,336877,38850347968,1500000000,1500000000
25000232845,1649924658,67646,26500232845,62846,29267080374,1500000000,1500000000
43766519520,1649904813,64741,48766519520,59941,299000000000,5000000000,5000000000
191553861058,1642177482,60862,193053861058,56062,198884641284,1500000000,1500000000
23016699731,1649936539,67646,24516699731,62846,31688036842,1500000000,1500000000
30233920180,1649929404,64741,32233920180,59941,200000000000,2000000000,2000000000
35799941035,1644895543,343211,37299941035,343211,44237683094,1500000000,1500000000
113813470985,1642174271,316592,115313470985,316592,121100000000,1500000000,1500000000
55385282899,1649962797,327908,57035282899,327908,59000000000,1650000000,1650000000
77336454821,1643963382,302837,78836454821,302837,85271657729,1500000000,1500000000
132177308728,1643996774,67646,133677308728,62846,139358322992,1500000000,1500000000
136334746525,1644002556,334284,137834746525,334284,145222198610,1500000000,1500000000
54031914220,1644925860,326109,55531914220,326109,59943444179,1500000000,1500000000
48402954291,1643967773,52904,49902954291,48104,63078115923,1500000000,1500000000
104959292255,1641624769,54884,106459292255,54884,154357079724,1500000000,1500000000
39038662820,1644895011,343771,40538662820,343771,47254734887,1500000000,1500000000
148354866953,1642183676,55648,150854866953,55648,295872940848,2500000000,2500000000
171118864671,1642174192,333646,172618864671,333646,178751448784,1500000000,1500000000
52608910250,1649950052,67734,54108910250,62934,68199212520,1500000000,1500000000
119983234416,1642160813,60874,121483234416,56074,139307419937,1500000000,1500000000
56244750540,1649952934,55680,57744750540,50880,78960398585,1500000000,1500000000
209439198905,1642177488,55648,211939198905,55648,385607722116,2500000000,2500000000
22349531813,1648194823,337470,23849531813,337470,26440729812,1500000000,1500000000
43080237611,1648230340,330545,44580237611,330545,45233546544,1500000000,1500000000
29843688765,1649907634,333684,31343688765,333684,37068085179,1500000000,1500000000
70274234251,1649900106,60862,71774234251,56062,90741908148,1500000000,1500000000
67087534327,1649965363,67634,68587534327,67634,70000000000,1500000000,1500000000
175208349972,1643990808,55648,177708349972,55648,314856959492,2500000000,2500000000
90488508424,1648239461,60862,91988508424,56062,102048776232,1500000000,1500000000
89692694848,1649964097,67634,91192694848,67634,114020424638,1500000000,1500000000
20067534742,1649936589,64044,21567534742,54444,27196104367,1500000000,1500000000
117790347621,1641684529,54703,119290347621,54703,145591015855,1500000000,1500000000
132818798795,1642147969,67646,134318798795,62846,185980547730,1500000000,1500000000
29641025751,1648195353,60838,31141025751,60838,44981937838,1500000000,1500000000
154968693842,1642183278,334286,156378693842,334286,172200844877,1410000000,1410000000
60872481017,1649966268,59946,62372481017,55146,78335128544,1500000000,1500000000
50806187364,1644905696,55648,53306187364,55648,94222864996,2500000000,2500000000
45861966299,1644914695,54813,46555869672,50013,46555869672,1500000000,693903373
78778147699,1641630255,67622,80278147699,67622,114799472324,1500000000,1500000000
101288007350,1641618510,60850,102788007350,56050,122993023159,1500000000,1500000000
59774992137,1641632217,322494,61274992137,322494,65000000000,1500000000,1500000000
151934838056,1642196740,67634,153434838056,62834,196654592555,1500000000,1500000000
83182663814,1643963593,60862,84682663814,56062,111215701502,1500000000,1500000000
133496165687,1641671657,60862,134996165687,56062,169015124753,1500000000,1500000000
133496165687,1641671657,67634,134996165687,67634,169015124753,1500000000,1500000000
110636699308,1641624943,60838,112136699308,60838,131145334688,1500000000,1500000000
374969796503,1642121668,67634,376851596503,62834,522319475248,1881800000,1881800000
165555769991,1642188345,67622,167055769991,67622,183808105365,1500000000,1500000000
181473689703,1642129375,60862,182973689703,56062,208847136717,1500000000,1500000000
24119580309,1649907050,66790,25619580309,61990,31812520050,1500000000,1500000000
50526651164,1649967906,333658,52026651164,333658,68000000000,1500000000,1500000000
74753395274,1641650529,60850,76253395274,56050,82130161178,1500000000,1500000000
24708592685,1649929335,66766,26208592685,66766,34233968635,1500000000,1500000000
24708592685,1649929335,56516,26358592685,51716,220000000000,1650000000,1650000000
55902524481,1643955649,56516,57402524481,51716,76404269987,1500000000,1500000000
52250119335,1644916884,330569,53750119335,330569,64644358039,1500000000,1500000000
92063292710,1641681688,67634,93563292710,62834,138607677459,1500000000,1500000000
171662518619,1642131751,55705,173162518619,50905,194696826582,1500000000,1500000000
115934570198,1642173883,331143,117434570198,331143,124923316360,1500000000,1500000000
115934570198,1642173883,333722,117259970198,333722,120701741996,1325400000,1325400000
269030047590,1642125429,60850,270530047590,56050,272999430744,1500000000,1500000000
112274552654,1648225976,67646,113774552654,62846,167713258592,1500000000,1500000000
72488899555,1649946846,49571,73724560563,49571,73724560563,1500000000,1235661008
42112701026,1649949356,315297,43522701026,315297,44000000000,1410000000,1410000000
87499274017,1643961206,314071,88999274017,314071,117042725340,1500000000,1500000000
97377731113,1641607145,336893,98877731113,336893,101000349957,1500000000,1500000000
145799129236,1642141549,60838,147299129236,60838,178385815064,1500000000,1500000000
54027309846,1649964220,59946,55527309846,55146,60000000000,1500000000,1500000000
234970679497,1643994585,333706,236470679497,333706,239083863574,1500000000,1500000000
60279849307,1643962932,49483,61779849307,49483,65479120229,1500000000,1500000000
127590672713,1642161414,59946,129090672713,55146,139000000000,1500000000,1500000000
170965959071,1642134890,67634,172465959071,67634,217349776254,1500000000,1500000000
171333487675,1642176971,55648,173833487675,55648,339693785480,2500000000,2500000000
199950013158,1642182669,67646,201450013158,62846,203520696819,1500000000,1500000000
98622097734,1643952010,55648,101122097734,55648,219112308886,2500000000,2500000000
87414351236,1641629253,67646,88914351236,62846,117223295845,1500000000,1500000000
25426905009,1649921535,55693,27426905009,50893,36969721572,2000000000,2000000000
102109966679,1643933692,330575,103609966679,330575,110000000000,1500000000,1500000000
35075461085,1644915507,54872,36575461085,50072,45869810343,1500000000,1500000000
194991911690,1642173574,67634,196491911690,67634,211538889043,1500000000,1500000000
202950047788,1642169902,60862,204484213040,60862,254869022298,1534165252,1534165252
38502315471,1649976813,302253,40502315471,302253,51217708867,2000000000,2000000000
84947677057,1643938440,326818,86447677057,326818,105130573168,1500000000,1500000000
36919674282,1644915600,67634,38419674282,62834,50817753774,1500000000,1500000000
43645218869,1648241693,336885,45145218869,336885,57145081829,1500000000,1500000000
63263357058,1649946896,55693,64763357058,55693,93997357172,1500000000,1500000000
122182684681,1643992626,52928,124182684681,48128,127511954002,2000000000,2000000000
96988885584,1641624835,60838,98488885584,60838,125456448254,1500000000,1500000000
152330109446,1642188150,60850,153830109446,56050,241451710304,1500000000,1500000000
153718568901,1642198416,60850,155218568901,60850,226338154710,1500000000,1500000000
120637464184,1642199004,67646,122337464184,62846,125000000000,1700000000,1700000000
162654284691,1642174067,55636,165154284691,55636,316264482286,2500000000,2500000000
47402496940,1649970189,55668,48902496940,55668,67662407467,1500000000,1500000000
92304911786,1649960674,60950,93804911786,56150,120528050534,1500000000,1500000000
119265368751,1641658763,60862,120765368751,56062,128641427524,1500000000,1500000000
87713086863,1641604382,67634,89123086863,62834,97377267627,1410000000,1410000000
147257592975,1642182495,60850,148757592975,60850,198724223205,1500000000,1500000000
98229624655,1642165195,52916,99729624655,48116,142927386528,1500000000,1500000000
170406956266,1642129291,55705,171906956266,50905,212380357312,1500000000,1500000000
133594926237,1642175666,60850,135094926237,56050,168256405215,1500000000,1500000000
172375062664,1642180117,60850,173875062664,56050,233319349933,1500000000,1500000000
135888473360,1642195887,55648,138388473360,55648,283378645138,2500000000,2500000000
32218655960,1649921314,54825,33718655960,50025,45217069409,1500000000,1500000000
96288358521,1641617385,60862,97788358521,56062,121728328300,1500000000,1500000000
153555809508,1642193228,60850,155055809508,60850,171888858709,1500000000,1500000000
26987656582,1649931661,49607,28987656582,44807,35774321262,2000000000,2000000000
28961854931,1649934382,327353,30461854931,327353,35149370973,1500000000,1500000000
82482105437,1643961441,67622,83982105437,67622,116079679007,1500000000,1500000000
437644533061,1642176186,60850,439926215561,56050,482228224668,2281682500,2281682500
92926826960,1641611196,340057,94426826960,340057,125235715755,1500000000,1500000000
186260532903,1642173670,60850,187760532903,60850,234812164970,1500000000,1500000000
73013996110,1649943924,49583,74513996110,44783,82636769583,1500000000,1500000000
70711810544,1644888749,337701,72211810544,337701,72849324355,1500000000,1500000000
199301741372,1642181798,54771,200801741372,49971,245628382173,1500000000,1500000000
19830226247,1648203489,67634,21330226247,62834,23535106302,1500000000,1500000000
19830226247,1648203489,54824,21330226247,50024,23535106302,1500000000,1500000000
22382209437,1648207420,314082,23836822520,314082,23836822520,1500000000,1454613083
126951959040,1641654246,52904,127986918747,48104,127986918747,1500000000,1034959707
19199032878,1648201862,310333,20515032878,310333,21249140372,1316000000,1316000000
19199032878,1648201862,313411,20699032878,313411,25000000000,1500000000,1500000000
43682220199,1644892373,314136,45182220199,314136,56009232298,1500000000,1500000000
97525988606,1641628616,331205,97839083749,331205,97839083749,1500000000,313095143
97525988606,1641628616,330571,97839083749,330571,97839083749,1500000000,313095143
115913920415,1642173918,55696,117413920415,50896,146418212748,1500000000,1500000000
51160321648,1649950786,321568,52660321648,321568,74217435270,1500000000,1500000000
38391237045,1648190090,55592,39891237045,50792,45507742797,1500000000,1500000000
61537070739,1641648123,330475,63537070739,330475,85860746670,2000000000,2000000000
39788611886,1648189931,67658,41288611886,62858,47218485905,1500000000,1500000000
88150034034,1644950121,346394,89650034034,346394,117645864719,1500000000,1500000000
151131154101,1641659038,67622,152631154101,62822,189046800107,1500000000,1500000000
55935521671,1649957882,67646,57435521671,62846,64136873463,1500000000,1500000000
68446702533,1649954396,64741,69946702533,59941,200000000000,1500000000,1500000000
125333140075,1643990988,67646,127333140075,62846,191727200314,2000000000,2000000000
121636203635,1642168516,60850,122310416085,56050,122310416085,1500000000,674212450
25959906036,1649938448,55684,27459906036,50884,34386265372,1500000000,1500000000
77942911692,1641625593,60862,79442911692,60862,85082847472,1500000000,1500000000
163524706587,1642178971,55592,165024706587,50792,188639809252,1500000000,1500000000
162577424121,1642178546,67634,164077424121,62834,226852093789,1500000000,1500000000
27909687077,1648183543,322957,29409687077,322957,39751933643,1500000000,1500000000
239677840805,1641672746,334308,241959523305,334308,344419962250,2281682500,2281682500
47390712254,1649912077,67722,48890712254,62922,63470924962,1500000000,1500000000
52494176350,1643971305,314053,53994176350,314053,64809828450,1500000000,1500000000
47637379725,1644909088,64717,49354847777,64717,53551351463,1717468052,1717468052
134200416644,1642138253,60862,135700416644,56062,149831306562,1500000000,1500000000
38887653952,1649908208,66766,39911978580,66766,39911978580,1500000000,1024324628
114639930474,1644966634,67634,116139930474,67634,128879227192,1500000000,1500000000
154381682124,1642173426,60850,155881682124,56050,215166932935,1500000000,1500000000
76847252606,1641628806,60850,78347252606,56050,91531384035,1500000000,1500000000
72649528787,1641607209,319933,75000000000,319933,,,
320549595170,1642122401,60862,327419269556,56062,,,
258220447023,1642124216,67634,259720447023,67634,303101141124,1500000000,1500000000
29449223317,1648213380,323549,30949223317,323549,31402902177,1500000000,1500000000
36294506927,1648175921,67634,37794506927,62834,56728545882,1500000000,1500000000
82107944949,1641626042,336815,83607944949,336815,117295798757,1500000000,1500000000
136540433339,1642181116,64729,138140933339,59929,207724998025,1600500000,1600500000
27012358984,1648195885,334350,28512358984,334350,34720880725,1500000000,1500000000
55777475027,1649954790,66886,57277475027,62086,76385312342,1500000000,1500000000
25615351511,1649933553,324198,27115351511,324198,34862987685,1500000000,1500000000
97909645668,1644005416,296246,99409645668,296246,112604513998,1500000000,1500000000
258448490492,1642127008,60850,259948490492,60850,281374830807,1500000000,1500000000
156731286031,1642183008,67646,158231286031,62846,190823166968,1500000000,1500000000
156731286031,1642183008,60850,158231286031,60850,189542388523,1500000000,1500000000
199896204436,1642173593,64741,201396204436,59941,245239889613,1500000000,1500000000
66122315518,1649947807,60938,67622315518,60938,79385046072,1500000000,1500000000
66545550911,1649953440,60926,68045550911,56126,82982796473,1500000000,1500000000
192956595770,1641678569,67622,194456595770,67622,261943230917,1500000000,1500000000
80262390676,1641646137,54884,81762390676,54884,102022157098,1500000000,1500000000
83877842879,1641637079,67634,85377842879,67634,103416194095,1500000000,1500000000
161425154776,1642178878,60862,162925154776,56062,232875563604,1500000000,1500000000
171191550475,1642128774,67634,172691550475,67634,261841990479,1500000000,1500000000
26783874363,1649932889,67634,28283874363,62834,39463073088,1500000000,1500000000
27077495756,1649919206,343219,28577495756,343219,34510151260,1500000000,1500000000
60144185641,1649968202,60862,61644185641,56062,68513544145,1500000000,1500000000
344992550802,1642150257,67710,346992550802,67710,401105067465,2000000000,2000000000
41786099061,1649895307,56516,43286099061,51716,61186064893,1500000000,1500000000
264771724828,1642123027,327333,266271724828,327333,285771424717,1500000000,1500000000
46112132353,1649904031,67646,47612132353,62846,47965730274,1500000000,1500000000
163783527564,1642193756,55592,165283527564,50792,216629933859,1500000000,1500000000
51840880125,1649964459,60926,53340880125,60926,61325573522,1500000000,1500000000
133125032695,1641657717,60838,134625032695,56038,147348188517,1500000000,1500000000
159001838074,1642135761,67634,160501838074,62834,198922137970,1500000000,1500000000
181540629662,1642177445,67646,183040629662,62846,198884641284,1500000000,1500000000
181540629662,1642177445,55696,183040629662,50896,198884641284,1500000000,1500000000
122431359543,1642165545,67646,123931359543,62846,182323500355,1500000000,1500000000
45449288298,1644896726,55612,46949288298,55612,58380952487,1500000000,1500000000
77109468842,1644959018,59934,78609468842,55134,101600596299,1500000000,1500000000
142697924315,1642151637,60850,144197924315,56050,176659970705,1500000000,1500000000
63919050666,1649954635,60850,65419050666,60850,72921319262,1500000000,1500000000
119891120639,1649955972,55592,121838764821,50792,148913166037,1947644182,1947644182
156196484043,1642184895,60850,157696484043,56050,200993179588,1500000000,1500000000
61691086877,1649951738,60938,63191086877,56138,70301333129,1500000000,1500000000
69699773115,1641655567,336813,71199773115,336813,90039369050,1500000000,1500000000
115925251289,1642133214,60018,117425251289,55218,169964699142,1500000000,1500000000
33071357839,1648233445,319777,36967046598,319777,,,
107530435116,1643990214,52916,109530435116,48116,149549291789,2000000000,2000000000
85266829828,1644003107,343239,86766829828,343239,118699308843,1500000000,1500000000
34615457342,1644921922,323634,36115457342,323634,39964011307,1500000000,1500000000
177500080502,1641669929,336845,179000080502,336845,183553878610,1500000000,1500000000
189051176967,1641664739,67634,190551176967,62834,224024533287,1500000000,1500000000
115676859273,1642159932,60850,117176859273,60850,181831586753,1500000000,1500000000
203918377980,1642184636,67634,205418377980,62834,224524961504,1500000000,1500000000
35829975255,1648243293,67646,37329975255,62846,44243644989,1500000000,1500000000
87261525209,1641616862,60862,88761525209,56062,113321731934,1500000000,1500000000
94752293319,1641654292,316586,95629028023,316586,95629028023,1500000000,876734704
91248000811,1642160700,67658,92748000811,62858,141732102090,1500000000,1500000000
45710439359,1648167704,67646,47210439359,62846,56527182835,1500000000,1500000000
123834624943,1642155061,314063,125334624943,314063,147211352709,1500000000,1500000000
179546217605,1642180513,67658,205000000000,62858,,,
41799267093,1649935435,67634,43299267093,62834,54567205085,1500000000,1500000000
33440749912,1644921125,326950,34940749912,326950,39446066864,1500000000,1500000000
82847083204,1641651978,60838,84347083204,60838,86864892080,1500000000,1500000000
24101328047,1649927141,49571,25601328047,49571,29345418764,1500000000,1500000000
41703598058,1649971259,66754,43203598058,61954,47350517390,1500000000,1500000000
68396722212,1644955817,67634,69896722212,67634,92185850087,1500000000,1500000000
159892322530,1642137811,48639,161392322530,48639,191933867173,1500000000,1500000000
23754657929,1649934593,312980,25254657929,312980,28767387789,1500000000,1500000000
82240805312,1641629616,60850,83740805312,56050,91704063833,1500000000,1500000000
515890821810,1642119600,67634,518082149683,67634,734634695223,2191327873,2191327873
37199948606,1649897985,330036,39139948606,330036,43061384820,1940000000,1940000000
88902866446,1644017219,60850,90402866446,56050,98728388993,1500000000,1500000000
88902866446,1644017219,67634,90402866446,62834,98993635423,1500000000,1500000000
78569018048,1643936278,55648,81069018048,55648,172603236594,2500000000,2500000000
59242561469,1644943962,52916,60742561469,52916,64874233934,1500000000,1500000000
103607637262,1641655261,55705,105107637262,50905,143989530652,1500000000,1500000000
28087928529,1649896209,55705,29587928529,50905,35793397443,1500000000,1500000000
28087928529,1649896209,54933,29587928529,50133,200000000000,1500000000,1500000000
169867822393,1642181741,54800,171367822393,54800,212273844543,1500000000,1500000000
132854881692,1642144967,55705,134520825701,50905,170396596446,1665944009,1665944009
28167055303,1648210756,67634,29667055303,67634,32574435508,1500000000,1500000000
59192919998,1644884474,349554,60692919998,349554,67726014085,1500000000,1500000000
171820825546,1641664049,60850,173320825546,56050,247337072233,1500000000,1500000000
155539496079,1641602260,326042,157039496079,241903,166270476452,1500000000,1500000000
155539496079,1641602260,326042,157039496079,326042,166270476452,1500000000,1500000000
115459931009,1641652388,60862,116959931009,56062,119860328015,1500000000,1500000000
124553727077,1642137974,48735,126053727077,43935,151824874793,1500000000,1500000000
150416089725,1642177527,60862,152496527829,56062,155000000000,2080438104,2080438104
54933613002,1649953546,67646,56433613002,62846,90296794273,1500000000,1500000000
48893482170,1649969869,67646,50393482170,62846,64765094340,1500000000,1500000000
121291934555,1641659354,60850,122610754463,56050,122610754463,1500000000,1318819908
47054561170,1648175408,325651,48554561170,325651,51991789638,1500000000,1500000000
35895986159,1649894745,326802,37395986159,326802,38817710605,1500000000,1500000000
32592524626,1649895714,55717,34592524626,50917,35138226177,2000000000,2000000000
140153359320,1642193300,67646,205000000000,62846,,,
121025964637,1642137165,67634,122525964637,62834,167583825200,1500000000,1500000000
29860613640,1649923110,67622,31360613640,67622,38312705514,1500000000,1500000000
60688362665,1643949527,312280,62188362665,312280,96921093993,1500000000,1500000000
78257497463,1643964399,67646,79757497463,62846,98326522999,1500000000,1500000000
103627220632,1643933710,324850,105127220632,324850,110000000000,1500000000,1500000000
383957233734,1642176112,67646,386309483734,62846,583194813418,2352250000,2352250000
62367675002,1643980112,55705,63867675002,50905,93027183470,1500000000,1500000000
47044257113,1644930585,67634,48544257113,62834,81777455297,1500000000,1500000000
41006787523,1644896328,55660,42506787523,55660,57240403997,1500000000,1500000000
80211180797,1641605023,319791,81711180797,319791,100758536830,1500000000,1500000000
85924214541,1641630871,336277,87424214541,336277,113157467053,1500000000,1500000000
146497312066,1641674908,60850,147997312066,56050,156440750799,1500000000,1500000000
57080827046,1648173457,317250,58580827046,317250,73091375075,1500000000,1500000000
76260946045,1649902423,322877,77760946045,322877,94828126608,1500000000,1500000000
92008086843,1644016781,60838,93238336930,60838,93238336930,1561746805,1230250087
89235467620,1641624156,67646,90735467620,62846,122153763898,1500000000,1500000000
131438311747,1642190419,66754,132938311747,66754,167400890845,1500000000,1500000000
131438311747,1642190419,67622,132938311747,67622,156606197490,1500000000,1500000000
167120057668,1642179272,67634,168620057668,62834,236073334307,1500000000,1500000000
140306833759,1642198927,55283,141806833759,50483,216384080087,1500000000,1500000000
64263070651,1649952664,60006,65763070651,55206,77405846263,1500000000,1500000000
39443201875,1649895538,67646,40943201875,62846,90000000000,1500000000,1500000000
72257959137,1649949944,60018,73757959137,55218,81015505449,1500000000,1500000000
139110970615,1643998961,55580,140610970615,50780,144000000000,1500000000,1500000000
135486352807,1642192996,60862,136986352807,56062,194081234172,1500000000,1500000000
45005079338,1644915240,55580,46415079338,55580,54691768474,1410000000,1410000000
122854090407,1641675832,302605,124854090407,302605,165162261621,2000000000,2000000000
102750444025,1641616896,54872,105250444025,54872,198828487754,2500000000,2500000000
153897484979,1642197159,52928,155397484979,48128,193303036943,1500000000,1500000000
21797636469,1648190506,60862,23797636469,60862,34907867316,2000000000,2000000000
81600870278,1649952777,55580,83100870278,50780,102638833174,1500000000,1500000000
169882705012,1642178805,55648,172382705012,55648,304557762560,2500000000,2500000000
35268946107,1648214671,66766,36768946107,61966,41171949927,1500000000,1500000000
94452232601,1641636902,320523,95952232601,320523,111238024015,1500000000,1500000000
171150882396,1642204212,55592,172650882396,50792,208809631349,1500000000,1500000000
182212515867,1642138565,60862,183712515867,60862,216863097388,1500000000,1500000000
37865401556,1649914079,63200,39365401556,63200,68823075556,1500000000,1500000000
25393472641,1649932551,326087,26893472641,326087,32832745813,1500000000,1500000000
88964235513,1644003375,55636,91464235513,55636,181635306362,2500000000,2500000000
50620242843,1644883928,329270,52120242843,329270,52417858152,1500000000,1500000000
129164167882,1644967054,340679,130664167882,340679,131390129894,1500000000,1500000000
138803037744,1642193883,55636,141303037744,55636,295785194160,2500000000,2500000000
25071036463,1649912760,49607,26571036463,44807,36000000000,1500000000,1500000000
99509004013,1641600883,60850,101009004013,56050,145114407723,1500000000,1500000000
45723819047,1648244693,52916,47223819047,52916,49803380545,1500000000,1500000000
30688044556,1649921634,66730,32188044556,66730,37255640537,1500000000,1500000000
40449152118,1644887731,340657,41949152118,340657,48327182427,1500000000,1500000000
84056724784,1641625760,60850,85556724784,60850,103960429028,1500000000,1500000000
149163033865,1642174096,320382,150663033865,320382,204817855864,1500000000,1500000000
121572783799,1642188254,329956,123072783799,329956,146918886408,1500000000,1500000000
120210866558,1642202697,67646,121710866558,62846,126000000000,1500000000,1500000000
46518647196,1649977225,67646,48018647196,62846,49781639622,1500000000,1500000000
57381277055,1649946952,55705,58881277055,50905,85769354929,1500000000,1500000000
71954015816,1649954464,67722,73454015816,67722,95431990094,1500000000,1500000000
87463963079,1644002891,54921,88963963079,50121,300000000000,1500000000,1500000000
91014425792,1641643468,330515,92514425792,330515,134576403025,1500000000,1500000000
172050538104,1642178583,67646,173550538104,62846,226852093789,1500000000,1500000000
126846583556,1642168569,317312,128346583556,317312,153241912614,1500000000,1500000000
121876811820,1642150724,55693,123376811820,50893,155211822062,1500000000,1500000000
44299493391,1649901006,56516,45799493391,51716,49077018237,1500000000,1500000000
30877972403,1646400801,55580,32377972403,55580,37502491263,1500000000,1500000000
84688847263,1642666592,67634,86188847263,62834,117704578649,1500000000,1500000000
37555212406,1646376280,55592,50180000000,50792,50180000000,50179999989,12624787594
34090320625,1646398352,52568,35590320625,47768,35688891558,1500000000,1500000000
108476394809,1642657475,67646,109976394809,62846,127407593157,1500000000,1500000000
299718639436,1641833393,67646,301218639436,62846,403941508464,1500000000,1500000000
124970434764,1641796709,60862,126470434764,56062,127465036693,1500000000,1500000000
146360190750,1641845716,67634,147860190750,62834,219604602880,1500000000,1500000000
23855017834,1646387532,60862,25355017834,56062,32055915410,1500000000,1500000000
93786207436,1642694086,316660,95286207436,316660,114124306888,1500000000,1500000000
136186228892,1642714566,67634,137686228892,67634,191577031217,1500000000,1500000000
17733097831,1645853436,66742,21376400881,66742,21376400881,21376400881,3643303050
28801993010,1646400733,60838,30301993010,56038,44915982697,1500000000,1500000000
75205932805,1642665467,337486,76705932805,337486,86997454863,1500000000,1500000000
123054918924,1641782723,54872,124554918924,50072,176122450375,1500000000,1500000000
20043213204,1645854074,66778,22169403887,57178,22169403887,22169403887,2126190683
20933962380,1646657962,301616,22433962380,301616,27609114335,1500000000,1500000000
131610351842,1641802055,52916,133110351842,48116,172984300212,1500000000,1500000000
86243126236,1642657808,331147,88343126236,331147,101000000000,2100000000,2100000000
32839317972,1646672429,60850,34339317972,56050,36847009359,1500000000,1500000000
29678175960,1646403469,67622,31178175960,67622,39713515594,1500000000,1500000000
34341470999,1646673038,67634,35841470999,67634,54188787895,1500000000,1500000000
35861937130,1646669207,67634,37361937130,67634,51991100794,1500000000,1500000000
110646294533,1641803518,337502,112146294533,337502,112253291399,1500000000,1500000000
107855285684,1641795498,67622,109355285684,67622,143852607072,1500000000,1500000000
106837426590,1641792978,336909,108247426590,336909,112435206750,1410000000,1410000000
25214084709,1645869298,347025,27224084709,347025,31093247446,2010000000,2010000000
175740000690,1641843187,67634,177240000690,67634,203521252155,1500000000,1500000000
59720103125,1646413073,67634,61220103125,67634,73693956390,1500000000,1500000000
46474414636,1645837575,55580,47974414636,50780,89153924094,1500000000,1500000000
46474414636,1645837575,54933,47974414636,50133,200000000000,1500000000,1500000000
266230992368,1641822613,54969,267730992368,50169,276615157440,1500000000,1500000000
23348852696,1646629020,67622,24848852696,67622,26231924325,1500000000,1500000000
108349784444,1641801251,55693,109849784444,50893,119222926885,1500000000,1500000000
203498370830,1641832772,67634,204998370830,62834,272667978820,1500000000,1500000000
276813087264,1641849578,67634,278313087264,67634,329632901722,1500000000,1500000000
117788742150,1641775253,326111,119288742150,326111,123948278172,1500000000,1500000000
331040504513,1641827115,55592,332690504513,50792,351000000000,1650000000,1650000000
220609192260,1641816871,52916,222109192260,52916,229381785282,1500000000,1500000000
227042895179,1641823249,340045,229042895179,340045,290120753641,2000000000,2000000000
29165946219,1646617165,67646,30665946219,62846,41630217787,1500000000,1500000000
29982604694,1646379580,60862,31482604694,60862,44969599860,1500000000,1500000000
29213853623,1646385189,67634,30713853623,58034,32779435432,1500000000,1500000000
61661113178,1646407564,60862,63661113178,56062,83316358963,2000000000,2000000000
28619690350,1646645706,55592,30119690350,50792,34682466737,1500000000,1500000000
156669969530,1641856048,60862,158169969530,56062,160000000000,1500000000,1500000000
79545615256,1642644544,326309,81045615256,326309,91729027337,1500000000,1500000000
37519159831,1645864594,60862,39019159831,56062,47346609444,1500000000,1500000000
98202800217,1641791200,336195,99702800217,336195,103202880028,1500000000,1500000000
97436701774,1646685022,67622,98936701774,67622,137918425995,1500000000,1500000000
254511777255,1641831192,54861,257011777255,54861,502351707902,2500000000,2500000000
37193165134,1645882644,60838,38693165134,60838,46780791142,1500000000,1500000000
29359875977,1646378703,327375,30859875977,327375,33610170440,1500000000,1500000000
28452487166,1646383980,64044,29618544610,64044,29618544610,1500000000,1166057444
99911954734,1642664348,320545,101411954734,320545,133113058163,1500000000,1500000000
29942928192,1646630082,67634,31442928192,62834,37272771417,1500000000,1500000000
51897657048,1646677023,67646,53397657048,62846,63383112652,1500000000,1500000000
51897657048,1646677023,67634,53397657048,67634,63383112652,1500000000,1500000000
168814764676,1641854860,60838,170314764676,60838,180000000000,1500000000,1500000000
92717906631,1642686076,60850,94217906631,56050,115461242803,1500000000,1500000000
71441909908,1646685514,313435,73091909908,313435,80689425211,1650000000,1650000000
21813306746,1646652940,56516,81813306746,51716,1888000000000,60000000000,60000000000
130155005289,1641784484,67646,139948131280,62846,,,
31704767947,1646630542,64056,33204767947,54456,36727848615,1500000000,1500000000
20229426751,1646386692,56516,21729426751,51716,25262407737,1500000000,1500000000
25390052869,1646385938,55592,27390052869,50792,36574656072,2000000000,2000000000
104773412510,1642694534,333728,106273412510,333728,121753982194,1500000000,1500000000
38096223986,1645847405,60838,39606223986,60838,41225640110,1510000000,1510000000
128167771564,1642649815,67634,129667771564,62834,168265876692,1500000000,1500000000
25253166014,1646370436,54095,26753166014,49295,37694400099,1500000000,1500000000
90344675535,1642677156,337494,91844675535,337494,115645816718,1500000000,1500000000
62989286622,1642675926,336907,66000000000,336907,,,
104164432713,1642655997,53400,105664432713,53400,141077036957,1500000000,1500000000
70207944124,1642688138,60838,71707944124,60838,104118950333,1500000000,1500000000
103873013118,1641802697,67646,105373013118,62846,113744809492,1500000000,1500000000
29752901715,1645867879,336809,31252901715,336809,40988411682,1500000000,1500000000
18712595491,1646382525,60862,20212595491,56062,26874012908,1500000000,1500000000
91764663496,1642687949,55636,94264663496,55636,237255619248,2500000000,2500000000
27293958569,1645885820,332017,28293958569,332017,30000000000,1000000000,1000000000
31449623937,1646622949,54933,32949623937,50133,41674111613,1500000000,1500000000
20988585024,1646655185,67646,22988585024,62846,26254441804,2000000000,2000000000
33063323132,1646384604,60850,34563323132,56050,44700510244,1500000000,1500000000
46952545269,1646695140,67634,48452545269,67634,58298994113,1500000000,1500000000
313143383346,1641829138,55580,314643383346,50780,331000000000,1500000000,1500000000
210759882547,1642707277,67722,212259882547,67722,314117052088,1500000000,1500000000
118039438262,1642662547,54812,119539438262,50012,139300848530,1500000000,1500000000
20995784039,1646659658,60850,22495784039,56050,30255208975,1500000000,1500000000
149754947461,1641850301,67622,151254947461,67622,226492339395,1500000000,1500000000
122106878408,1642697240,330583,124106878408,330583,157392351997,2000000000,2000000000
28442357376,1645854371,343767,28576070466,343767,,,
24168440091,1646637745,299756,25668440091,299756,32080008288,1500000000,1500000000
240613719978,1641810721,67646,242113719978,62846,347009211259,1500000000,1500000000
215912313215,1641828245,328000,217412313215,328000,220223043600,1500000000,1500000000
121123167853,1641855235,60850,123123167853,60850,203260855520,2000000000,2000000000
82853918659,1642683094,60850,84353918659,56050,111835823898,1500000000,1500000000
233941248045,1641829893,334326,235941248045,334326,302952981203,2000000000,2000000000
95998317730,1641779696,340017,97448317730,340017,100000000000,1450000000,1450000000
95998317730,1641779696,331173,97448317730,331173,100000000000,1450000000,1450000000
33464450680,1646395693,63200,35964450680,63200,67457443974,2500000000,2500000000
64551850760,1646421230,60078,66051850760,55278,77864843697,1500000000,1500000000
158309587831,1642687516,60838,159809587831,60838,198935732755,1500000000,1500000000
93104536629,1642685541,322488,94604536629,322488,96150133179,1500000000,1500000000
71782700797,1646687307,67622,73722700797,62822,91856882874,1940000000,1940000000
37748438607,1646669382,64705,39248438607,64705,42726182963,1500000000,1500000000
21336899046,1646637085,306056,22836899046,306056,25736702588,1500000000,1500000000
126023702356,1642714728,67646,127523702356,62846,174595435564,1500000000,1500000000
40706245100,1646690563,67646,42206245100,62846,52784502809,1500000000,1500000000
109797231267,1642637134,60850,111297231267,56050,139184267439,1500000000,1500000000
216214746492,1641832120,54759,217714746492,49959,319252314510,1500000000,1500000000
76721061995,1642671454,55717,78221061995,50917,100000000000,1500000000,1500000000
180603996026,1641858208,60838,182103996026,60838,231710938488,1500000000,1500000000
26296803718,1646403866,67646,27796803718,62846,28788371119,1500000000,1500000000
49063807289,1645847960,323592,50563807289,323592,58597314515,1500000000,1500000000
44166492642,1645898938,346993,45666492642,346993,67142893192,1500000000,1500000000
22444352795,1646648613,324824,23944352795,324824,27698406980,1500000000,1500000000
44349523136,1646354106,52916,45849523136,48116,61635662787,1500000000,1500000000
45022318773,1646682926,55717,46522318773,50917,55472013689,1500000000,1500000000
21647097430,1646385383,307720,23147097430,307720,31064834032,1500000000,1500000000
32360873345,1646404225,60850,33860873345,60850,45876963692,1500000000,1500000000
58613758268,1645836163,60862,60113758268,56062,78317896592,1500000000,1500000000
30655315328,1646666009,304590,32155315328,304590,32967584707,1500000000,1500000000
22928344655,1646653628,56516,24928344655,51716,29763152817,2000000000,2000000000
74035383776,1642688207,56516,75535383776,51716,104110400818,1500000000,1500000000
40133610998,1645906829,60850,41633610998,56050,51169902973,1500000000,1500000000
28458853193,1646681640,67634,29958853193,67634,30258890728,1500000000,1500000000
36642440920,1646405153,60850,38142440920,56050,66572392273,1500000000,1500000000
41182589730,1646693565,67646,42682589730,62846,60000000000,1500000000,1500000000
24569011976,1646392036,330555,25916886378,330555,25916886378,1410000000,1347874402
88243081947,1641780518,316656,89743081947,316656,120071582369,1500000000,1500000000
88243081947,1641780518,314073,92000000000,314073,,,
295295436163,1641837985,60838,296620836163,60838,358274004980,1325400000,1325400000
22116897934,1646394975,55592,24116897934,50792,29684319372,2000000000,2000000000
75472443369,1642641975,67634,76972443369,62834,104026444408,1500000000,1500000000
26273957054,1646401530,330545,27773957054,330545,33776695170,1500000000,1500000000
113492167737,1642693828,319799,114992167737,319799,153660266079,1500000000,1500000000
52187147197,1646696729,67646,53687147197,62846,57517948400,1500000000,1500000000
85470667348,1642690844,55648,86970667348,50848,114882379120,1500000000,1500000000
32223708398,1645877059,67634,33723708398,67634,38797310007,1500000000,1500000000
207278434828,1641848481,55620,208688434828,50820,229568262610,1410000000,1410000000
82571950693,1642695199,60850,84071950693,56050,90165414084,1500000000,1500000000
95902496936,1642680439,320531,97402496936,320531,101916175584,1500000000,1500000000
24868393464,1646386441,327361,26868393464,327361,30114572236,2000000000,2000000000
62409450882,1646352075,55693,63909450882,50893,98123357172,1500000000,1500000000
180193608549,1642720698,54896,181693608549,50096,274863720718,1500000000,1500000000
27309654545,1645852039,339030,28903360553,332561,28903360553,28903360553,1593706008
62547206627,1646678195,66730,64047206627,61930,86909755817,1500000000,1500000000
194511234338,1641854035,67634,196011234338,67634,299757182475,1500000000,1500000000
51083251161,1646358970,59994,52583251161,55194,58260779449,1500000000,1500000000
62955386149,1642689737,331183,64455386149,331183,83817207534,1500000000,1500000000
72734412159,1642681507,336891,74234412159,336891,91434870587,1500000000,1500000000
40368296469,1646620715,67634,41868296469,62834,58096194553,1500000000,1500000000
101370781673,1641801197,67634,103370781673,67634,141110725043,2000000000,2000000000
139571377759,1641786318,317216,141071377759,317216,171948508392,1500000000,1500000000
203390359210,1641850119,59922,204890359210,59922,233633767698,1500000000,1500000000
149202041981,1642651131,60850,150702041981,60850,193611933979,1500000000,1500000000
72048444630,1646685739,67634,74048444630,67634,88557490052,2000000000,2000000000
372968371810,1641836457,60838,374468371810,60838,447040258269,1500000000,1500000000
22214207212,1646401458,67622,23714207212,67622,27604694119,1500000000,1500000000
207575210897,1642700162,337468,209075210897,337468,226798614557,1500000000,1500000000
31712001881,1646643647,64705,33212001881,59905,36740514003,1500000000,1500000000
199798521786,1641816968,55717,201298521786,50917,204206436967,1500000000,1500000000
51528709088,1646406912,67634,53028709088,67634,67028300749,1500000000,1500000000
137956632186,1642701032,54759,139620982669,54759,198534794370,1664350483,1664350483
123150431676,1641780462,319281,124650431676,319281,173372909519,1500000000,1500000000
31681465625,1646695712,67646,33181465625,62846,46525166798,1500000000,1500000000
23305910645,1646370753,55580,24805910645,50780,31912290360,1500000000,1500000000
85851074044,1642650656,54322,87851074044,54322,88000000000,2000000000,2000000000
61696345250,1645845470,322835,63196345250,322835,69610508194,1500000000,1500000000
24690902345,1646395862,60862,26190902345,60862,27755131628,1500000000,1500000000
64085050859,1646409770,59994,65585050859,55194,85075402132,1500000000,1500000000
241034178043,1641807458,343209,242601664761,343209,302458229660,1567486718,1567486718
45749079799,1646364308,327399,47249079799,327399,61021020754,1500000000,1500000000
147165057207,1642722886,543215,148815057207,343215,150000000000,1650000000,1650000000
119363678151,1642694628,340027,120863678151,340027,124207965215,1500000000,1500000000
15830177067,1646637834,55580,19400296067,50780,,,
346185018665,1641812046,60862,347685018665,56062,374481981530,1500000000,1500000000
22396002112,1646395081,55580,23896002112,55580,25000000000,1500000000,1500000000
22407356145,1646380275,67634,23907356145,62834,34092838649,1500000000,1500000000
89647278215,1642688055,60862,90000000000,56062,90000000000,1500000000,352721785
21055811080,1646638393,52904,23987909864,48104,,,
193786021623,1641819003,49507,195286021623,44707,253856723488,1500000000,1500000000
28201511914,1646632116,330481,29701511914,330481,32881397434,1500000000,1500000000
28201511914,1646632116,330037,29701511914,330037,32881397434,1500000000,1500000000
123337230151,1641776864,55705,124837230151,50905,182527672184,1500000000,1500000000
275257175283,1641831661,63200,277757175283,63200,491850189060,2500000000,2500000000
55620285134,1646413733,60850,57120285134,56050,71901576637,1500000000,1500000000
92358332797,1641802623,55705,93858332797,50905,103860918178,1500000000,1500000000
97147872047,1641801451,55592,98647872047,50792,132362975980,1500000000,1500000000
26365714792,1646372677,65530,28365714792,60730,45105873910,2000000000,2000000000
27787618336,1645876297,55580,29307618336,55580,34000000000,1520000000,1520000000
17737206974,1646647255,60838,19237206974,56038,25912497069,1500000000,1500000000
98263742661,1641804902,55580,99763742661,50780,134741998844,1500000000,1500000000
63969076532,1645836516,55580,65469076532,50780,68499506234,1500000000,1500000000
63969076532,1645836516,66742,65469076532,61942,74285660063,1500000000,1500000000
114495585070,1641781849,60850,115995585070,56050,151028468399,1500000000,1500000000
238460538397,1641852658,67634,239960538397,67634,259002165110,1500000000,1500000000
43016934780,1646367323,64056,44516934780,59256,56003256317,1500000000,1500000000
43268108928,1646673003,67634,45268108928,67634,49069114943,2000000000,2000000000
101864826775,1641790936,54872,104364826775,54872,228251104022,2500000000,2500000000
23145958896,1646402613,67634,24645958896,62834,36271739105,1500000000,1500000000
69379809803,1646684513,67634,70789809803,67634,72000000000,1410000000,1410000000
56660306448,1645835958,60850,58200306448,60850,59228438565,1540000000,1540000000
79261667020,1642690550,54801,80761667020,50001,105665779244,1500000000,1500000000
144079293046,1641784430,331165,145579293046,331165,194568053012,1500000000,1500000000
91171971539,1641800966,55592,92671971539,50792,113422330978,1500000000,1500000000
107642396663,1641792231,333714,109642396663,333714,112570162753,2000000000,2000000000
167105705663,1641773403,323093,168515705663,323093,211416600682,1410000000,1410000000
212133575265,1641842734,337526,213633575265,337526,235488752945,1500000000,1500000000
67400130316,1645834461,63200,69900130316,63200,123121218326,2500000000,2500000000
389435229207,1641812061,60862,390935229207,56062,396234116569,1500000000,1500000000
164039804062,1641817711,66718,165539804062,66718,226860435363,1500000000,1500000000
34224364161,1646679404,66754,35724364161,61954,36866917529,1500000000,1500000000
19280576380,1646652779,55648,21780576380,55648,44615736106,2500000000,2500000000
283481766164,1641828583,336875,303481766164,336875,311745649468,20000000000,20000000000
209201028729,1641844612,60850,210701028729,56050,294579620158,1500000000,1500000000
119864193820,1642693431,55693,121364193820,50893,128902692607,1500000000,1500000000
70725172627,1642668738,55648,72225172627,50848,108694918792,1500000000,1500000000
25734053047,1646401711,55592,27234053047,50792,32935504445,1500000000,1500000000
25734053047,1646401711,67646,27234053047,62846,32935504445,1500000000,1500000000
52459763452,1646678250,67646,60954015374,62846,,,
99155848096,1642680929,66742,100655848096,66742,111677141150,1500000000,1500000000
118090159185,1642639579,49495,119590159185,44695,126501129672,1500000000,1500000000
188329925870,1641785543,67634,189829925870,67634,228498512663,1500000000,1500000000
63861884762,1646409885,67634,65361884762,67634,81967766647,1500000000,1500000000
57292730265,1646682157,327922,58824573496,327922,62060230780,1531843231,1531843231
30347614601,1646384805,67646,30490032076,62846,30490032076,1000000000,142417475
31015421721,1646379278,60850,32515421721,60850,34923849227,1500000000,1500000000
155977163891,1641853793,67646,157477163891,62846,235191933444,1500000000,1500000000
90858075580,1642704581,310254,95858075580,310254,159939745994,5000000000,5000000000
328635672750,1641807198,334366,330406258370,334366,424489739158,1770585620,1770585620
20883755295,1646401423,318504,22383755295,318504,31349226248,1500000000,1500000000
78520852683,1642678265,64693,80520852683,59893,103792730888,2000000000,2000000000
58965502045,1646682648,336899,60465502045,336899,97166414584,1500000000,1500000000
111405405784,1642702220,316626,112905405784,316626,143545480740,1500000000,1500000000
23016001940,1646638625,60850,24516001940,60850,26772973943,1500000000,1500000000
259380576084,1641837249,54957,260880576084,50157,375859318182,1500000000,1500000000
97625542964,1642667346,67646,99275542964,62846,135020720185,1650000000,1650000000
101131055553,1642658115,55580,103131055553,50780,116512595257,2000000000,2000000000
42298720094,1645892787,332005,43695690590,332005,45917038659,1396970496,1396970496
21959240802,1646658545,67646,23459240802,62846,30107577354,1500000000,1500000000
205397207283,1641822754,310856,206897207283,310856,264545963625,1500000000,1500000000
79571194173,1642670550,319785,81071194173,319785,97147343333,1500000000,1500000000
51171150885,1646677114,300721,52671150885,300721,62078266933,1500000000,1500000000
51171150885,1646677114,300258,52671150885,300258,57666577108,1500000000,1500000000
64042840705,1646688358,327429,65542840705,327429,70000000000,1500000000,1500000000
30167000389,1646373744,324776,31667000389,324776,36127291778,1500000000,1500000000
35486850758,1646368065,55580,36986850758,50780,38000000000,1500000000,1500000000
30119287345,1646401203,60862,31619287345,56062,39170938715,1500000000,1500000000
77165865240,1642682570,52928,78665865240,48128,96581717172,1500000000,1500000000
83231042855,1642666521,67646,84731042855,62846,89110672238,1500000000,1500000000
63792295530,1642689178,327419,70716011623,327419,,,
96012556571,1642657764,331189,97512556571,331189,97668887415,1500000000,1500000000
156498451610,1642702403,67634,157998451610,67634,184648694022,1500000000,1500000000
142835374334,1641773767,310858,144335374334,310858,162811328393,1500000000,1500000000
19293934531,1646377205,333682,20793934531,333682,30449429733,1500000000,1500000000
37116931357,1646399065,67646,38616931357,62846,52945384249,1500000000,1500000000
122205623839,1642645545,320535,123705623839,320535,137812282019,1500000000,1500000000
286897094215,1641831907,67634,288397094215,67634,343954880317,1500000000,1500000000
162597772681,1642701852,54771,164097772681,54771,186079838813,1500000000,1500000000
254846747992,1641823866,60850,256346747992,56050,272010603718,1500000000,1500000000
220314540753,1641830294,54848,221814540753,50048,304227440407,1500000000,1500000000
29203609150,1646404382,67646,31203609150,62846,36542496007,2000000000,2000000000
25245409730,1646401959,55580,26745409730,55580,35632524624,1500000000,1500000000
43384310706,1645838712,55592,44464087274,50792,44464087274,1500000000,1079776568
43619420787,1646419189,60862,45119420787,56062,49935298964,1500000000,1500000000
25654981885,1646389364,55592,26754981885,50792,31000000000,1100000000,1100000000
19552162382,1646652720,67646,21052162382,62846,30146741410,1500000000,1500000000
33856196801,1646622756,52928,34856196801,48128,35151158618,1000000000,1000000000
79792603575,1641792578,336931,81292603575,336931,111353920127,1500000000,1500000000
28017098636,1646376156,317306,29517098636,317306,41096159837,1500000000,1500000000
111858212072,1641793237,328000,113358212072,328000,153859124167,1500000000,1500000000
176275837623,1641852767,55705,177775837623,50905,277503329997,1500000000,1500000000
94555638989,1642685674,330006,96055638989,330006,121572368893,1500000000,1500000000
52037015398,1646682686,327370,53537015398,310277,69704214905,1500000000,1500000000
28284231300,1646400867,60862,29784231300,56062,39068556798,1500000000,1500000000
24912670645,1646391376,330523,26412670645,330523,35398393523,1500000000,1500000000
44526484630,1646613096,311281,46026484630,311281,49886252782,1500000000,1500000000
211763937403,1641807862,318450,213263937403,318450,316245604309,1500000000,1500000000
238265884206,1641828547,55781,239765884206,50981,309824609177,1500000000,1500000000
35719836116,1646620248,324188,37219836116,324188,47751001989,1500000000,1500000000
221993265058,1641829656,60838,223493265058,60838,306775597332,1500000000,1500000000
55105673316,1646438131,317342,56605673316,317342,70409399183,1500000000,1500000000
86566313867,1642678111,60838,88066313867,60838,106929923790,1500000000,1500000000
181864066838,1641843799,340035,183364066838,340035,231153782264,1500000000,1500000000
29687565459,1646363236,54771,31187565459,49971,50401727262,1500000000,1500000000
49356193990,1646353119,60862,50463265902,60862,50463265902,1500000000,1107071912
63740336963,1645837523,55580,65240336963,55580,88250569218,1500000000,1500000000
32779122767,1646620298,307156,34279122767,307156,42159353370,1500000000,1500000000
306757529117,1641836624,319763,308257529117,319763,515205500067,1500000000,1500000000
55728578366,1646409363,67646,57728578366,62846,67427139638,2000000000,2000000000
51556694697,1645899269,329903,53056694697,329903,64163051608,1500000000,1500000000
278457458982,1641838887,323053,280123402991,323053,366048208392,1665944009,1665944009
176765556834,1641798222,67634,178265556834,62834,215976322684,1500000000,1500000000
33141638755,1646361790,60850,34641638755,56050,43022037939,1500000000,1500000000
114503999152,1642704173,319767,116003999152,319767,125000000000,1500000000,1500000000
71636342660,1642666500,336903,73136342660,336903,88436563239,1500000000,1500000000
35482192275,1646623908,66778,36982192275,61978,50889744827,1500000000,1500000000
93224705321,1646688169,67646,94724705321,62846,120152429935,1500000000,1500000000
123422370589,1641801755,54824,124922370589,50024,140564827170,1500000000,1500000000
160963490102,1641784350,340023,162463490102,340023,216208371134,1500000000,1500000000
26434923845,1646399282,321881,27934923845,321881,42803292453,1500000000,1500000000
115426718785,1642644906,60850,116926718785,56050,130858524173,1500000000,1500000000
78493123895,1641781455,302853,89100000000,302853,,,
78493123895,1641781455,326161,89452145143,326161,,,
19826507845,1646395149,60862,21326507845,56062,26292420305,1500000000,1500000000
73253979773,1642673908,336911,75253979773,336911,78000000000,2000000000,2000000000
41662120236,1645840216,55592,42732120236,50792,44603444114,1070000000,1070000000
25610707499,1645857201,600000,28157652053,251296,,,
20665752056,1646637765,307803,22165752056,307803,31695061684,1500000000,1500000000
21593373287,1646635076,64717,23093373287,64717,30877883277,1500000000,1500000000
73749242625,1645836287,55648,76249242625,55648,150542584294,2500000000,2500000000
34711880268,1646372963,54346,36711880268,49546,41293052056,2000000000,2000000000
64684063267,1642689380,324862,70716011623,324862,,,
43471365587,1645835621,60862,44971365587,56062,56011808383,1500000000,1500000000
105221998627,1641802466,67634,106721998627,62834,127380243084,1500000000,1500000000
25399411596,1646669791,60862,26899411596,56062,39606218753,1500000000,1500000000
37244714774,1646678547,67646,38744714774,62846,46406126264,1500000000,1500000000
94590890318,1641798965,337476,96090890318,337476,100000000000,1500000000,1500000000
42115176477,1646438160,297036,43615176477,297036,70382091645,1500000000,1500000000
24383252268,1646631177,55592,25883252268,50792,27710421635,1500000000,1500000000
25359988702,1646656968,327413,26859988702,327413,31208356442,1500000000,1500000000
30007662128,1646384793,60862,31143197053,56062,31143197053,1500000000,1135534925
26036895211,1646402635,49471,27536895211,49471,30432448620,1500000000,1500000000
122743079841,1641800265,55580,124243079841,55580,127800036037,1500000000,1500000000
26968920275,1645918311,284388,28468920275,284388,36811857374,1500000000,1500000000
30275216350,1645862786,332462,31775216350,332462,35570931495,1500000000,1500000000
30551653673,1646640343,286660,32051653673,286660,37732760988,1500000000,1500000000
240403890107,1641809539,331097,241903890107,331097,263913033683,1500000000,1500000000
108967496936,1641795575,60838,110467496936,60838,117008673597,1500000000,1500000000
81006759388,1642675449,60850,82506759388,56050,93092388818,1500000000,1500000000
22636291942,1646653301,55648,25136291942,55648,51800710804,2500000000,2500000000
151259992324,1642662063,56516,152759992324,51716,333000000000,1500000000,1500000000
24651774104,1646659433,67646,26151774104,62846,35627414572,1500000000,1500000000
93217734508,1641804536,55592,94717734508,50792,108927115934,1500000000,1500000000
125718219699,1641800397,337544,127218219699,337544,175608165419,1500000000,1500000000
125718219699,1641800397,67622,127218219699,67622,175608165419,1500000000,1500000000
107230482803,1641781710,323650,108730482803,323650,119644838545,1500000000,1500000000
284410499229,1641837127,49495,285910499229,44695,449334073503,1500000000,1500000000
115983376702,1642714745,66778,118483376702,61978,125009801522,2500000000,2500000000
456378593898,1641826428,55580,457878593898,55580,608918742337,1500000000,1500000000
32536339631,1646375578,55580,34536339631,55580,38574406060,2000000000,2000000000
29170187336,1646358457,59994,30670187336,59994,41416410594,1500000000,1500000000
327167544465,1642721867,62151,329336511850,57351,475917258948,2168967385,2168967385
160991069538,1642702043,66766,162491069538,66766,182998963528,1500000000,1500000000
35289603136,1645866356,59970,36789603136,55170,39334187695,1500000000,1500000000
260138858089,1641827303,52928,261402305312,48128,261402305312,1410000000,1263447223
162489942286,1641844750,60850,163989942286,60850,267459127343,1500000000,1500000000
35790059443,1646679068,317256,37290059443,317256,49542967039,1500000000,1500000000
22799341505,1646670561,66730,24299341505,66730,33233640649,1500000000,1500000000
112594835664,1641803863,319785,114094835664,319785,136798428477,1500000000,1500000000
24705900418,1645878737,67634,26205900418,67634,39391419189,1500000000,1500000000
33033623879,1646675375,60838,34533623879,56038,44201689199,1500000000,1500000000
100148861505,1642691023,67634,101648861505,67634,122248827768,1500000000,1500000000
101577221210,1642688965,67646,103077221210,67646,123013053330,1500000000,1500000000
292125751120,1641829179,54957,293625751120,50157,326090056279,1500000000,1500000000
90394662958,1641789469,323052,91804662958,323052,95000000000,1410000000,1410000000
110532025210,1641804927,328777,112032025210,328777,125962969093,1500000000,1500000000
332362409494,1642721685,55580,335019173217,50780,447030485812,2656763723,2656763723
43531236167,1646677765,49483,45031236167,49483,57234288430,1500000000,1500000000
32795668892,1646398562,313515,34295668892,313515,41178883347,1500000000,1500000000
127311144947,1641857631,54872,129811144947,54872,280214128510,2500000000,2500000000
105898771305,1641791928,67634,107398771305,67634,124565427549,1500000000,1500000000
105898771305,1641791928,67646,107898771305,62846,145967205290,2000000000,2000000000
77349478503,1642677950,317300,78849478503,317300,125240653928,1500000000,1500000000
49650867471,1645839921,64741,51150867471,59941,59609155209,1500000000,1500000000
28542343342,1646673764,60938,30000000000,60938,30000000000,1500000000,1457656658
250948805791,1641830796,67634,252448805791,67634,281041874848,1500000000,1500000000
237532225167,1641829441,67646,239032225167,62846,293426692833,1500000000,1500000000
18579802692,1646383765,327393,20079802692,327393,26633475039,1500000000,1500000000
139286532335,1641800394,67634,140786532335,62834,145082981162,1500000000,1500000000
201896582655,1641830144,60850,203396582655,60850,244173735228,1500000000,1500000000
64531944098,1642676269,64729,66031944098,59929,97220844518,1500000000,1500000000
99856458889,1642649324,307061,101856458889,307061,136214702942,2000000000,2000000000
32050694329,1646383521,67634,33550694329,62834,33888521743,1500000000,1500000000
99421608929,1641778023,66742,100921608929,66742,145625968072,1500000000,1500000000
51738706127,1646421318,67634,54514450498,62834,,,
127109117649,1642693559,67634,128609117649,67634,165594571417,1500000000,1500000000
179798122829,1642661030,54860,181298122829,54860,240295832444,1500000000,1500000000
64221082169,1646612046,310961,65721082169,310961,67420875124,1500000000,1500000000
193465730435,1642714324,60862,194965730435,56062,256361592242,1500000000,1500000000
95880494149,1641803254,340699,97380494149,340699,118724901563,1500000000,1500000000
49282540206,1646674467,331101,50782540206,331101,59730289137,1500000000,1500000000
24945803139,1646383943,324798,26445803139,324798,29767704500,1500000000,1500000000
232758327200,1641832092,60874,234258327200,56074,319252314510,1500000000,1500000000
83646481426,1642690510,67634,85146481426,67634,109789790988,1500000000,1500000000
78235616063,1642689514,60838,79735616063,60838,115239899767,1500000000,1500000000
95192421350,1641793598,60862,96692421350,56062,121486363632,1500000000,1500000000
33576569429,1646395621,55592,35076569429,50792,48221511495,1500000000,1500000000
31831646316,1646369789,54676,32831646316,49876,34513741883,1000000000,1000000000
95882762178,1641792573,336863,97382762178,336863,111353920127,1500000000,1500000000
30206792211,1646661727,55580,31706792211,50780,37166172225,1500000000,1500000000
181089609073,1641853551,60862,182589609073,56062,216898014185,1500000000,1500000000
78016687789,1646355796,324176,79516687789,324176,93955142715,1500000000,1500000000
138448131280,1641784438,60850,139948131280,60850,182701261119,1500000000,1500000000
35030969800,1646695655,314138,36530969800,314138,45009573948,1500000000,1500000000
69337997890,1642679643,55624,70837997890,50824,77239158910,1500000000,1500000000
23642731395,1646670820,321686,25142731395,321686,30700381917,1500000000,1500000000
19972190509,1646647066,55693,21472190509,50893,25132591634,1500000000,1500000000
34971250099,1646361266,67634,36471250099,62834,43690748929,1500000000,1500000000
153269453630,1642714708,52916,154769453630,48116,194422682358,1500000000,1500000000
85162589194,1642690494,55636,87662589194,55636,175763665580,2500000000,2500000000
16290047244,1646652870,56516,18290047244,51716,30779350866,2000000000,2000000000
97404331204,1641793676,60838,102791580210,60838,,,
23058070315,1646385483,60850,24558070315,56050,36948300482,1500000000,1500000000
53379998493,1645839370,55592,54879998493,50792,63928084993,1500000000,1500000000
57580789870,1646685998,67646,59080789870,62846,59100628305,1500000000,1500000000
373483595503,1641826530,60862,374983595503,56062,418435974999,1500000000,1500000000
193015613200,1641845852,54861,195515613200,54861,413546863724,2500000000,2500000000
108303709305,1642642816,66754,109803709305,61954,137801997069,1500000000,1500000000
142054196063,1642661348,314162,143704196063,314162,145000000000,1650000000,1650000000
44710045630,1646697256,67646,46710045630,62846,53671830430,2000000000,2000000000
45823531838,1646353227,60850,47323531838,60850,52420118607,1500000000,1500000000
109635179260,1642686325,336935,111135179260,336935,155020643227,1500000000,1500000000
114661262557,1642693400,60850,116161262557,56050,120106262115,1500000000,1500000000
114661262557,1642693400,322973,120106262115,322973,,,
166700520924,1642697716,333744,168200520924,333744,170247644582,1500000000,1500000000
120572378725,1642650323,48711,122072378725,43911,158929585468,1500000000,1500000000
30216434613,1646670292,67634,31716434613,62834,39021382359,1500000000,1500000000
79194982407,1645913324,67634,80694982407,67634,106842404083,1500000000,1500000000
22413794672,1645869264,339973,24413794672,339973,31093247446,2000000000,2000000000
83572877475,1641804714,55580,85072877475,50780,100657336538,1500000000,1500000000
22493705982,1646637124,317294,23993705982,317294,25208873054,1500000000,1500000000
403425199787,1641825884,55580,404925199787,50780,460417875409,1500000000,1500000000
32605437904,1646622791,314200,34105437904,314200,41305249650,1500000000,1500000000
30626834345,1646667972,310173,32126834345,310173,34799964549,1500000000,1500000000
30626834345,1646667972,60938,32126834345,56138,34799964549,1500000000,1500000000
80080633892,1642692848,67646,81580633892,62846,81708908593,1500000000,1500000000
26459264029,1646650974,326862,27959264029,326862,30902741318,1500000000,1500000000
47704029226,1646408279,317286,49204029226,317286,54892009798,1500000000,1500000000
23943331614,1646680340,331113,25000000000,331113,25000000000,25000000000,1056668386
256980125473,1641831545,54800,258480125473,54800,299021200764,1500000000,1500000000
37968758141,1646360950,313449,39378758141,313449,40384764163,1410000000,1410000000
43176661404,1646357947,60862,44141726424,56062,44141726424,1500000000,965065020
33983606229,1645894895,54747,35483606229,54747,49714745127,1500000000,1500000000
51398057375,1645847268,340645,52898057375,340645,55130553788,1500000000,1500000000
218019208186,1641809188,60838,219429208186,56038,243341040383,1410000000,1410000000
18171733785,1646395310,55592,19671733785,50792,21638910871,1500000000,1500000000
37048158524,1646371085,55592,39048158524,50792,43236032840,2000000000,2000000000
65321729316,1642689575,67634,66821729316,62834,97771454527,1500000000,1500000000
121528629640,1641797203,323114,123028629640,323114,144303230083,1500000000,1500000000
122107503541,1641800602,67646,123607503541,62846,141481602162,1500000000,1500000000
122931268113,1641793344,313425,124431268113,313425,141322765090,1500000000,1500000000
122931268113,1641793344,328000,124431268113,241879,153859124167,1500000000,1500000000
187782826140,1641846117,54848,189282826140,50048,258702284878,1500000000,1500000000
102024673754,1642691401,67634,103524673754,62834,115569243349,1500000000,1500000000
65066577657,1646616275,67734,66566577657,62934,72180504473,1500000000,1500000000
157022854802,1641858074,67622,158522854802,67622,200983777608,1500000000,1500000000
129444148734,1641779145,336879,130944148734,336879,164453282577,1500000000,1500000000
48338717102,1646356192,60850,49838717102,60850,56254350999,1500000000,1500000000
48338717102,1646356192,52916,49838717102,52916,56254350999,1500000000,1500000000
30801552027,1646633250,64741,32801552027,59941,40443735905,2000000000,2000000000
23461654802,1646396785,67634,24961654802,62834,34005330507,1500000000,1500000000
189750599607,1642718578,314059,193000000000,314059,,,
84886119168,1642685547,336909,86386119168,336909,87098595025,1500000000,1500000000
38713482823,1646362836,330561,40213482823,330561,65731542964,1500000000,1500000000
251705572566,1641829859,340037,253205572566,340037,373842793513,1500000000,1500000000
27880133275,1645875802,60838,29380133275,56038,43478941843,1500000000,1500000000
135284816040,1642651510,67634,136784816040,67634,191116421935,1500000000,1500000000
71890707162,1642644643,67634,73390707162,62834,75000000000,1500000000,1500000000
40828363052,1645860244,60850,42328363052,56050,47834249899,1500000000,1500000000
322269249520,1641827188,333764,323769249520,333764,446396718548,1500000000,1500000000
31385593692,1645878842,60850,32885593692,56050,40317077325,1500000000,1500000000
28843375830,1645866308,66766,30353375830,61966,36022336867,1510000000,1510000000
34911634392,1646667572,67646,36411634392,62846,39359665255,1500000000,1500000000
17663138333,1646665659,60850,19663138333,60850,20000000000,2000000000,2000000000
202888494598,1641843461,54872,204388494598,50072,231322502548,1500000000,1500000000
28988552896,1646645862,67646,30488552896,62846,33711186140,1500000000,1500000000
109845346236,1641797482,343221,111345346236,343221,111868997348,1500000000,1500000000
185137904263,1641857899,338736,186637904263,338736,214011268210,1500000000,1500000000
228113657902,1641830173,60850,229613657902,60850,253870728319,1500000000,1500000000
20466249987,1646386564,60862,21966249987,56062,29645568557,1500000000,1500000000
262940024001,1641812279,60862,264440024001,60862,377913268527,1500000000,1500000000
19002031626,1646654439,332866,20502031626,332866,21744912995,1500000000,1500000000
155286377532,1641786798,60838,156786377532,60838,179559202567,1500000000,1500000000
170825456360,1642697713,330028,172325456360,330028,194354450950,1500000000,1500000000
133216079246,1641805027,55580,134716079246,55580,159219458519,1500000000,1500000000
144724142362,1641857976,67646,146224142362,62846,150000000000,1500000000,1500000000
210752753261,1641842429,54884,212252753261,50084,258351556318,1500000000,1500000000
132859975246,1641799883,55580,134509975246,55580,137741893712,1650000000,1650000000
75369812643,1646414616,49507,76869812643,44707,90610211080,1500000000,1500000000
42519502400,1645854822,346352,44029502400,346352,48885667983,1510000000,1510000000
35450316041,1646673727,60862,36950316041,56062,41974375399,1500000000,1500000000
216052516158,1641821797,325619,217552516158,325619,246117501344,1500000000,1500000000
189247038804,1642661139,60850,190747038804,56050,277391848133,1500000000,1500000000
110820625013,1641804170,337488,112320625013,337488,133805177938,1500000000,1500000000
245357303733,1641852247,59934,246857303733,55134,275048140139,1500000000,1500000000
262963017845,1641833742,60850,264463017845,56050,423277662189,1500000000,1500000000
26984454147,1646394910,55648,29484454147,55648,62929051352,2500000000,2500000000
73962208203,1642667964,330523,75462208203,330523,96777720455,1500000000,1500000000
60468829558,1645846819,340625,61998829558,340625,70009493574,1530000000,1530000000
23469532989,1645872630,346346,25469532989,346346,35436682107,2000000000,2000000000
86968690372,1642668315,55636,89468690372,55636,201285577992,2500000000,2500000000
23465106280,1646645890,60874,24965106280,56074,34018396129,1500000000,1500000000
19508013725,1646629561,67634,21008013725,62834,30255450777,1500000000,1500000000
112657868847,1642658249,55693,114157868847,50893,155847332320,1500000000,1500000000
25226866756,1645854237,349490,27523947407,349490,,,
36398812451,1646675255,64067,37898812451,59267,39603020148,1500000000,1500000000
305623240562,1641807357,334334,307239206251,334334,372875969119,1615965689,1615965689
160032036270,1641845587,322961,161532036270,322961,182065217042,1500000000,1500000000
92028926261,1642641184,301672,93528926261,301672,135140011718,1500000000,1500000000
127328616910,1641786212,334344,128828616910,334344,140000000000,1500000000,1500000000
82859242811,1642662708,54884,84359242811,50084,121492566295,1500000000,1500000000
54040309348,1645902749,60850,55540309348,60850,65570517972,1500000000,1500000000
27417837112,1646680258,60862,28917837112,56062,44032928595,1500000000,1500000000
77197773014,1642682942,58612,78697773014,58612,111782532877,1500000000,1500000000
18132361895,1645875287,326802,19632361895,326802,20000000000,1500000000,1500000000
56162934109,1646622081,52916,57662934109,52916,66772971030,1500000000,1500000000
335204149925,1641834225,60850,336704149925,56050,400061968267,1500000000,1500000000
198291407886,1641834820,336887,200000000000,336887,200000000000,1815000000,1708592114
43474508368,1646408694,67634,56282747433,67634,,,
39947567125,1645854755,322871,41947567125,322871,47804672459,2000000000,2000000000
178723982546,1642715386,55592,180223982546,50792,197394743255,1500000000,1500000000
55551427556,1646683269,293097,57491427556,293097,63667068958,1940000000,1940000000
83300484805,1642688779,60838,84800484805,60838,92738677900,1500000000,1500000000
117584544971,1641773723,67634,119084544971,62834,186613822462,1500000000,1500000000
214090965202,1641848539,60850,215590965202,60850,282420091695,1500000000,1500000000
23567063449,1646638080,324172,25067063449,324172,35885118177,1500000000,1500000000
85974398181,1641793678,340077,87474398181,340077,90399128873,1500000000,1500000000
25096747260,1646377267,60850,26596747260,56050,28630793687,1500000000,1500000000
108099503437,1642686015,60850,109599503437,56050,114298868100,1500000000,1500000000
78217778439,1642689339,331211,79717778439,331211,80000000000,1500000000,1500000000
80676419854,1642681406,319795,82176419854,319795,107509668320,1500000000,1500000000
39475234922,1645859067,60838,40975234922,56038,54152404179,1500000000,1500000000
20585606371,1646631515,60850,22085606371,56050,29910718633,1500000000,1500000000
271136843985,1641807492,334352,272704330703,334352,294699283408,1567486718,1567486718
32552887079,1646625648,333724,34052887079,333724,39493243434,1500000000,1500000000
129010991400,1646428577,71201,139010991400,59929,301304579300,10000000000,10000000000
71865046737,1642669030,60862,73365046737,56062,89129793228,1500000000,1500000000
86806272720,1642682584,67646,88306272720,62846,96581717172,1500000000,1500000000
64569645896,1646687114,67646,66069645896,62846,83239205193,1500000000,1500000000
28563787679,1645888496,66802,30063787679,66802,41050006590,1500000000,1500000000
28857500570,1646638308,55580,30008090967,55580,30008090967,1500000000,1150590397
32995519424,1646618059,60838,34495519424,56038,42711091704,1500000000,1500000000
196812509969,1641829995,326147,198462509969,326147,200000000000,1650000000,1650000000
155589197366,1641785830,54872,158089197366,54872,306121639250,2500000000,2500000000
32761395161,1646660770,54296,34261395161,49496,45733820349,1500000000,1500000000
284175897542,1641811357,60862,285675897542,56062,445957607527,1500000000,1500000000
29194202626,1646662827,56516,30694202626,51716,41453064849,1500000000,1500000000
50016917397,1646413305,67622,51516917397,67622,59901674788,1500000000,1500000000
87260646403,1642694551,334360,88760646403,334360,124135828887,1500000000,1500000000
29354346308,1646634879,67646,30854346308,67646,38778098600,1500000000,1500000000
26929992595,1646642426,67634,28429992595,58034,38709352804,1500000000,1500000000
174032708953,1641851321,335564,175532708953,335564,227565157049,1500000000,1500000000
174032708953,1641851321,336893,175532708953,336893,227565157049,1500000000,1500000000
118770508117,1641800561,67646,120270508117,62846,152776697733,1500000000,1500000000
28922326753,1646393446,67634,30422326753,62834,32164698405,1500000000,1500000000
29535503032,1645860416,335731,31045503032,335731,41379413253,1510000000,1510000000
79616765294,1642653870,54848,81116765294,50048,100453926633,1500000000,1500000000
130916844583,1642653251,54945,132416844583,50145,158303953899,1500000000,1500000000
31070958786,1646639515,55580,32570958786,55580,43452504915,1500000000,1500000000
159587022086,1641858072,64741,161087022086,59941,200280837834,1500000000,1500000000
139966806293,1642704392,302680,141466806293,302680,143661340117,1500000000,1500000000
413853660778,1641826803,331113,415353660778,331113,446334782679,1500000000,1500000000
23720989050,1646382204,55648,26220989050,55648,48266542306,2500000000,2500000000
21200099402,1646632242,329329,22700099402,329329,39604924598,1500000000,1500000000
97630837927,1641775835,328026,99630837927,328026,100000000000,2000000000,2000000000
240378394790,1641849490,60862,241878394790,56062,257922800692,1500000000,1500000000
115869343093,1642704998,55620,117369343093,55620,144105908584,1500000000,1500000000
38483973736,1646674559,334314,39983973736,317214,61735980257,1500000000,1500000000
205916162244,1641856968,54872,208416162244,54872,414350272866,2500000000,2500000000
277823420135,1642699598,56516,279823420135,51716,300000000000,2000000000,2000000000
76222176364,1642667942,53424,77722176364,48624,121059227159,1500000000,1500000000
48954688472,1646368415,55592,50228147874,55592,50228147874,1410000000,1273459402
78761245031,1641799350,60850,80261245031,56050,93263414255,1500000000,1500000000
113577880188,1642661647,331161,115077880188,331161,116909923072,1500000000,1500000000
113577880188,1642661647,307090,114987880188,307090,115264135529,1410000000,1410000000
103388758503,1642668213,322001,104888758503,322001,112354777734,1500000000,1500000000
133022977189,1641797739,334354,134522977189,334354,139365222233,1500000000,1500000000
203675316598,1641812794,67634,205175316598,52314,396234116569,1500000000,1500000000
41127430068,1646674568,60874,42627430068,56074,49604967170,1500000000,1500000000
395827105888,1641811043,67646,397327105888,62846,452825829524,1500000000,1500000000
144296614013,1641854904,67646,145796614013,62846,212518455845,1500000000,1500000000
308404571720,1641830970,60850,309904571720,60850,327250522522,1500000000,1500000000
24067267705,1646392166,60862,25067267705,60862,25439768971,1000000000,1000000000
26401627904,1646379095,67634,27989961890,62834,27989961890,1881800000,1588333986
152110279387,1642696878,60850,153610279387,56050,204537378112,1500000000,1500000000
23093843315,1645869431,60850,24593843315,56050,33507996734,1500000000,1500000000
142928481662,1641788274,67646,144428481662,62846,183689700072,1500000000,1500000000
141595725638,1641800662,55592,143095725638,50792,169636150864,1500000000,1500000000
18497242829,1646390437,55580,19084644566,55580,19084644566,1000000000,587401737
82455905824,1642687873,67646,83955905824,62846,90000000000,1500000000,1500000000
57379509054,1646616337,54261,58879509054,49461,82833222072,1500000000,1500000000
101040028829,1641800175,319297,102540028829,319297,116000000000,1500000000,1500000000
34441706621,1646374204,333732,35941706621,333732,39917092202,1500000000,1500000000
63023838083,1642675491,327992,75000000000,327992,,,
83459080121,1645843158,55592,84959080121,50792,85121562293,1500000000,1500000000
71818406256,1646407492,324206,73318406256,324206,76341310659,1500000000,1500000000
70571039970,1642689099,60850,72071039970,56050,89345731992,1500000000,1500000000
143191584074,1642653045,54860,144691584074,54860,150068214089,1500000000,1500000000
52526547966,1645891506,338250,53554178348,338250,60126086244,1027630382,1027630382
71527415619,1646686256,67646,73027415619,62846,74369091967,1500000000,1500000000
23690210750,1646401547,67634,25190210750,62834,30533264559,1500000000,1500000000
27849873635,1646386485,67646,29349873635,62846,32585491830,1500000000,1500000000
45634067897,1646353517,60850,47134067897,56050,51573608567,1500000000,1500000000
30289849661,1646358399,66766,31789849661,61966,41493364639,1500000000,1500000000
87655595761,1642651977,319634,89655595761,319634,90000000000,2000000000,2000000000
47613363111,1646678042,67634,49113363111,67634,60800034373,1500000000,1500000000
97819459979,1641794192,55693,99319459979,50893,103405325118,1500000000,1500000000
51069470496,1646411779,316578,52569470496,316578,56895943873,1500000000,1500000000
26009900755,1646392647,67646,27509900755,62846,30332448280,1500000000,1500000000
68611304762,1642680083,54884,70111304762,50084,98170546933,1500000000,1500000000
110361708018,1641795132,59958,111861708018,59958,177965147928,1500000000,1500000000
25713136405,1646375517,320473,27213136405,320473,27370759644,1500000000,1500000000
103578889518,1642655957,55681,105078889518,50881,145302296688,1500000000,1500000000
88461215676,1642695035,331179,89000000000,331179,89000000000,1500000000,538784324
79992250695,1642667654,55624,82492250695,55624,177559893354,2500000000,2500000000
172774841748,1644252325,64067,174274841748,59267,190665812137,1500000000,1500000000
147767577432,1644243920,60874,149767577432,56074,187362798144,2000000000,2000000000
147767577432,1644243920,67658,149767577432,62858,187362798144,2000000000,2000000000
111405216394,1644254687,346983,112905216394,346983,172949772085,1500000000,1500000000
52423042210,1644313096,55608,53923042210,50808,69108672849,1500000000,1500000000
73926979445,1644306149,64729,75426979445,55129,78742883592,1500000000,1500000000
101353562184,1644302439,337478,102853562184,337478,122092498173,1500000000,1500000000
83193709354,1644194280,54334,84693709354,49534,115878014638,1500000000,1500000000
63830701841,1644331081,55608,65330701841,50808,80907180337,1500000000,1500000000
50785636027,1644232403,63200,53285636027,63200,132424336430,2500000000,2500000000
90860835433,1644288762,319761,92360835433,319761,110952380415,1500000000,1500000000
90860835433,1644288762,316578,92360835433,316578,98800988275,1500000000,1500000000
110393184998,1644276732,340611,111893184998,340611,135606442873,1500000000,1500000000
85993265865,1644212108,323529,87493265865,323529,121712767860,1500000000,1500000000
45701868404,1644238273,337512,47201868404,337512,63742077158,1500000000,1500000000
95399426417,1644273582,67634,96899426417,67634,106612769357,1500000000,1500000000
159319849495,1644247809,343789,160819849495,343789,179864951898,1500000000,1500000000
73190478493,1644239005,67646,74690478493,62846,77748153143,1500000000,1500000000
73190478493,1644239005,334306,74690478493,334306,84645851115,1500000000,1500000000
63508995553,1644224299,64067,65448995553,59267,72706529428,1940000000,1940000000
64177131236,1644226385,64067,65677131236,59267,96740883490,1500000000,1500000000
119245669775,1644194038,66754,120745669775,61954,136596112963,1500000000,1500000000
383937156376,1644260679,53264,385603100385,43664,448816124477,1665944009,1665944009
116408036374,1644270354,67622,117908036374,62822,141477230307,1500000000,1500000000
72293252466,1644293996,335124,73793252466,335124,83109681664,1500000000,1500000000
92024696513,1644302383,49495,94024696513,49495,118453344148,2000000000,2000000000
125734270309,1644249548,343185,127234270309,343185,133647858317,1500000000,1500000000
52135239435,1644241418,49495,54135239435,44695,76143954475,2000000000,2000000000
87515088891,1644335011,314122,89015088891,314122,111462347154,1500000000,1500000000
78328340780,1644225774,54872,79828340780,50072,100346136337,1500000000,1500000000
108255487556,1644250213,343183,109755487556,343183,145869462628,1500000000,1500000000
142424526025,1644249729,55636,144924526025,55636,308927896002,2500000000,2500000000
93895052179,1644272014,55584,95395052179,50784,134242982924,1500000000,1500000000
54070589961,1644235214,322970,55570589961,322970,65554013958,1500000000,1500000000
120162683602,1644256219,331139,121662683602,331139,133097342952,1500000000,1500000000
107938812544,1644348426,66814,109438812544,66814,147396225122,1500000000,1500000000
82136941590,1644364482,67634,83636941590,62834,90000000000,1500000000,1500000000
76822691800,1644358695,332390,78322691800,332390,92434912427,1500000000,1500000000
134962732837,1644197905,318418,136462732837,318418,163768893967,1500000000,1500000000
73864788368,1644224750,326794,75364788368,326794,83442020685,1500000000,1500000000
72723660461,1644211297,340649,74223660461,340649,95334670630,1500000000,1500000000
47360819816,1644323174,331139,48860819816,331139,67616468938,1500000000,1500000000
72710018734,1644358579,55584,74210018734,50784,92694565587,1500000000,1500000000
69895342019,1644344152,55584,71395342019,50784,77641117314,1500000000,1500000000
62529017722,1644232550,326085,64029017722,326085,79602244698,1500000000,1500000000
129437562151,1644205838,343191,146903296086,343191,,,
102684982821,1644270849,337496,104184982821,337496,127405398708,1500000000,1500000000
102684982821,1644270849,55584,104184982821,50784,127405398708,1500000000,1500000000
146727441978,1644347193,60018,148227441978,60018,167294603617,1500000000,1500000000
198868142371,1644252814,343231,200368142371,343231,237982242854,1500000000,1500000000
69461121197,1644235548,335504,71461121197,335504,83938078620,2000000000,2000000000
75719928720,1644212629,315319,77219928720,315319,100028593304,1500000000,1500000000
61856964785,1644339784,314019,63356964785,314019,71459756577,1500000000,1500000000
52455402700,1644328963,324812,53955402700,324812,75429262898,1500000000,1500000000
175536303415,1644255240,54703,177036303415,49903,177615326192,1500000000,1500000000
66768489437,1644193487,328170,68268489437,328170,83280011829,1500000000,1500000000
95210208597,1644311625,55693,96710208597,36429,121351313879,1500000000,1500000000
95210208597,1644311625,55693,96710208597,50893,143711064220,1500000000,1500000000
112998644151,1644268676,55584,114498644151,50784,115358678515,1500000000,1500000000
159777998441,1644255696,51564,160618254877,51564,160618254877,1410000000,840256436
65171133059,1644299261,55717,66671133059,50917,94933473847,1500000000,1500000000
71799936211,1644331101,334342,73799936211,334342,75760278759,2000000000,2000000000
106992805122,1644349798,64067,108492805122,59267,136863508848,1500000000,1500000000
98630678356,1644208128,343185,100130678356,343185,117280596487,1500000000,1500000000
97768933702,1644345846,322474,99268933702,322474,157502857805,1500000000,1500000000
61980544921,1644231836,64067,63480544921,59267,83459768825,1500000000,1500000000
102076213180,1644282117,319643,103576213180,319643,127800200690,1500000000,1500000000
86419036745,1644358716,343205,86871415327,343205,86871415327,1500000000,452378582
175252473026,1644252977,324796,176752473026,324796,180000000000,1500000000,1500000000
87831715804,1644271944,55681,89831715804,55681,139161933907,2000000000,2000000000
133184184715,1644253695,326798,134684184715,326798,167856648962,1500000000,1500000000
133184184715,1644253695,337490,134684184715,337490,149379853122,1500000000,1500000000
86256075115,1644348026,55584,87756075115,50784,122497050624,1500000000,1500000000
92282192860,1644277325,67622,93782192860,62822,114616990402,1500000000,1500000000
136973420543,1644253685,346408,138473420543,346408,152669888664,1500000000,1500000000
64147050531,1644227375,64067,65647050531,59267,86077457407,1500000000,1500000000
73731949390,1644308971,60862,75231949390,56062,86983075470,1500000000,1500000000
92070665671,1644197364,52916,95428782052,48116,,,
116173350684,1644196286,67646,117673350684,67646,143013198833,1500000000,1500000000
62852461972,1644228202,64067,64352461972,59267,76975128082,1500000000,1500000000
109807210090,1644246390,55644,112307210090,55644,197719746504,2500000000,2500000000
52810470516,1644233407,322947,54310470516,322947,71782762724,1500000000,1500000000
83967947953,1644209009,60850,85467947953,56050,95811125522,1500000000,1500000000
95629067355,1644197327,67646,101608389587,62846,,,
58123231998,1644215721,54860,60075621164,50060,,,
132443698032,1644258570,60862,133943698032,56062,151243139234,1500000000,1500000000
85593246088,1644204593,55624,87093246088,50824,115429366043,1500000000,1500000000
49187854343,1644241128,310953,50687854343,310953,75837241033,1500000000,1500000000
59109988314,1644221818,54884,60519988314,50084,61000000000,1410000000,1410000000
58932438090,1644215279,337450,60432438090,337450,100167086652,1500000000,1500000000
68314130613,1644351269,60862,69814130613,56062,94404791675,1500000000,1500000000
53230306387,1644235385,328779,54730306387,328779,64771224420,1500000000,1500000000
45912170018,1644319754,55580,47412170018,50780,73666485453,1500000000,1500000000
137580674179,1644263444,60838,139080674179,60838,188224444802,1500000000,1500000000
144069581997,1644247808,322903,145569581997,322903,179864951898,1500000000,1500000000
182665431005,1644261888,324194,184165431005,324194,203033151952,1500000000,1500000000
113719352651,1644342672,66718,115219352651,66718,159275876463,1500000000,1500000000
146164055966,1644260071,54320,147664055966,49520,150000000000,1500000000,1500000000
146164055966,1644260071,55592,147664055966,50792,150000000000,1500000000,1500000000
74705078664,1644300717,56564,76205078664,51764,80354383013,1500000000,1500000000
79783012950,1644344671,321859,81283012950,321859,88465668827,1500000000,1500000000
50739559233,1644236457,67622,52239559233,67622,66776048168,1500000000,1500000000
50739559233,1644236457,67646,52239559233,62846,66570383027,1500000000,1500000000
60738598741,1644224467,60862,62238598741,60862,75278944318,1500000000,1500000000
60744724292,1644231071,64067,62244724292,59267,82584036630,1500000000,1500000000
68739099681,1644224522,67646,70239099681,62846,87712070170,1500000000,1500000000
132875060432,1644269830,67722,134875060432,67722,154361270659,2000000000,2000000000
159054325724,1644289821,67622,160554325724,67622,215643515748,1500000000,1500000000
90501026270,1644206804,321660,91911026270,321660,101058018069,1410000000,1410000000
143359601442,1644348302,334308,144769601442,334308,145344465601,1410000000,1410000000
100923261681,1644203586,67634,102423261681,62834,121825534040,1500000000,1500000000
65149998538,1644309885,312855,66649998538,312855,78048124605,1500000000,1500000000
106412673045,1644285335,317230,107912673045,317230,119745536170,1500000000,1500000000
149628668325,1644248624,67646,151128668325,62846,164444478757,1500000000,1500000000
84120037104,1644281712,60850,85620037104,56050,111640695875,1500000000,1500000000
49392219173,1650229907,64741,50892219173,59941,200000000000,1500000000,1500000000
14329685253,1647767733,67634,15829685253,67634,20837866509,1500000000,1500000000
173967747550,1641329371,60862,175738333170,56062,232842541132,1770585620,1770585620
13767124534,1647769787,314071,15267124534,314071,18529541555,1500000000,1500000000
174107124241,1641473743,64741,175781926241,59941,241318723379,1674802000,1674802000
122363318317,1641313039,67646,123863318317,62846,180216738290,1500000000,1500000000
104458856256,1641309379,340625,105958856256,340625,181007105983,1500000000,1500000000
123468750187,1641503619,330531,124968750187,330531,177083276718,1500000000,1500000000
16485005972,1647162461,49519,17985005972,44719,21254245364,1500000000,1500000000
118973693024,1641257265,60850,120473693024,56050,161419429064,1500000000,1500000000
291184802022,1641316548,59934,293083561707,59934,316246116859,1898759685,1898759685
82077190659,1641472251,67634,83577190659,67634,105041364863,1500000000,1500000000
137699755028,1641340360,304534,139199755028,304534,154503608045,1500000000,1500000000
162155506398,1641314232,66718,163655506398,66718,215926103270,1500000000,1500000000
161362113762,1641258855,60850,162862113762,60850,184602955948,1500000000,1500000000
180624833229,1641330990,60862,182124833229,56062,212648797912,1500000000,1500000000
13921381165,1647749323,337486,15421381165,337486,20808787327,1500000000,1500000000
18213829889,1647130922,337422,19713829889,337422,27051615893,1500000000,1500000000
18705995971,1647753846,334286,20205995971,334286,20860733080,1500000000,1500000000
152272900538,1641507445,66742,153772900538,61942,199150213428,1500000000,1500000000
124988360335,1641487144,67634,126488360335,67634,164092756327,1500000000,1500000000
124229132520,1641453798,54884,125729132520,54884,139534188183,1500000000,1500000000
150672807825,1641324423,60862,152172807825,56062,155049862315,1500000000,1500000000
67767436697,1641285546,53240,80000000000,48440,,,
19233360837,1647757093,334276,20882328738,334276,20882328738,1881800000,1648967901
121626345258,1641454079,66778,122966446048,61978,122966446048,1500000000,1340100790
148721386959,1641483895,67622,150221386959,67622,159686450183,1500000000,1500000000
148721386959,1641483895,67646,195000000000,62846,,,
103251701088,1641452414,54812,104751701088,54812,126538011959,1500000000,1500000000
22611827542,1650229041,60066,24111827542,55266,31503906574,1500000000,1500000000
32910223889,1650183005,49583,34410223889,44783,39459655474,1500000000,1500000000
16499784217,1650171512,334324,17999784217,334324,19178258499,1500000000,1500000000
19295407050,1650186633,67634,20795407050,67634,25066153837,1500000000,1500000000
25687876279,1647188492,67622,27187876279,67622,36037102980,1500000000,1500000000
71609372349,1641298882,55592,73609372349,50792,94485441792,2000000000,2000000000
62967455362,1641294303,49445,64967455362,44645,93554566171,2000000000,2000000000
132206789733,1641272680,60874,133706789733,56074,164697856723,1500000000,1500000000
40691135680,1650205137,67658,42691135680,62858,49021122609,2000000000,2000000000
40691135680,1650205137,60874,42691135680,56074,52845372563,2000000000,2000000000
19145645877,1647144503,326016,20645645877,326016,27174160169,1500000000,1500000000
34261313448,1647205799,67634,50000000000,67634,50000000000,50000000000,15738686552
14529486018,1647178089,322697,16029486018,322697,20732800904,1500000000,1500000000
84680179619,1641469139,55592,86180179619,50792,98293456755,1500000000,1500000000
13198222640,1647160928,60850,14698222640,56050,17492817353,1500000000,1500000000
116516035497,1641437977,319937,118016035497,319937,163601142820,1500000000,1500000000
25547647867,1650216617,60862,27047647867,56062,32126147320,1500000000,1500000000
22341384236,1650199817,60862,24341384236,56062,34524907727,2000000000,2000000000
124580534868,1641487188,67634,126580534868,67634,167779663814,2000000000,2000000000
12131197618,1647167336,60838,13631197618,60838,18775453405,1500000000,1500000000
32895144062,1650214396,51452,34395144062,46652,49394625708,1500000000,1500000000
108194704207,1641512144,60862,108368200833,56062,108368200833,1500000000,173496626
146121537833,1641314021,60862,147621537833,56062,158348242833,1500000000,1500000000
11495118446,1647748713,67634,12995118446,62834,15294024934,1500000000,1500000000
110865759683,1641445373,337538,112365759683,337538,143760535670,1500000000,1500000000
110865759683,1641445373,333740,112365759683,333740,143760535670,1500000000,1500000000
100542988970,1641472822,310900,102042988970,310900,140909152492,1500000000,1500000000
164875287402,1641485747,54920,166375287402,50120,198116094729,1500000000,1500000000
23725129337,1650212218,55596,25000000000,50796,25000000000,1500000000,1274870663
42388934255,1650209315,56516,43888934255,51716,50427355675,1500000000,1500000000
26556228738,1650158720,67622,28056228738,67622,28838961753,1500000000,1500000000
28478560986,1650214447,55717,29978560986,50917,48018212904,1500000000,1500000000
111989321395,1641454767,67634,113489321395,67634,133118063459,1500000000,1500000000
86189879402,1641285180,66742,87689879402,61942,120792069759,1500000000,1500000000
139433643023,1641333215,333704,141433643023,333704,173097550887,2000000000,2000000000
22276764034,1650239842,59946,23776764034,55146,29791222304,1500000000,1500000000
22276764034,1650239842,343865,23776764034,343865,29791222304,1500000000,1500000000
23413088180,1647177991,60862,24913088180,56062,31569396999,1500000000,1500000000
30365824204,1650211836,59934,31865824204,59934,34094539657,1500000000,1500000000
31049956456,1650208799,63200,32549956456,63200,68413080934,1500000000,1500000000
144280590137,1641444712,60850,145780590137,56050,200459498417,1500000000,1500000000
29411996938,1650221126,60850,30911996938,56050,35719269844,1500000000,1500000000
30629721256,1647189759,56516,32129721256,51716,41769311827,1500000000,1500000000
77279892083,1641285784,52940,78779892083,48140,87000000000,1500000000,1500000000
44454869870,1650208647,55705,45954869870,50905,59858240294,1500000000,1500000000
24815791779,1650186452,49607,26315791779,44807,32154733995,1500000000,1500000000
75813990689,1641288984,60950,77313990689,56150,111777412227,1500000000,1500000000
28918565790,1650201458,60850,30418565790,60850,38671780792,1500000000,1500000000
123750243026,1641435611,67646,125250243026,62846,130736659555,1500000000,1500000000
145404008911,1641501270,340785,147054008911,340785,193257906960,1650000000,1650000000
22028665669,1647137690,60838,23528665669,60838,34631707734,1500000000,1500000000
78536710888,1641297962,67622,80036710888,67622,99983228540,1500000000,1500000000
83008862627,1641275759,54921,84508862627,50121,300000000000,1500000000,1500000000
107588550285,1641300753,67634,109088550285,67634,151015998180,1500000000,1500000000
83885282835,1641284123,324818,85385282835,324818,94000432820,1500000000,1500000000
15394612969,1647753521,317330,16894612969,317330,20404503667,1500000000,1500000000
13939696105,1650187474,317198,15439696105,317198,24458649788,1500000000,1500000000
119836094599,1641507119,67634,121336094599,67634,169951373714,1500000000,1500000000
122406574033,1641435623,67634,126406574033,67634,220000000000,4000000000,4000000000
87414167134,1641280529,329972,88914167134,329972,113688880852,1500000000,1500000000
28175244278,1650221953,67634,29675244278,67634,42509242423,1500000000,1500000000
161933722625,1641331377,60862,163433722625,56062,258919584054,1500000000,1500000000
67505372293,1641299240,55592,69005372293,50792,85358067730,1500000000,1500000000
122856136905,1641257750,55592,124266136905,50792,159572376582,1410000000,1410000000
122856136905,1641257750,60850,124356136905,56050,176458381174,1500000000,1500000000
26822800541,1647814030,67646,27973089406,62846,27973089406,1325400000,1150288865
136989255473,1641485544,67646,138489255473,62846,143509951823,1500000000,1500000000
87893219402,1641284923,60838,89496954801,60838,89496954801,89496954801,1603735399
19780981540,1650166399,336879,21280981540,336879,36581526298,1500000000,1500000000
12972655538,1647741201,55592,14472655538,50792,25179885997,1500000000,1500000000
112455125690,1641441228,60850,116455125690,60850,150000000000,4000000000,4000000000
120412522499,1641256107,60850,121912522499,56050,156793569728,1500000000,1500000000
120412522499,1641256107,60850,121912522499,60850,180301154185,1500000000,1500000000
25239131079,1647184368,337516,26490962343,337516,26490962343,1500000000,1251831264
25239131079,1647184368,336877,26490962343,336877,26490962343,1500000000,1251831264
124784415991,1641487161,60862,126284415991,56062,161748597442,1500000000,1500000000
16045209348,1647752049,55705,17545209348,50905,25100475902,1500000000,1500000000
166022713307,1641473958,64741,167522713307,59941,194502571927,1500000000,1500000000
167096726054,1641485127,59970,168506726054,59970,170081921654,1410000000,1410000000
106591625658,1641337923,67622,108091625658,62822,151711354818,1500000000,1500000000
35522038885,1650211749,66778,37022038885,57178,49671822152,1500000000,1500000000
74758157888,1641309829,67634,76264068338,62834,78000000000,1505910450,1505910450
24715812402,1650222452,322510,26215812402,322510,28873145789,1500000000,1500000000
18446370676,1647818189,334310,19856370676,334310,20066753632,1410000000,1410000000
184809224208,1641328417,52072,186809224208,47272,217263912101,2000000000,2000000000
100954741202,1641255070,54848,102454741202,50048,112929678349,1500000000,1500000000
20021788484,1650172706,48651,21521788484,48651,29879010804,1500000000,1500000000
100406098993,1641450770,54800,101906098993,54800,132925023844,1500000000,1500000000
143350841184,1641327330,67634,144850841184,62834,161105473604,1500000000,1500000000
23823531420,1647799639,48603,25323531420,48603,28218253282,1500000000,1500000000
94944365630,1641475795,334294,96444365630,334294,121343895688,1500000000,1500000000
81816543171,1641296966,60850,83083307977,56050,83083307977,1500000000,1266764806
52127566110,1647782813,315564,53627566110,315564,59267535447,1500000000,1500000000
52127566110,1647782813,60862,53627566110,56062,59267535447,1500000000,1500000000
22495717853,1647189352,317322,23995717853,317322,29940746790,1500000000,1500000000
17474397090,1647179306,340709,20430901345,340709,20430901345,10000000000,2956504255
16171124413,1650191041,67646,17671124413,62846,22480716838,1500000000,1500000000
14669818907,1650189261,316588,16669818907,316588,21171464748,2000000000,2000000000
96864888456,1641443156,327996,98274888456,327996,101957020214,1410000000,1410000000
93154027938,1641457392,60862,95154027938,56062,117989202894,2000000000,2000000000
136171636350,1641460852,54872,138671636350,54872,259121261660,2500000000,2500000000
85709417439,1641289400,334461,87209417439,334461,88070221740,1500000000,1500000000
34273704415,1650231060,67634,35773704415,62834,43632951180,1500000000,1500000000
34092901162,1650210629,67734,35592901162,67734,40882441580,1500000000,1500000000
34092901162,1650210629,67622,35592901162,67622,40882441580,1500000000,1500000000
124300617808,1641485674,55717,125800617808,50917,157668604230,1500000000,1500000000
90179724833,1641268447,326057,91679724833,326057,112717411382,1500000000,1500000000
117556017224,1641269959,55580,119056017224,50780,144399992999,1500000000,1500000000
18270073263,1647157245,67646,19770073263,62846,29039263239,1500000000,1500000000
99061920089,1641271861,67622,100561920089,67622,131567019127,1500000000,1500000000
143264708606,1641473340,64741,144764708606,59941,164837727292,1500000000,1500000000
144170981246,1641442415,54739,145670981246,49939,161740913222,1500000000,1500000000
25249837121,1647754285,60838,26749837121,60838,28089578080,1500000000,1500000000
132379614203,1641430436,67646,133879614203,62846,146004231663,1500000000,1500000000
117238014953,1641460603,54812,118738014953,54812,141253846319,1500000000,1500000000
19089945372,1647151060,316640,21089945372,316640,25000000000,2000000000,2000000000
127104636336,1641337013,49483,128604636336,49483,133807796918,1500000000,1500000000
142774792634,1641258169,340011,144274792634,340011,160152485639,1500000000,1500000000
142774792634,1641258169,60850,144274792634,56050,160152485639,1500000000,1500000000
26551937519,1650234538,55612,28051937519,55612,41469183599,1500000000,1500000000
28845621421,1647188066,60862,30345621421,60862,37178058165,1500000000,1500000000
84256221145,1641275788,340659,85756221145,340659,97548594977,1500000000,1500000000
66730623011,1641299329,60850,68230623011,60850,72650130468,1500000000,1500000000
23940304383,1650235047,60850,25940304383,56050,32799718143,2000000000,2000000000
15496376941,1647769830,67646,16996376941,62846,18708905668,1500000000,1500000000
119571073844,1641500973,323785,121071073844,323785,149192422028,1500000000,1500000000
46954662771,1647207031,67646,48454662771,62846,52040073475,1500000000,1500000000
19537041169,1650158430,313381,20537041169,313381,23023058269,1000000000,1000000000
94805868252,1641258054,54849,96305868252,50049,139120981538,1500000000,1500000000
29479170316,1647804127,325038,30979170316,325038,36553967553,1500000000,1500000000
20217800737,1647799219,55580,21717800737,50780,29906673819,1500000000,1500000000
94473948766,1641272988,55717,95973948766,50917,123515790044,1500000000,1500000000
138733687255,1641326300,67634,140233687255,67634,140404933814,1500000000,1500000000
149498798835,1641321709,67634,150998798835,62834,186450959299,1500000000,1500000000
71651436331,1641456812,319807,73151436331,319807,80000000000,1500000000,1500000000
22765784173,1647130868,54356,24265784173,49556,37565244550,1500000000,1500000000
122141868499,1641340760,67634,123641868499,67634,136136756135,1500000000,1500000000
38477706237,1647815232,336913,39977706237,336913,43015467509,1500000000,1500000000
19041602924,1647739409,312389,21041602924,312389,30348339021,2000000000,2000000000
47063673761,1650205916,60862,49063673761,56062,51921068360,2000000000,2000000000
113669392435,1641430813,54771,115169392435,54771,136013678273,1500000000,1500000000
176000425548,1641494970,67634,177500425548,62834,197443410160,1500000000,1500000000
79617401974,1641302768,60838,81117401974,60838,99986293584,1500000000,1500000000
91407663065,1641459330,60862,92907663065,56062,105992575247,1500000000,1500000000
46340644501,1647782810,67634,47840644501,62834,59267535447,1500000000,1500000000
117210651398,1641460084,314138,118710651398,314138,140839299747,1500000000,1500000000
32799371351,1650211932,66754,34299371351,61954,41959870058,1500000000,1500000000
145002974842,1641265744,60850,146502974842,56050,153110996222,1500000000,1500000000
152487457851,1641314184,340057,153987457851,340057,180638027122,1500000000,1500000000
27289872942,1650216466,67634,28789872942,67634,37715346374,1500000000,1500000000
19130795016,1650165742,67634,20630795016,67634,29140357052,1500000000,1500000000
176069786262,1641485178,54872,177569786262,54872,222743300023,1500000000,1500000000
141450243461,1641437090,67634,142950243461,67634,175088753394,1500000000,1500000000
12489040241,1650193131,60850,13989040241,56050,20188325243,1500000000,1500000000
11049512053,1647773227,60850,12549512053,56050,16129346880,1500000000,1500000000
32726078540,1647808870,67646,33730452343,62846,45541173450,1004373803,1004373803
216392303162,1641439906,60850,220392303162,60850,287978475265,4000000000,4000000000
10777979082,1647161449,324768,12277979082,324768,18687496165,1500000000,1500000000
22836808947,1647194328,64044,24336808947,59244,26878069520,1500000000,1500000000
87801474351,1641303937,316524,89801474351,316524,116616736141,2000000000,2000000000
27226405569,1650221105,60850,28726405569,60850,32452737698,1500000000,1500000000
24523787196,1650186443,66778,26023787196,61978,32395861588,1500000000,1500000000
29287148891,1650226072,340001,30787148891,340001,38414134243,1500000000,1500000000
18748450621,1650195862,324385,20248450621,324385,23580644527,1500000000,1500000000
77994200384,1641458956,63200,80494200384,63200,178610355786,2500000000,2500000000
104488351250,1641466120,60850,105988351250,56050,116752548564,1500000000,1500000000
14293033901,1647758860,60838,15793033901,56038,16720074893,1500000000,1500000000
362295745090,1641316117,67634,364506860090,67634,434157421320,2211115000,2211115000
26999180969,1650235164,67734,28499180969,67734,38258106937,1500000000,1500000000
73561172683,1641472201,67646,75061172683,62846,78000000000,1500000000,1500000000
18918133923,1647185221,60850,20418133923,60850,30844262674,1500000000,1500000000
108995253285,1641480484,60850,110495253285,56050,112285115073,1500000000,1500000000
91584871871,1641279901,60850,93084871871,60850,101399055385,1500000000,1500000000
122419237659,1641307288,52916,123919237659,48116,133667699013,1500000000,1500000000
105834990003,1641313831,324852,107334990003,324852,129976141062,1500000000,1500000000
120695808911,1641498156,55592,122195808911,50792,126163132284,1500000000,1500000000
15156636057,1647149978,55693,16656636057,50893,21422572743,1500000000,1500000000
24614280482,1647734757,333718,26114280482,333718,29819491662,1500000000,1500000000
89162256120,1641298516,324184,90662256120,324184,107197517493,1500000000,1500000000
78571856070,1641284629,64717,80571856070,64717,92849713062,2000000000,2000000000
34267775683,1650204970,67634,35767775683,62834,46014712932,1500000000,1500000000
20131703234,1650165721,340029,23186236777,340029,,,
84334084778,1641301709,60850,85834084778,56050,108998065873,1500000000,1500000000
32634094408,1647215863,55592,34134094408,50792,34760574342,1500000000,1500000000
59718700696,1641287590,346498,61218700696,346498,81547845700,1500000000,1500000000
31849452530,1650199492,60850,33349452530,56050,33370740137,1500000000,1500000000
11035219947,1647748697,67646,12535219947,62846,15859460610,1500000000,1500000000
15950870819,1647751415,333640,17167900369,333640,19000000000,1217029550,1217029550
112028430660,1641494586,67646,113528430660,62846,124894360008,1500000000,1500000000
116728603763,1641464474,54872,119228603763,54872,210044423246,2500000000,2500000000
120260159115,1641478951,60850,121760159115,56050,163945662379,1500000000,1500000000
222035555832,1641319293,59934,223535555832,55134,315475885144,1500000000,1500000000
108618385949,1641267123,49519,109693855788,44719,109693855788,1500000000,1075469839
97530179952,1641279487,320408,99030179952,320408,114128621979,1500000000,1500000000
76880797659,1641273801,59982,78380797659,59982,111301775312,1500000000,1500000000
14611745406,1650189905,67646,16111745406,62846,24273434202,1500000000,1500000000
26608380900,1647210468,54332,28108380900,49532,50000000000,1500000000,1500000000
29905998839,1650216150,334318,31405998839,334318,37443047787,1500000000,1500000000
112520479348,1641508127,54861,115020479348,54861,256180267700,2500000000,2500000000
20399718494,1647174195,60862,21899718494,60862,25460461215,1500000000,1500000000
68292016446,1641283512,340627,69463139886,340627,76804747983,1171123440,1171123440
68292016446,1641283512,309173,69792016446,309173,107689585317,1500000000,1500000000
32564033184,1650181402,60950,34064033184,56150,48020047405,1500000000,1500000000
14616575643,1650227819,59934,16116575643,55134,19344285163,1500000000,1500000000
12247774265,1647760042,60850,13747774265,60850,17397368417,1500000000,1500000000
95720056169,1641459430,52916,97220056169,48116,132311788940,1500000000,1500000000
105143303670,1641457077,55592,106643303670,50792,123152598887,1500000000,1500000000
138305959738,1641430107,67634,139805959738,67634,195326045562,1500000000,1500000000
79622906919,1641273035,60862,81122906919,56062,123515790044,1500000000,1500000000
29655349365,1650208937,56492,31155349365,51692,40234589960,1500000000,1500000000
32614173302,1647808770,60850,34114173302,56050,39548263865,1500000000,1500000000
116449008677,1641472682,314148,117949008677,314148,175733974344,1500000000,1500000000
112055001474,1641437389,67646,113555001474,62846,129677173914,1500000000,1500000000
76838875981,1641275748,67622,78338875981,62822,103973746953,1500000000,1500000000
109745489496,1641261573,52916,111245489496,48116,145596226038,1500000000,1500000000
13406187555,1647752919,333696,14410000000,333696,14410000000,14410000000,1003812445
157822846300,1641331810,67646,159322846300,62846,190121064880,1500000000,1500000000
79310867554,1641457893,330559,80810867554,330559,87000000000,1500000000,1500000000
145833438355,1641490215,59970,147333438355,59970,182830215229,1500000000,1500000000
29476863024,1647179988,331071,30976863024,313971,34257871817,1500000000,1500000000
29476863024,1647179988,331133,30976863024,331133,34257871817,1500000000,1500000000
90654912108,1641277236,60850,92154912108,56050,130429795165,1500000000,1500000000
25559063005,1650185562,64144,27059063005,59344,31705934507,1500000000,1500000000
25559063005,1650185562,48699,27059063005,43899,31705934507,1500000000,1500000000
111779346301,1641442128,335528,113279346301,335528,135644932239,1500000000,1500000000
80194430191,1641467386,54896,81694430191,50096,119475886057,1500000000,1500000000
123615846552,1641333455,67634,125115846552,67634,186867184149,1500000000,1500000000
127998562635,1641255817,49471,129498562635,49471,176116402474,1500000000,1500000000
105815266307,1641254691,67634,107315266307,67634,206271150213,1500000000,1500000000
114742660680,1641495424,67634,116242660680,67634,146000000000,1500000000,1500000000
133598323039,1641505351,67646,135098323039,62846,158755523774,1500000000,1500000000
98216437896,1641274227,340065,99716437896,340065,127327371430,1500000000,1500000000
98939721824,1641475649,64741,100439721824,59941,106353530889,1500000000,1500000000
86429532660,1641279773,64741,87929532660,59941,100915510939,1500000000,1500000000
156323892593,1641493971,60850,157823892593,60850,183827562618,1500000000,1500000000
83748350406,1641475470,55592,85248350406,50792,101188066913,1500000000,1500000000
97316299061,1641459180,67634,98816299061,67634,128760656958,1500000000,1500000000
73270882645,1641302636,54848,74770882645,54848,95742909507,1500000000,1500000000
24364066221,1647158973,67634,25864066221,67634,29637006957,1500000000,1500000000
150597217199,1641256995,66778,152597217199,61978,156712358876,2000000000,2000000000
15134004243,1650170703,340019,16893066778,340019,,,
23105885914,1650207078,331179,24605885914,331179,28000000000,1500000000,1500000000
15919577009,1650179201,64056,17419577009,59256,23688532048,1500000000,1500000000
112792976314,1641502177,60838,114292976314,60838,156655917060,1500000000,1500000000
21997936198,1650190794,55680,23497936198,50880,31664102779,1500000000,1500000000
111995833948,1641477322,64741,113995833948,59941,135735011455,2000000000,2000000000
21977865915,1647166061,67646,23210491943,67646,23210491943,1500000000,1232626028
23124548910,1647177004,55717,24624548910,50917,29284488078,1500000000,1500000000
451902614353,1641315900,67634,454327614353,67634,553399482090,2425000000,2425000000
152372107877,1641431777,327405,153872107877,327405,179227084739,1500000000,1500000000
20362349252,1650182640,339406,21862349252,339406,24518925252,1500000000,1500000000
96459653311,1641448112,316536,98459653311,316536,142471588987,2000000000,2000000000
147424523093,1641493830,67646,148924523093,62846,161055148985,1500000000,1500000000
128747571296,1641503763,67634,130247571296,67634,144987792960,1500000000,1500000000
176742578118,1641429335,67634,178242578118,67634,197732717494,1500000000,1500000000
33872310868,1650231503,66754,34960593372,61954,34960593372,1500000000,1088282504
23972820578,1650208189,67710,25472820578,67710,40569219034,1500000000,1500000000
87737717711,1641459008,55717,89737717711,50917,116471731261,2000000000,2000000000
89908348214,1641455925,67646,91408348214,62846,110830008923,1500000000,1500000000
53182771451,1650215264,322897,54682771451,322897,72713195473,1500000000,1500000000
21158237969,1650180903,60926,22658237969,60926,29056062244,1500000000,1500000000
94306417127,1641463668,326806,95306417127,326806,98839459820,1000000000,1000000000
127808213757,1641451058,67646,129308213757,62846,161432336184,1500000000,1500000000
18072353872,1647756925,310209,20572353872,310209,24448345305,2500000000,2500000000
17423921001,1650173887,327317,18923921001,238643,21462463528,1500000000,1500000000
17423921001,1650173887,327317,18923921001,327317,21462463528,1500000000,1500000000
23150745577,1647789438,296540,24650745577,296540,29005821973,1500000000,1500000000
167472028871,1641483558,60850,169472028871,56050,227552795385,2000000000,2000000000
120491214527,1641510152,48675,121991214527,43875,135687710835,1500000000,1500000000
11258481774,1647762369,310159,12758481774,310159,18946609550,1500000000,1500000000
14663214607,1647774821,340059,16163214607,340059,16343545324,1500000000,1500000000
146429015855,1641451226,67634,147929015855,67634,154466763914,1500000000,1500000000
103626511021,1641257422,64741,105126511021,59941,129303841163,1500000000,1500000000
39265223544,1650229816,320348,40765223544,320348,42863641907,1500000000,1500000000
99691223551,1641492506,331141,101191223551,331141,120245286719,1500000000,1500000000
157996054437,1641450987,60838,159496054437,60838,185907463348,1500000000,1500000000
15090121674,1647170532,60838,16590121674,60838,19590486984,1500000000,1500000000
47511125217,1647201403,60862,49011125217,56062,61968852437,1500000000,1500000000
120874783243,1641263773,328777,122374783243,328777,129298339838,1500000000,1500000000
134906189483,1641472573,310319,136406189483,310319,158019651332,1500000000,1500000000
94736003379,1641459917,54739,96236003379,49939,134256929127,1500000000,1500000000
17906660064,1650174301,333688,19406660064,333688,24269995369,1500000000,1500000000
128585428388,1641503801,60850,130085428388,56050,161989120103,1500000000,1500000000
96561489901,1641267086,60862,98061489901,56062,132580380154,1500000000,1500000000
98606012413,1641272885,67658,100106012413,62858,114000000000,1500000000,1500000000
30732576385,1650219933,60850,32232576385,56050,35650713313,1500000000,1500000000
64318309918,1641304253,60030,65818309918,55230,105481108510,1500000000,1500000000
29491133313,1650217277,60950,33664228869,56150,,,
165399375368,1641334253,67646,166899375368,62846,173773961703,1500000000,1500000000
121670404074,1641509659,52916,123170404074,48116,174074189964,1500000000,1500000000
98333362330,1641274558,60862,99833362330,56062,133088633057,1500000000,1500000000
101778587402,1641441765,52928,103278587402,48128,157526050952,1500000000,1500000000
80836433589,1641299631,55592,82336433589,50792,96912729124,1500000000,1500000000
87994242205,1641278634,60850,89494242205,56050,122160226194,1500000000,1500000000
94957928958,1641453169,60850,96457928958,60850,118283279680,1500000000,1500000000
88973929105,1641268384,343213,90473929105,343213,113329171084,1500000000,1500000000
13838415781,1647766170,54664,15338415781,49864,16841096648,1500000000,1500000000
123057788453,1641257584,55580,124557788453,50780,146992504553,1500000000,1500000000
18867875942,1650156035,337478,20367875942,337478,27792104985,1500000000,1500000000
28215978046,1650183897,67634,29715978046,62834,39831288224,1500000000,1500000000
23787510995,1650227073,48603,25287510995,43803,31730929702,1500000000,1500000000
91058587462,1641459949,55592,92558587462,50792,129257093577,1500000000,1500000000
92958626434,1641492492,322442,94458626434,322442,116671265630,1500000000,1500000000
21018908217,1647157184,52940,22518908217,48140,24857254483,1500000000,1500000000
90912297136,1641284312,63200,93412297136,63200,199454256940,2500000000,2500000000
23301692692,1647817537,316606,24801692692,316606,28108357178,1500000000,1500000000
119767262859,1641265773,336879,121267262859,336879,174923270927,1500000000,1500000000
64332497258,1641304463,55580,65456999134,50780,70828674057,1124501876,1124501876
186525956085,1641482511,60862,190000000000,56062,,,
119332966429,1641498673,60850,120832966429,60850,161940707872,1500000000,1500000000
126084719670,1641435112,67634,127750663679,67634,153269742774,1665944009,1665944009
25338242448,1647204205,323638,26838242448,323638,31237446877,1500000000,1500000000
110690817909,1641260208,49519,112190817909,44719,115522546960,1500000000,1500000000
13050612010,1647777735,67646,14150612010,62846,15000000000,1100000000,1100000000
29368910468,1647191353,325715,30868910468,325715,42878985743,1500000000,1500000000
96918192433,1641267467,59934,98418192433,55134,99000000000,1500000000,1500000000
82618086113,1641278027,60838,84028086113,56038,110869637940,1410000000,1410000000
121855916047,1641259067,49483,123355916047,49483,159529046088,1500000000,1500000000
20317633562,1650162022,60850,21817633562,56050,28558621792,1500000000,1500000000
141698713316,1641495302,67646,143698713316,62846,165919173525,2000000000,2000000000
76330183299,1641299570,337452,77830183299,337452,84936482160,1500000000,1500000000
24973645110,1647754230,67622,26473645110,62822,38640545074,1500000000,1500000000
110895999647,1641491075,327377,112395999647,327377,116693436697,1500000000,1500000000
110895999647,1641491075,320396,112895999647,320396,121801174165,2000000000,2000000000
73518378821,1641468170,67646,75018378821,62846,85150162593,1500000000,1500000000
146606137478,1641337096,66838,148106137478,66838,165708705109,1500000000,1500000000
98744903027,1641261044,86822,100244903027,82022,116782409010,1500000000,1500000000
114350672704,1641256031,55592,115850672704,50792,147401502620,1500000000,1500000000
24448876541,1650219251,338752,25948876541,338752,36069357939,1500000000,1500000000
107464671978,1641496124,67634,108964671978,62834,162901496044,1500000000,1500000000
21372934171,1647175155,320491,22872934171,320491,28344773929,1500000000,1500000000
131722131058,1641504307,66742,133222131058,61942,160002764812,1500000000,1500000000
130360565194,1641313140,67646,131860565194,62846,161435974679,1500000000,1500000000
48128211654,1650205432,66730,49628211654,66730,55297068103,1500000000,1500000000
77997910043,1641458172,337464,79497910043,337464,80000000000,1500000000,1500000000
88344594932,1641511733,91275,96000000000,56050,,,
139191106115,1641510493,54824,140691106115,54824,183497982605,1500000000,1500000000
101965027016,1641312587,49507,103465027016,44707,129443158670,1500000000,1500000000
22346857347,1647134163,336903,23846857347,336903,27454216343,1500000000,1500000000
14643802808,1650196514,59982,16643802808,59982,17741975695,2000000000,2000000000
86033916782,1641282044,60838,87533916782,60838,113464405930,1500000000,1500000000
39070516548,1650209114,66742,40570516548,66742,53420652314,1500000000,1500000000
121442394524,1641307606,59946,122942394524,55146,185033914907,1500000000,1500000000
33558316487,1650199982,60938,35058316487,56138,43352461164,1500000000,1500000000
22063625273,1647801599,60862,23563625273,56062,29518600753,1500000000,1500000000
128909506709,1641505384,60862,130409506709,56062,165858985705,1500000000,1500000000
55417451701,1647212897,60862,56917451701,56062,71976590699,1500000000,1500000000
134337779074,1641332529,67634,136337779074,62834,180729518108,2000000000,2000000000
33291319820,1647786853,316622,34791319820,316622,43417125952,1500000000,1500000000
13744600822,1647767135,327972,15244600822,327972,17015325198,1500000000,1500000000
107470234369,1641472917,64741,108970234369,59941,155000000000,1500000000,1500000000
152140139565,1641447500,54676,153640139565,49876,183235714475,1500000000,1500000000
125103294051,1641493685,67634,126603294051,67634,131760777877,1500000000,1500000000
73922261714,1641280148,307220,75422261714,307220,118188794014,1500000000,1500000000
151131330901,1641432257,67646,152631330901,62846,153058417600,1500000000,1500000000
130292869114,1641258516,65530,131792869114,60730,145967241759,1500000000,1500000000
15807887823,1650165088,60862,17307887823,56062,17640783448,1500000000,1500000000
15807887823,1650165088,67658,17307887823,62858,17640783448,1500000000,1500000000
15811235565,1650155201,67634,17311235565,67634,25835192675,1500000000,1500000000
23972284859,1650211354,319783,25189803063,319783,25189803063,1500000000,1217518204
112337409468,1641450584,319939,113837409468,319939,142616211505,1500000000,1500000000
98183745579,1641452094,67658,99683745579,62858,125358937064,1500000000,1500000000
13989621047,1647153001,60850,15489621047,56050,21485172924,1500000000,1500000000
106748332978,1641314748,60862,108248332978,56062,148137909475,1500000000,1500000000
24667044112,1650201095,48723,26167044112,43923,29252077915,1500000000,1500000000
123654257965,1641312501,60006,125154257965,55206,138934619167,1500000000,1500000000
123654257965,1641312501,328016,125154257965,328016,138934619167,1500000000,1500000000
123654257965,1641312501,60850,125654257965,60850,144932003933,2000000000,2000000000
92606676244,1641279091,60850,94106676244,56050,105295904150,1500000000,1500000000
22560930736,1647796611,317304,24060930736,317304,27986962107,1500000000,1500000000
129083803004,1641479014,331129,130583803004,331129,173639368384,1500000000,1500000000
101744491008,1641311839,60862,103069891008,56062,116018190341,1325400000,1325400000
101744491008,1641311839,67634,103244491008,67634,128372555687,1500000000,1500000000
184709507754,1641323464,67646,186209507754,62846,226208157490,1500000000,1500000000
61655276461,1641291066,63176,63155276461,63176,87577001110,1500000000,1500000000
32125607070,1650235910,67722,33625607070,62922,37196693588,1500000000,1500000000
99002006631,1641510781,60862,100502006631,56062,141589094445,1500000000,1500000000
151537100762,1641486134,67634,153037100762,62834,201631876502,1500000000,1500000000
11631266185,1647157486,343197,12841266185,343197,13310000000,1210000000,1210000000
42009284323,1647196637,67634,43621643713,67634,54207481939,1612359390,1612359390
80170028030,1641271420,100000,81670028030,56062,82000000000,1500000000,1500000000
17112956596,1647739450,334312,18612956596,334312,19350681648,1500000000,1500000000
147288555692,1641339683,54795,149288555692,49995,193095194635,2000000000,2000000000
64490883820,1641291121,60838,65990883820,56038,81677206710,1500000000,1500000000
126568633859,1641508141,60850,128068633859,56050,157812628237,1500000000,1500000000
76468439793,1641280656,60862,77968439793,56062,123139304905,1500000000,1500000000
17526347469,1650225031,71188,27526347469,59917,41733106876,10000000000,10000000000
14367925134,1647780334,328208,15867925134,328208,19358303334,1500000000,1500000000
145165430728,1641491346,320428,146765430728,320428,162762215064,1600000000,1600000000
19529819176,1647193663,67634,21029819176,58034,21846038842,1500000000,1500000000
72367845689,1641287832,54509,73867845689,54509,90355972198,1500000000,1500000000
100065109333,1641498676,59958,102428269468,59958,,,
147125047368,1641489958,67646,148625047368,62846,187133159209,1500000000,1500000000
87806107909,1641270892,67646,89306107909,62846,141408035554,1500000000,1500000000
110195107967,1641299709,63200,112695107967,63200,207087428176,2500000000,2500000000
73508737900,1641291317,331327,75008737900,331327,75612899600,1500000000,1500000000
127429480104,1641301304,60006,128929480104,55206,154498425698,1500000000,1500000000
67573137842,1641299195,55693,69073137842,50893,94681502930,1500000000,1500000000
66326343943,1641303052,307100,67826343943,307100,92781912937,1500000000,1500000000
24537830083,1650161407,55592,26037830083,50792,34606235017,1500000000,1500000000
32904569429,1650166316,322945,34404569429,322945,34524805583,1500000000,1500000000
17088751479,1647797871,67646,19088751479,62846,29351774785,2000000000,2000000000
107558143625,1641501089,54825,109058143625,54825,149395620184,1500000000,1500000000
169539742638,1641326541,331295,171039742638,331295,205300801388,1500000000,1500000000
142879791825,1641496953,67646,144379791825,62846,155121186089,1500000000,1500000000
168807522465,1641483746,331181,170307522465,331181,231291044028,1500000000,1500000000
118933856970,1641259257,67634,120433856970,62834,171405509957,1500000000,1500000000
88805927529,1641280243,67622,90305927529,67622,112316699477,1500000000,1500000000
15893828511,1647764841,67646,17393828511,62846,21045463162,1500000000,1500000000
71349567842,1641276052,67646,72849567842,62846,108421027604,1500000000,1500000000
13077157751,1647771475,64729,14577157751,59929,18661544260,1500000000,1500000000
147798229812,1641434681,327353,149298229812,327353,228863299698,1500000000,1500000000
94699051535,1641310613,67634,96199051535,67634,142093725162,1500000000,1500000000
36960248225,1647816624,67622,38842048225,67622,49261571185,1881800000,1881800000
142920305969,1641436316,66778,144420305969,66778,155544500090,1500000000,1500000000
23463931805,1650155830,67634,24963931805,67634,28386465352,1500000000,1500000000
21823979856,1647131002,317354,23323979856,317354,29505252592,1500000000,1500000000
101893886029,1641471260,67646,103393886029,62846,121735058335,1500000000,1500000000
218378081776,1641481726,60850,219878081776,56050,306830470183,1500000000,1500000000
80450362800,1641277043,319745,81950362800,319745,104508749775,1500000000,1500000000
98024961645,1641279986,67634,99524961645,67634,102552460739,1500000000,1500000000
146053560780,1641314108,67634,147553560780,67634,187317857622,1500000000,1500000000
24618467119,1650180330,60938,32345589146,60938,,,
96362484732,1641471900,316622,97862484732,316622,125548282794,1500000000,1500000000
117024219507,1641430517,54932,118524219507,50132,138232543059,1500000000,1500000000
20437489438,1650186605,67734,21937489438,62934,29273273592,1500000000,1500000000
120589063573,1641460137,54824,122589063573,54824,149872870116,2000000000,2000000000
98700488210,1641472194,64741,100700488210,59941,130091081692,2000000000,2000000000
26137478469,1647176087,326085,27637478469,326085,37895404348,1500000000,1500000000
14356868173,1647145483,333724,15856868173,333724,18878137100,1500000000,1500000000
116555462153,1641333009,60850,118055462153,56050,147468837977,1500000000,1500000000
128629946974,1641256063,67634,130629946974,67634,150655874516,2000000000,2000000000
124590218955,1641264325,67634,126090218955,62834,126322174852,1500000000,1500000000
130491810004,1641333072,49519,131991810004,44719,147194327692,1500000000,1500000000
15878266634,1647145810,67646,17378266634,62846,22437969064,1500000000,1500000000
97653900817,1641468540,334324,99153900817,334324,124581106410,1500000000,1500000000
102417721087,1641475725,67634,103917721087,67634,111000000000,1500000000,1500000000
125422119064,1641332888,310281,126922119064,310281,198895033135,1500000000,1500000000
11245560531,1647762670,313457,12745560531,313457,20527895140,1500000000,1500000000
118504476016,1641497132,60838,120504476016,60838,169583565109,2000000000,2000000000
31983961749,1647201110,320392,33483961749,320392,42124337470,1500000000,1500000000
78873734932,1641305223,60862,80873734932,56062,132952091745,2000000000,2000000000
103008150290,1641309442,67722,104948150290,67722,130994285308,1940000000,1940000000
26542721423,1650198086,63188,28042721423,63188,43451810880,1500000000,1500000000
17072529979,1647750331,331135,18337872892,331135,18337872892,1500000000,1265342913
28654110546,1647215592,59946,30154110546,55146,38120850563,1500000000,1500000000
87410679549,1641284255,64717,92410679549,59917,115993472087,5000000000,5000000000
133835943849,1641313725,318492,135335943849,318492,136514222015,1500000000,1500000000
273948442380,1641256642,64729,275448442380,59929,340400059927,1500000000,1500000000
26936443346,1650186063,60850,28436443346,56050,31390467129,1500000000,1500000000
21256798998,1650239758,337478,22756798998,337478,25636012150,1500000000,1500000000
16573375057,1647758355,307827,18073375057,307827,22627076100,1500000000,1500000000
113101468470,1641508921,49483,114223120893,49483,114223120893,1500000000,1121652423
98671189750,1641458063,319287,100171189750,319287,100638584443,1500000000,1500000000
120247461543,1641259095,60850,121747461543,56050,153819895059,1500000000,1500000000
73072269294,1641290579,320474,74572269294,314005,97197220587,1500000000,1500000000
85189137908,1641282109,310299,86689137908,310299,108477927510,1500000000,1500000000
106019967148,1641274110,67646,107519967148,62846,112434782942,1500000000,1500000000
32625595046,1647803874,55580,34125595046,50780,46955044063,1500000000,1500000000
102001865616,1641504688,60838,103501865616,60838,106953521523,1500000000,1500000000
23204660073,1647795078,67646,24704660073,67646,32293567138,1500000000,1500000000
13005572300,1647768377,321865,14505572300,321865,20428184935,1500000000,1500000000
18794152988,1650207281,60862,20294152988,56062,28000000000,1500000000,1500000000
35644313323,1650199403,333690,37118432442,333690,37118432442,1500000000,1474119119
14627954910,1650187747,49583,16127954910,44783,20191596172,1500000000,1500000000
78334388511,1641276232,55693,80334388511,50893,98443649787,2000000000,2000000000
27359937252,1650217863,331133,28527626015,331133,28527626015,1500000000,1167688763
111171610272,1641462085,54872,113671610272,54872,228217110424,2500000000,2500000000
104366413052,1641459050,54884,105866413052,50084,111172147139,1500000000,1500000000
90775720609,1641290137,52892,92275720609,52892,107649522895,1500000000,1500000000
14279293950,1650188451,67646,15779293950,62846,19339600733,1500000000,1500000000
21445152259,1650207263,66790,22945152259,66790,24000000000,1500000000,1500000000
42694348610,1647787966,67646,44194348610,62846,46127283268,1500000000,1500000000
105714149798,1641471304,60862,107214149798,56062,132041106913,1500000000,1500000000
126091671942,1641495240,63200,128591671942,63200,216479138568,2500000000,2500000000
153957898807,1641337791,67646,155457898807,62846,168120598958,1500000000,1500000000
12709535744,1647777005,67622,14053076042,62822,14053076042,1500000000,1343540298
125103896778,1641501988,296246,127103896778,296246,162553362070,2000000000,2000000000
110561800535,1641491509,313315,112061800535,313315,113230000000,1500000000,1500000000
151205126788,1641319967,60862,152615126788,56062,178239045980,1410000000,1410000000
401908546480,1641316298,323503,403990976492,323503,589298805139,2082430012,2082430012
401908546480,1641316298,67634,403990976492,62834,589298805139,2082430012,2082430012
26582856072,1650179565,60938,28067683263,60938,,,
163928471821,1641482592,67646,165928471821,62846,218692840106,2000000000,2000000000
122067461838,1641494494,335550,124067461838,335550,161460725309,2000000000,2000000000
12238379450,1647169112,67646,13000000000,62846,13000000000,1500000000,761620550
12238379450,1647169112,60862,13000000000,56062,13000000000,1500000000,761620550
72564444826,1641277458,55693,74064444826,50893,100459448313,1500000000,1500000000
126567020567,1641505629,49519,128067020567,44719,137871962177,1500000000,1500000000
139946760063,1641440349,67646,141446760063,62846,153981853389,1500000000,1500000000
25599457373,1650209803,56492,27099457373,56492,43066714388,1500000000,1500000000
14586399905,1650233767,64741,15000000000,59941,15000000000,1500000000,413600095
33880425897,1650179906,67646,35380425897,62846,52775350318,1500000000,1500000000
33576250029,1647785349,60850,35076250029,56050,38869564370,1500000000,1500000000
13871038323,1647777649,318492,15371038323,318492,21645319638,1500000000,1500000000
18682634638,1650158465,319795,20182634638,319795,26596022569,1500000000,1500000000
128676568709,1641479583,59970,130176568709,55170,156892064124,1500000000,1500000000
25591853624,1647778100,67634,27091853624,62834,27590115282,1500000000,1500000000
29649888329,1647197874,56504,31149888329,51704,36773821580,1500000000,1500000000
17194245897,1650192516,67722,18694245897,67722,21145246728,1500000000,1500000000
24356301167,1650161386,67622,25856301167,67622,29997881910,1500000000,1500000000
54054733004,1647198372,333742,55825318624,333742,73479735328,1770585620,1770585620
189002682570,1641483988,320396,190502682570,320396,225635116207,1500000000,1500000000
19138937017,1647141309,60862,20638937017,56062,26180899317,1500000000,1500000000
12950300357,1647763873,316596,14450300357,316596,16148475565,1500000000,1500000000
16862231614,1647752859,67646,18362231614,62846,19933143448,1500000000,1500000000
101217083747,1641292938,67634,102717083747,62834,130298401410,1500000000,1500000000
25240176829,1647797952,67646,26740176829,62846,30045794378,1500000000,1500000000
140446868080,1641435689,60850,154508217542,60850,,,
28972277099,1650216428,55592,29754438229,50792,,,
28972277099,1650216428,67634,30472277099,67634,45112375042,1500000000,1500000000
17018999596,1650165873,334326,18888438685,334326,,,
99026527669,1641474853,55592,100526527669,50792,131247603229,1500000000,1500000000
99026527669,1641474853,60006,100526527669,55206,137845472178,1500000000,1500000000
17101493737,1647131189,54909,18601493737,54909,25243528133,1500000000,1500000000
34158143918,1650211852,334310,35658143918,334310,44299453150,1500000000,1500000000
19896344399,1647800701,67634,21396344399,67634,29134248014,1500000000,1500000000
168029432435,1641473761,306550,169704234435,306550,219308707302,1674802000,1674802000
86640338898,1641301774,60862,88140338898,56062,106917605973,1500000000,1500000000
23553236370,1650207031,333710,25053236370,333710,30000000000,1500000000,1500000000
85278497337,1641448523,54920,86778497337,50120,121718068164,1500000000,1500000000
100232387863,1641433460,60838,101732387863,60838,136024924658,1500000000,1500000000
134926055786,1641334807,67634,136426055786,67634,163123179330,1500000000,1500000000
119097484685,1641267025,55592,120597484685,50792,127474849498,1500000000,1500000000
100481095031,1641314908,55620,101981095031,50820,137734110632,1500000000,1500000000
129287504405,1641259880,67634,130787504405,67634,169855007492,1500000000,1500000000
14195007946,1647753879,317232,15695007946,317232,24882494964,1500000000,1500000000
33586318207,1647804527,67622,35086318207,67622,37020784675,1500000000,1500000000
146201949313,1641479962,60850,147701949313,60850,192585381939,1500000000,1500000000
121914358336,1641486990,64729,123414358336,59929,161672522625,1500000000,1500000000
87034374319,1641268327,343831,88534374319,343831,111731739258,1500000000,1500000000
28183209239,1647778132,67634,30183209239,67634,31573981249,2000000000,2000000000
24656971196,1647800511,60850,26156971196,56050,37717360074,1500000000,1500000000
97426284755,1641496589,60862,98926284755,60862,113323492633,1500000000,1500000000
32415817037,1650198644,66754,33915817037,66754,41603763255,1500000000,1500000000
25336490351,1650184781,64120,26836490351,64120,34499873992,1500000000,1500000000
27419619685,1650238173,343205,28919619685,343205,30056168137,1500000000,1500000000
20441172498,1647735905,55620,22941172498,50820,28986051579,2500000000,2500000000
106997199966,1641480544,313449,108497199966,313449,131847820340,1500000000,1500000000
18412528018,1647154723,314079,19912528018,314079,23682080627,1500000000,1500000000
100217380671,1641269984,60862,101717380671,60862,148445021530,1500000000,1500000000
101823310908,1641441352,60850,103323310908,56050,138446309495,1500000000,1500000000
107872895809,1641437663,54908,108977395809,50108,111528191149,1104500000,1104500000
14441105653,1647145818,320507,15941105653,320507,21347833293,1500000000,1500000000
101256574427,1641307029,310243,102756574427,310243,110236407618,1500000000,1500000000
107375201669,1641477900,67622,108875201669,67622,140331278112,1500000000,1500000000
33080584618,1650214407,55720,34580584618,50920,200000000000,1500000000,1500000000
17178650786,1650194545,327966,18678650786,327966,20459882317,1500000000,1500000000
101052289751,1641491759,336895,102552289751,336895,125735341447,1500000000,1500000000
158035548009,1641331445,55717,160035548009,50917,182533481840,2000000000,2000000000
108492736227,1641484713,67634,109992736227,62834,125114151454,1500000000,1500000000
110607893070,1641496509,67646,112607893070,62846,156497802383,2000000000,2000000000
21862017656,1647179052,66826,23362017656,62026,24660599898,1500000000,1500000000
71791370004,1641275385,55717,73291370004,50917,91045586848,1500000000,1500000000
23031598644,1650207321,67634,24531598644,62834,24992691235,1500000000,1500000000
13535031290,1650188039,60850,15035031290,56050,20638506632,1500000000,1500000000
8981290147,1647765935,334308,10481290147,334308,15582215332,1500000000,1500000000
18689220974,1647755251,330505,20189220974,313405,22266588549,1500000000,1500000000
18689220974,1647755251,327377,20189220974,327377,20663418978,1500000000,1500000000
116394003642,1641257541,55592,117894003642,50792,144788585040,1500000000,1500000000
107200831918,1641312306,63200,109700831918,63200,196412002058,2500000000,2500000000
34639026152,1647138663,325633,36139026152,325633,40125486832,1500000000,1500000000
139906681864,1641314384,55580,141406681864,50780,142193432988,1500000000,1500000000
82940732588,1641279785,52904,84440732588,48104,100915510939,1500000000,1500000000
110143428597,1641337478,313433,111643428597,313433,131513642158,1500000000,1500000000
80034734772,1641459189,54824,82034734772,54824,129229877942,2000000000,2000000000
88869153615,1641477272,52568,90369153615,47768,122319247983,1500000000,1500000000
85115841029,1641309726,64044,86615841029,59244,111943779564,1500000000,1500000000
163568735587,1641501350,60862,165068735587,56062,204752358522,1500000000,1500000000
117411091049,1641455750,67634,118911091049,67634,134824552678,1500000000,1500000000
14067727236,1647162682,55693,15567727236,50893,21181689820,1500000000,1500000000
48070910876,1647785032,49507,49570910876,44707,65463855948,1500000000,1500000000
383310874817,1641317012,67634,385592557317,67634,476456141927,2281682500,2281682500
15805356362,1650173576,336837,17305356362,336837,24227976248,1500000000,1500000000
105138630620,1641312189,67646,106638630620,62846,114756615663,1500000000,1500000000
18610904193,1650197566,331141,20305798998,331141,23268948027,1694894805,1694894805
37016520163,1650219781,63200,38516520163,63200,89895154510,1500000000,1500000000
10540501232,1647777408,60862,12040501232,56062,13575525767,1500000000,1500000000
132039820495,1641474523,52556,133539820495,47756,142023412968,1500000000,1500000000
136381011088,1641427224,60850,137881011088,56050,169384291780,1500000000,1500000000
26485668753,1650207201,67646,27985668753,62846,28000000000,1500000000,1500000000
62143134978,1647784174,67646,63643134978,62846,82932664538,1500000000,1500000000
57941175623,1641288008,67646,59441175623,62846,80947215933,1500000000,1500000000
140190068795,1641499225,67634,141690068795,67634,175830060479,1500000000,1500000000
106572611231,1641463565,55580,108072611231,50780,134983714052,1500000000,1500000000
92588869898,1641466247,331185,94088869898,331185,112246365402,1500000000,1500000000
123375471715,1641473111,326030,124875471715,308930,176151435777,1500000000,1500000000
123375471715,1641473111,332316,124875471715,332316,176151435777,1500000000,1500000000
22299235621,1647154639,334290,23799235621,334290,28500674215,1500000000,1500000000
80327116808,1641308356,67622,81827116808,67622,113899199575,1500000000,1500000000
123196855203,1641498777,52544,124696855203,47744,160008819220,1500000000,1500000000
82615928796,1641307773,59946,103000000000,59946,,,
84796100729,1641277815,336847,86296100729,336847,102062504503,1500000000,1500000000
11061610357,1647748382,55584,12561610357,50784,19258378378,1500000000,1500000000
27301622907,1647176422,320759,28801622907,320759,35612835920,1500000000,1500000000
93331743301,1641277708,67622,94831743301,67622,113203918948,1500000000,1500000000
142517679098,1641262635,50000,143927679098,50000,171827362738,1410000000,1410000000
12998930678,1650196424,56717,14498930678,51917,15970581120,1500000000,1500000000
82176705382,1641456543,60850,84176705382,60850,118364363102,2000000000,2000000000
114585337129,1641455085,59946,116085337129,55146,146122683920,1500000000,1500000000
158438156251,1641473887,302551,160013977453,302551,188649305405,1575821202,1575821202
144689739141,1641505813,59970,146189739141,59970,175439801532,1500000000,1500000000
87145343254,1641279942,49445,88645343254,44645,112735285529,1500000000,1500000000
91904529782,1641302477,60838,92971450472,60838,92971450472,1500000000,1066920690
74067807419,1641289972,60862,76067807419,56062,106099122878,2000000000,2000000000
18934927123,1647756572,309147,20434927123,309147,23869448225,1500000000,1500000000
98328930141,1641453740,60874,99828930141,56074,137550001065,1500000000,1500000000
20104238876,1650190284,67634,21604238876,62834,23839993607,1500000000,1500000000
147422257688,1641488222,68579,167711679080,43779,,,
122038663673,1641259300,60850,123538663673,60850,171405509957,1500000000,1500000000
19968637724,1650204601,66766,21223994147,66766,21223994147,1500000000,1255356423
107094646133,1641511714,54908,108594646133,50108,128893976005,1500000000,1500000000
95357031739,1641271731,55717,96857031739,50917,109011973912,1500000000,1500000000
148613504893,1641501506,316776,150113504893,316776,206046163402,1500000000,1500000000
87714296500,1641458099,327347,90714296500,327347,107027390812,3000000000,3000000000
175525113826,1641262052,336885,177259138816,336885,221422215041,1734024990,1734024990
9434638213,1647765799,337849,10434638213,337849,13414606289,1000000000,1000000000
145862050094,1641493945,67646,147362050094,62846,198604236777,1500000000,1500000000
16321128533,1650155014,329933,17821128533,329933,25388293099,1500000000,1500000000
153295833000,1641473909,336903,154824379566,336903,177766440765,1528546566,1528546566
76467991209,1641302875,60862,77967991209,56062,78992305809,1500000000,1500000000
111803859140,1641325299,55592,113469803149,50792,120000000000,1665944009,1665944009
80286886305,1641281336,64741,81786886305,59941,82067920975,1500000000,1500000000
23640627171,1650186903,60950,25140627171,56150,32193269653,1500000000,1500000000
105764039705,1641475920,64717,107764039705,59917,120195637091,2000000000,2000000000
119400925471,1641494753,60862,120900925471,56062,162734777243,1500000000,1500000000
115573793407,1641258472,67634,117573793407,67634,130111390033,2000000000,2000000000
106858954710,1641313252,55592,108358954710,50792,150970642304,1500000000,1500000000
106858954710,1641313252,67634,108358954710,62834,201441303510,1500000000,1500000000
20138365949,1650221642,66742,21638365949,61942,24236357370,1500000000,1500000000
99841555927,1641508810,66766,101341555927,66766,152093237885,1500000000,1500000000
87224511280,1641465163,328757,88634511280,328757,93879861101,1410000000,1410000000
110203352762,1641506424,67622,111703352762,67622,159510867825,1500000000,1500000000
32395144915,1650170122,339995,33895144915,339995,34911288552,1500000000,1500000000
142180529890,1641313185,55620,143680529890,50820,184812251402,1500000000,1500000000
31122200653,1647177801,67634,32622200653,67634,42712945540,1500000000,1500000000
83239628144,1641284109,336879,84739628144,336879,107214780365,1500000000,1500000000
24070719677,1650222117,64717,25570719677,59917,32232385727,1500000000,1500000000
131890540924,1641501883,54824,133715886924,50024,182252833839,1825346000,1825346000
89228546368,1641305124,67646,91228546368,62846,124321676455,2000000000,2000000000
27688019390,1650224540,55693,29188019390,50893,32306798639,1500000000,1500000000
18233916161,1647168420,323357,18487058635,323357,18487058635,1500000000,253142474
68344266229,1641290429,59958,69844266229,55158,90090525905,1500000000,1500000000
258305800911,1641330342,60838,259805800911,60838,305044518267,1500000000,1500000000
100344665642,1641260707,67634,101844665642,67634,109388004332,1500000000,1500000000
82267549035,1641461567,330505,83767549035,330505,88000000000,1500000000,1500000000
168883045286,1641488681,334344,170383045286,334344,243189691930,1500000000,1500000000
11861708841,1647160854,67646,13361708841,62846,18248299273,1500000000,1500000000
106532929074,1641474898,331135,108032929074,331135,149435105734,1500000000,1500000000
186408735183,1641482230,54759,187908735183,49959,257296940058,1500000000,1500000000
21587176831,1647143690,67634,23087176831,62834,34155549378,1500000000,1500000000
19065252393,1650233151,67634,20334094093,67634,20334094093,1500000000,1268841700
92669295180,1641303798,67634,94169295180,62834,127573963697,1500000000,1500000000
125977852257,1641489302,67622,127477852257,62822,173373347395,1500000000,1500000000
27621072537,1647188164,339973,29121072537,339973,40379076474,1500000000,1500000000
40633934985,1650229476,59946,42133934985,55146,46674366317,1500000000,1500000000
13497796901,1650159579,55680,14997796901,50880,18124828794,1500000000,1500000000
13643686006,1647763113,60850,15143686006,56050,18326448009,1500000000,1500000000
105074534475,1641442165,331131,117674012223,331131,,,
28889178438,1650223343,66814,30389178438,62014,37812075683,1500000000,1500000000
26658187023,1650207750,59958,28158187023,59958,32771497858,1500000000,1500000000
21192643882,1650236862,343175,22692643882,343175,26132402769,1500000000,1500000000
24681977296,1647790094,60838,26181977296,56038,29723330875,1500000000,1500000000
102428221537,1641459997,67646,103928221537,62846,119041773012,1500000000,1500000000
102428221537,1641459997,60862,103928221537,56062,119041773012,1500000000,1500000000
109148298818,1641455619,60862,110648298818,56062,133848292198,1500000000,1500000000
121367496322,1641510884,54860,122867496322,50060,140716487659,1500000000,1500000000
140707623352,1641489707,67646,142207623352,62846,153914760102,1500000000,1500000000
90265689017,1641305358,66814,91765689017,62014,132301703199,1500000000,1500000000
99494882324,1641480782,60862,100994882324,56062,108312139995,1500000000,1500000000
99494882324,1641480782,317246,100994882324,317246,108312139995,1500000000,1500000000
99494882324,1641480782,328034,100994882324,328034,109003759349,1500000000,1500000000
17063113393,1650190909,67746,18563113393,62946,25385336639,1500000000,1500000000
157672551925,1641445069,67634,159172551925,62834,179017290492,1500000000,1500000000
95182632942,1641303228,67622,96682632942,67622,110850311202,1500000000,1500000000
114055845652,1641259892,60850,115555845652,56050,170503572710,1500000000,1500000000
24732722214,1650184475,60926,25932204475,60926,25932204475,1500000000,1199482261
9842287385,1647767889,59970,11342287385,55170,14629917195,1500000000,1500000000
11080421151,1647748727,326026,12580421151,326026,17016301113,1500000000,1500000000
30597826375,1650181446,340029,32097826375,340029,41760090698,1500000000,1500000000
77765322418,1641275883,54849,79265322418,50049,111534395520,1500000000,1500000000
17737564081,1650191445,67646,19022655878,62846,19022655878,1500000000,1285091797
115748950335,1641430563,332331,117248950335,332331,134284119859,1500000000,1500000000
14743506474,1647168493,60838,16243506474,56038,22055124973,1500000000,1500000000
119231363418,1643859659,54836,120731363418,50036,135444181735,1500000000,1500000000
40486727382,1644116790,400000,41986727382,325963,42000000000,1500000000,1500000000
66626232956,1643870572,60862,68126232956,56062,71000000000,1500000000,1500000000
66626232956,1643870572,67646,68126232956,62846,71000000000,1500000000,1500000000
128481743610,1643868257,59970,129981743610,55170,138511819825,1500000000,1500000000
44372392775,1644125557,343793,45872392775,343793,48083104095,1500000000,1500000000
138814605156,1643909351,346991,140314605156,346991,195598045728,1500000000,1500000000
93409967645,1644189133,64056,94909967645,54456,115901821772,1500000000,1500000000
68042707992,1643891664,319825,69542707992,319825,101176481505,1500000000,1500000000
92689845790,1644159518,304562,94189845790,304562,116084602119,1500000000,1500000000
140858017339,1644169992,60850,141798543139,56050,141798543139,1500000000,940525800
54533103214,1644134630,60862,56033103214,56062,74155791812,1500000000,1500000000
42051187317,1644140924,60862,43551187317,56062,63688815960,1500000000,1500000000
115942799006,1643926084,55636,118442799006,55636,235002749952,2500000000,2500000000
132617247882,1643906991,60862,134117247882,56062,168829174029,1500000000,1500000000
115298041508,1643851707,67622,116798041508,67622,133072908935,1500000000,1500000000
53710646414,1643893667,336891,55210646414,336891,77998402113,1500000000,1500000000
89414912437,1644185810,55592,90914912437,50792,139285548352,1500000000,1500000000
48558992040,1644131207,340635,50058992040,340635,61009866612,1500000000,1500000000
165924498426,1644168116,317361,167424498426,317361,175845692260,1500000000,1500000000
100707771942,1643868152,66754,102485041075,61954,130007199634,1777269133,1777269133
46683192741,1644137984,336853,48183192741,336853,55166761352,1500000000,1500000000
39557263530,1644153352,54848,41057263530,54848,55668637387,1500000000,1500000000
100272929409,1643905358,340653,101772929409,340653,111571604783,1500000000,1500000000
101944586984,1644167022,340619,104089368534,340619,135139636785,2144781550,2144781550
59760908397,1643899157,322953,61760908397,322953,85000000000,2000000000,2000000000
68194790213,1644119261,55580,68866428112,55580,68866428112,1500000000,671637899
45115463232,1644156831,54795,46615463232,49995,74847084275,1500000000,1500000000
85788475537,1644117880,56516,87788475537,51716,114234964555,2000000000,2000000000
53950279128,1644122403,67634,55450279128,62834,99889763279,1500000000,1500000000
67063168770,1643894653,55717,68563168770,50917,82253964122,1500000000,1500000000
37504271366,1644129183,333125,39004271366,333125,41881221458,1500000000,1500000000
91618295102,1643861268,67622,93118295102,67622,126686594367,1500000000,1500000000
128904361556,1643926673,55648,131404361556,55648,276560128846,2500000000,2500000000
103138960609,1643847548,54332,104638960609,49532,106165508007,1500000000,1500000000
59022052475,1644141219,320388,60522052475,320388,86555495687,1500000000,1500000000
61724001425,1644117268,67634,73224001425,67634,75767148492,11500000000,11500000000
144842878021,1644191232,67634,146342878021,67634,152467654944,1500000000,1500000000
52043448989,1644144743,317118,53543448989,317118,71438346688,1500000000,1500000000
99121960757,1644190622,60850,100621960757,56050,144000000000,1500000000,1500000000
94959707096,1643857868,56504,96459707096,51704,120835534698,1500000000,1500000000
40775287946,1644149478,67646,42275287946,67646,49552295490,1500000000,1500000000
45012443291,1644137697,56504,46512443291,51704,63321049880,1500000000,1500000000
102583362179,1643892111,343189,104583362179,343189,113492519852,2000000000,2000000000
41831819674,1644148904,67634,43331819674,62834,49149543867,1500000000,1500000000
137559523812,1644180886,66790,139059523812,66790,168917354997,1500000000,1500000000
45081007927,1644139818,343853,46581007927,343853,56940441667,1500000000,1500000000
86237121838,1642336191,54771,87737121838,49971,108388174490,1500000000,1500000000
31176085395,1646306154,333720,32676085395,333720,42877838460,1500000000,1500000000
81573473094,1645180550,67634,83073473094,67634,92138420989,1500000000,1500000000
62139557995,1649266933,63200,63639557995,63200,123405896788,1500000000,1500000000
26548118426,1650616234,319767,28048118426,319767,39452459590,1500000000,1500000000
61685497198,1650646678,60862,63185497198,56062,84312140809,1500000000,1500000000
83502353415,1642330897,343169,85002353415,343169,94292804800,1500000000,1500000000
105168720986,1642374811,67646,106668720986,62846,111268427453,1500000000,1500000000
81933156181,1645025477,333626,83433156181,333626,85514918190,1500000000,1500000000
146095599969,1650589971,67622,147595599969,62822,188059624777,1500000000,1500000000
33652293083,1650625950,333131,35152293083,333131,41752891535,1500000000,1500000000
72646999280,1645188834,54664,73646999280,49864,80000000000,1000000000,1000000000
67862216334,1649262682,48675,69362216334,43875,87681690495,1500000000,1500000000
38044816016,1650597501,317610,39595816016,317610,40000000000,1551000000,1551000000
58879839356,1650653887,52348,60379839356,47548,70493946389,1500000000,1500000000
25408321200,1646299435,60850,26908321200,56050,35130989299,1500000000,1500000000
29387608764,1645782820,314869,30887608764,314869,41591156067,1500000000,1500000000
34930691882,1645783292,336905,36430691882,336905,38234510955,1500000000,1500000000
37468304601,1647594284,55592,38968304601,50792,50489215823,1500000000,1500000000
89257747789,1645180720,337418,90757747789,337418,112608393550,1500000000,1500000000
85830973834,1645182407,60850,87330973834,56050,103575481700,1500000000,1500000000
34093898031,1649036980,324810,35593898031,324810,44440740072,1500000000,1500000000
70752915419,1649038904,60862,72752915419,56062,83805383989,2000000000,2000000000
111035586227,1645194708,55705,112535586227,50905,137910164027,1500000000,1500000000
39550685996,1650656153,60850,42550685996,60850,420000000000,3000000000,3000000000
63106142088,1649111298,60850,64308516321,56050,65027660543,1202374233,1202374233
152070174623,1642364260,67634,153480174623,62834,159446016691,1410000000,1410000000
69168982673,1646333857,60838,70668982673,60838,94497236250,1500000000,1500000000
55129782946,1647615572,67634,56629782946,62834,63507955934,1500000000,1500000000
88842591761,1645182265,66838,90342591761,66838,111651225958,1500000000,1500000000
54180747974,1649240734,72183,55680747974,72183,57172420873,1500000000,1500000000
43396267190,1649242578,60850,44896267190,60850,52674314212,1500000000,1500000000
74365752131,1642346788,54346,75865752131,49546,104299664080,1500000000,1500000000
35765752555,1646289573,67634,37265752555,67634,45742543352,1500000000,1500000000
37639198700,1646307469,55580,39139198700,45980,47311116689,1500000000,1500000000
120916755808,1645174455,54712,121668327625,49912,121668327625,1500000000,751571817
30607795729,1649249596,55720,35607795729,50920,200000000000,5000000000,5000000000
65967375814,1649091320,67646,69067375814,62846,92408072150,3100000000,3100000000
90528633219,1643245511,67622,92028633219,67622,112979109248,1500000000,1500000000
90585060870,1642326295,60826,92085060870,60826,130907229814,1500000000,1500000000
90585060870,1642326295,67646,92085060870,62846,130907229814,1500000000,1500000000
53601209606,1646288792,63200,56101209606,63200,98752375228,2500000000,2500000000
153476921488,1645197359,59970,154976921488,55170,181192419084,1500000000,1500000000
47910843448,1649244329,67634,49560843448,67634,55637074333,1650000000,1650000000
47910843448,1649244329,328238,49910843448,328238,53114922748,2000000000,2000000000
31420121924,1650609107,55592,32920121924,50792,46385888463,1500000000,1500000000
85837347992,1642331662,49507,87337347992,44707,113176798015,1500000000,1500000000
37165010155,1646278183,319371,41520288515,319371,,,
80908940250,1646331167,60850,82848940250,56050,117828206969,1940000000,1940000000
47299320462,1645764004,67634,48809320462,67634,58541213509,1510000000,1510000000
70878059929,1649275146,67634,72378059929,67634,79634465222,1500000000,1500000000
53965900275,1649267640,322043,55465900275,322043,74090952105,1500000000,1500000000
33713558844,1650625350,67646,35213558844,62846,60000000000,1500000000,1500000000
69479902082,1642332980,320418,70979902082,320418,101997964220,1500000000,1500000000
76453045621,1646334400,60874,77690926793,60874,77690926793,1500000000,1237881172
55608060851,1647612622,63188,57108060851,63188,100372649036,1500000000,1500000000
71905052560,1645213539,60838,73405052560,60838,97226790093,1500000000,1500000000
33385527361,1650609741,60862,34885527361,56062,40580872662,1500000000,1500000000
33385527361,1650609741,67646,34885527361,62846,45180591648,1500000000,1500000000
51480584567,1649067441,48615,52718863288,48615,52718863288,1500000000,1238278721
103732671661,1643298617,67710,105232671661,67710,127934992419,1500000000,1500000000
26960465348,1645783947,343193,28460465348,343193,38796110285,1500000000,1500000000
107933662272,1644972736,67646,109433662272,67646,150479243095,1500000000,1500000000
45398565295,1645007817,60850,46898565295,56050,51425490673,1500000000,1500000000
42120643944,1650615727,67634,43620643944,62834,52015503168,1500000000,1500000000
155696624921,1645209204,55681,157196624921,50881,218168919675,1500000000,1500000000
71549131455,1649280384,60862,73049131455,56062,87391620757,1500000000,1500000000
46814165448,1649250673,60850,48314165448,60850,49630620853,1500000000,1500000000
50775319556,1645000865,64729,52275319556,59929,69569486062,1500000000,1500000000
27816151427,1650617511,67646,29816151427,62846,40778874926,2000000000,2000000000
65260423044,1649079740,318732,67260423044,318732,69047123231,2000000000,2000000000
70358531976,1649046846,67634,71858531976,67634,95032927505,1500000000,1500000000
85460331917,1649106477,337536,86960331917,337536,110767870089,1500000000,1500000000
50236956199,1649092466,67634,52236956199,67634,71946091592,2000000000,2000000000
29195607717,1647582580,60862,30695607717,56062,37736705873,1500000000,1500000000
87351770111,1642316037,56516,88851770111,51716,102520809047,1500000000,1500000000
108746624074,1642303972,67622,110246624074,67622,168877661382,1500000000,1500000000
52375770364,1646340606,67634,54825770364,62834,59144805727,2450000000,2450000000
53678279121,1647598218,66790,55825114185,61990,90853671956,2146835064,2146835064
26375760086,1650622044,320455,27875760086,320455,39179657265,1500000000,1500000000
126207205214,1642294533,56516,127707205214,51716,161777406462,1500000000,1500000000
73083625527,1649208264,68492,74583625527,63692,82810312624,1500000000,1500000000
28717890320,1650617498,67646,30217890320,62846,41299144628,1500000000,1500000000
48930886099,1649076964,67634,50430886099,62834,54125136320,1500000000,1500000000
42359595485,1649066092,59958,43859595485,59958,52981270340,1500000000,1500000000
95459730973,1642303553,54836,97459730973,50036,114000000000,2000000000,2000000000
26915902342,1646298173,67634,28415902342,58034,36014747723,1500000000,1500000000
48918539566,1645760052,66033,50418539566,55230,55000000000,1500000000,1500000000
77487132736,1644986013,343225,78117418992,343225,78117418992,1500000000,630286256
41314082452,1650592311,67634,42814082452,67634,55542926552,1500000000,1500000000
26434128519,1650619927,67622,27934128519,62822,37045481539,1500000000,1500000000
54397008748,1649054590,55705,55897008748,50905,77042460650,1500000000,1500000000
85290670493,1645226022,329264,86790670493,329264,106000339990,1500000000,1500000000
32644586023,1650625694,60862,34144586023,60862,37109167087,1500000000,1500000000
107508036964,1642348508,56516,109008036964,51716,136933373905,1500000000,1500000000
62002308020,1646323844,67646,63502308020,62846,67921210393,1500000000,1500000000
114367625858,1645192619,328228,116367625858,328228,120363370811,2000000000,2000000000
79401604871,1649269716,55693,80901604871,50893,90114206522,1500000000,1500000000
110526903840,1645029367,56717,112026903840,51917,187236667179,1500000000,1500000000
53088917051,1650665269,67646,54201714308,62846,54201714308,1500000000,1112797257
49925459963,1649223242,63200,51425459963,63200,90264322960,1500000000,1500000000
38242534580,1650662199,320477,39742534580,320477,47344745037,1500000000,1500000000
45612929647,1649035013,55720,47112929647,50920,300000000000,1500000000,1500000000
99385936222,1642334126,54921,100885936222,50121,130000000000,1500000000,1500000000
32215703483,1645799259,67634,34215703483,62834,37000000000,2000000000,2000000000
49302825504,1649030711,55592,50802825504,50792,55989324880,1500000000,1500000000
225918844682,1643303802,346370,227454478816,346370,295641521469,1535634134,1535634134
109574210613,1642330723,322492,111074210613,322492,128654200334,1500000000,1500000000
53191989406,1646299951,331169,54691989406,331169,67098964417,1500000000,1500000000
28613498506,1650623319,60862,30113498506,56062,33298618684,1500000000,1500000000
59647631184,1649104808,66766,61147631184,66766,69395186005,1500000000,1500000000
26160631952,1646303136,321656,27660631952,321656,30026827679,1500000000,1500000000
40723543472,1649230648,331121,42001067075,331121,42001067075,1500000000,1277523603
76926738530,1650639690,60862,78426738530,56062,110987720475,1500000000,1500000000
64528235509,1650650721,55592,66178235509,50792,91014682468,1650000000,1650000000
68755111838,1650596433,55705,70255111838,50905,76267707109,1500000000,1500000000
50022347073,1650654611,67646,51522347073,62846,60278482379,1500000000,1500000000
31934067899,1650618690,60862,33202277010,56062,33202277010,1500000000,1268209111
71299295338,1650641615,67646,73299295338,62846,76534763021,2000000000,2000000000
54316148804,1649104784,63200,55816148804,63200,119998115986,1500000000,1500000000
54316148804,1649104784,67634,56316148804,67634,83020866605,2000000000,2000000000
149516244083,1649098314,67646,151016244083,67646,161628035829,1500000000,1500000000
37402097775,1649068251,67634,38902097775,67634,44546957433,1500000000,1500000000
49631321425,1649073670,317314,51131321425,317314,56280189743,1500000000,1500000000
69475914625,1643276221,304572,70046484250,304572,70046484250,1500000000,570569625
197579693798,1642369208,60838,199079693798,56038,229119565317,1500000000,1500000000
33543057101,1646293698,67622,35043057101,62822,48044016693,1500000000,1500000000
36282104827,1646289874,60850,38583539460,56050,,,
50516019998,1647612356,55717,52016019998,50917,73659055919,1500000000,1500000000
42815870472,1649223592,63200,44315870472,63200,97766668682,1500000000,1500000000
47183204140,1650589064,67646,48683204140,62846,51335555539,1500000000,1500000000
128693502876,1642298312,339975,130193502876,339975,166006007397,1500000000,1500000000
130514711640,1642372786,64044,132014711640,59244,165067429975,1500000000,1500000000
36952972260,1646270818,55592,37952972260,50792,40731199256,1000000000,1000000000
23511617042,1647580446,307813,25011617042,307813,34502992244,1500000000,1500000000
131566578659,1645211294,170000,133066578659,168288,160884905552,1500000000,1500000000
52478057727,1644986752,322478,53978057727,322478,55000000000,1500000000,1500000000
55898116329,1650646569,67622,57398116329,67622,69841393375,1500000000,1500000000
76710464074,1650649065,67634,78210464074,67634,107356764654,1500000000,1500000000
58217899236,1650645194,55592,59717899236,50792,71122950568,1500000000,1500000000
56923154194,1650642036,60862,58423154194,56062,71292370545,1500000000,1500000000
41624176713,1649243679,67634,42302501163,62834,42302501163,1385664578,678324450
81336976771,1650642488,67622,82836976771,67622,92504985423,1500000000,1500000000
95731812264,1642340672,330561,97231812264,330561,116980075573,1500000000,1500000000
38700101058,1646327708,324780,40200101058,324780,40337223218,1500000000,1500000000
42742337318,1646289131,60862,44242337318,56062,58854670750,1500000000,1500000000
63198752604,1649278995,64741,64698752604,59941,200000000000,1500000000,1500000000
40432649414,1650588730,55592,41932649414,50792,60255727990,1500000000,1500000000
72202670800,1650644720,55592,73702670800,50792,90837503869,1500000000,1500000000
73729175136,1650666032,63200,75229175136,63200,132587504242,1500000000,1500000000
67244873900,1649114072,67634,68744873900,67634,100881254835,1500000000,1500000000
58672880511,1649255223,67622,60172880511,67622,90353252457,1500000000,1500000000
59677460914,1650665274,333694,61177460914,333694,71723576070,1500000000,1500000000
34311963355,1650668182,67646,35811963355,67646,49914213759,1500000000,1500000000
34311963355,1650668182,63200,35811963355,63200,72539026894,1500000000,1500000000
27873650250,1650630259,55632,29373650250,50832,35724012963,1500000000,1500000000
94088348008,1642334229,67622,95588348008,62822,99453496697,1500000000,1500000000
38862939987,1645777297,56504,40362939987,51704,46386322258,1500000000,1500000000
48929951629,1644999850,55592,49929951629,50792,50497268771,1000000000,1000000000
91344269515,1650639644,55604,92453103767,50804,92453103767,1500000000,1108834252
82685702833,1650642350,67634,83167145544,67634,83167145544,1500000000,481442711
82685702833,1650642350,67634,84685702833,67634,86933831366,2000000000,2000000000
34414275950,1649067281,66754,35914275950,61954,44923044493,1500000000,1500000000
87610277734,1649112232,67622,89110277734,67622,104270370398,1500000000,1500000000
25876829613,1646313483,333081,27459755434,333081,32486685271,1582925821,1582925821
52832517741,1645757823,346969,54332517741,346969,62535697082,1500000000,1500000000
68198097153,1645144115,325028,69698097153,325028,81953709869,1500000000,1500000000
46583840722,1649289448,328044,48083840722,328044,49066210749,1500000000,1500000000
78582575777,1650640407,67646,80082575777,62846,98045908384,1500000000,1500000000
50807479046,1649039327,67634,52307479046,67634,58658413926,1500000000,1500000000
86676513575,1642342837,64729,88176513575,59929,126823902550,1500000000,1500000000
51934621854,1650662074,55805,52482983584,51005,52482983584,1000000000,548361730
38983393398,1650599838,67646,40483393398,62846,54357590527,1500000000,1500000000
32651065454,1650630169,60862,34651065454,56062,39910017122,2000000000,2000000000
45836102644,1650632074,67634,47336102644,62834,52494039589,1500000000,1500000000
33855549647,1650620802,49483,35355549647,44683,40947773853,1500000000,1500000000
43231791693,1650660618,343195,44731791693,343195,52714657275,1500000000,1500000000
84816423295,1649113048,67634,86316423295,67634,99112472558,1500000000,1500000000
84816423295,1649113048,67634,86316423295,67634,99112472558,1500000000,1500000000
115561479827,1642350394,60042,117061479827,60042,121844419010,1500000000,1500000000
125456857278,1642373836,60838,126956857278,60838,137653160720,1500000000,1500000000
45132200393,1645760458,346350,46632200393,346350,56120744375,1500000000,1500000000
38060949653,1650602942,67634,39560949653,62834,53442723553,1500000000,1500000000
29817423897,1650608707,59946,31317423897,55146,43913132507,1500000000,1500000000
37453928562,1650610521,55680,38953928562,50880,52309138220,1500000000,1500000000
35496431301,1647635894,55648,37996431301,55648,75779114298,2500000000,2500000000
79741331504,1647638565,67634,80267530459,67634,80267530459,1500000000,526198955
82530893092,1645225969,326671,84530893092,326671,122772278516,2000000000,2000000000
45911846933,1650587755,319878,47411846933,313409,78366618488,1500000000,1500000000
28979377945,1650611300,67658,30479377945,62858,40120636678,1500000000,1500000000
54443219569,1649283964,321606,55853219569,321606,57738875628,1410000000,1410000000
38401493465,1649247568,66802,39901493465,62002,53936588525,1500000000,1500000000
39967393970,1649247715,55592,41377393970,50792,42741438800,1410000000,1410000000
34510331693,1650631065,60850,36010331693,56050,48034912523,1500000000,1500000000
48686118666,1650654883,67634,50186118666,62834,67637829188,1500000000,1500000000
56586517490,1650586931,67646,58086517490,62846,59932792014,1500000000,1500000000
44967819394,1650669483,67634,46967819394,62834,61593574278,2000000000,2000000000
35370553808,1649071433,66766,36870553808,61966,36941041037,1500000000,1500000000
52618491635,1647621947,67646,54118491635,62846,60103984567,1500000000,1500000000
62303406943,1650585852,67646,63803406943,62846,86265416084,1500000000,1500000000
62303406943,1650585852,67634,63803406943,67634,84469825645,1500000000,1500000000
26310029489,1646290462,55592,27820029489,50792,29395191235,1510000000,1510000000
49365979740,1650616796,67634,51365979740,62834,61993581440,2000000000,2000000000
74018085387,1645182353,54813,75518085387,50013,96351376869,1500000000,1500000000
28953796973,1649241478,324170,30453796973,235497,30822122213,1500000000,1500000000
45358031680,1649249687,63200,46858031680,63200,73189823676,1500000000,1500000000
65277530662,1650661797,67622,66777530662,67622,77521794240,1500000000,1500000000
78045467318,1649088244,60850,80045467318,56050,87678901921,2000000000,2000000000
98723385929,1642295059,60850,100223385929,56050,149287944358,1500000000,1500000000
47537824118,1649251964,67622,49037824118,67622,69408076733,1500000000,1500000000
42241319191,1646340931,331159,45748121084,331159,45748121084,45748121084,3506801893
35167190923,1649286753,60938,36667190923,56138,47309958119,1500000000,1500000000
27947534961,1650619577,55672,29947534961,50872,43487477249,2000000000,2000000000
62850577042,1650591754,60862,64350577042,56062,79713716717,1500000000,1500000000
37659508142,1650604491,67722,39159508142,67722,40656885175,1500000000,1500000000
67410483079,1650644415,67634,69410483079,67634,94964306134,2000000000,2000000000
69272239741,1650639520,67634,70772239741,62834,77550139832,1500000000,1500000000
69272239741,1650639520,60850,70772239741,56050,77550139832,1500000000,1500000000
69272239741,1650639520,67634,70772239741,62834,77550139832,1500000000,1500000000
40577721976,1649042298,60850,42077721976,60850,45151561299,1500000000,1500000000
108908492044,1642349311,54800,110408492044,54800,130792565762,1500000000,1500000000
131304993246,1642297219,336815,144407468186,336815,,,
46883771866,1646351701,55592,48383771866,50792,64926197435,1500000000,1500000000
29793363672,1645790123,55720,31793363672,50920,100000000000,2000000000,2000000000
73084191036,1649259467,317238,74909537036,317238,100566249697,1825346000,1825346000
74696443872,1650640114,67646,76196443872,62846,110554377937,1500000000,1500000000
67778336911,1649101006,55648,70278336911,55648,153995137652,2500000000,2500000000
122004050023,1642373918,60838,123504050023,60838,154449268539,1500000000,1500000000
100550328654,1645189178,349554,101960328654,349554,118052428455,1410000000,1410000000
72091864462,1649280532,48591,73591864462,43791,102536533217,1500000000,1500000000
45579171818,1649224216,323676,47208110588,323676,64517410522,1628938770,1628938770
53455410880,1649238561,55705,54955410880,50905,62292387175,1500000000,1500000000
38560140515,1649246857,59982,40060140515,55182,58036744960,1500000000,1500000000
31463616896,1650622126,60862,32963616896,60862,34469700108,1500000000,1500000000
46049694772,1646341745,60862,52082457425,56062,52082457425,52082457425,6032762653
54972082137,1645807467,340065,56472082137,340065,60000000000,1500000000,1500000000
51285558809,1645004401,340061,52785558809,340061,52899164032,1500000000,1500000000
23956753537,1650612944,67634,25956753537,62834,37188524222,2000000000,2000000000
122535516428,1642373787,54872,125035516428,54872,220345057152,2500000000,2500000000
95386808784,1649205300,54320,96886808784,49520,121722926162,1500000000,1500000000
115005266600,1644973516,332658,116505266600,332658,158151018684,1500000000,1500000000
37666510098,1650630719,55644,39166510098,55644,49163198489,1500000000,1500000000
47436184707,1649032720,54921,48936184707,50121,200000000000,1500000000,1500000000
35636142363,1650629037,67634,37136142363,67634,48742486227,1500000000,1500000000
35636142363,1650629037,67634,37136142363,62834,48286918439,1500000000,1500000000
35636142363,1650629037,67646,37136142363,62846,43094280805,1500000000,1500000000
75188597450,1650641096,67646,76688597450,62846,79574658344,1500000000,1500000000
62045960242,1649112940,67634,76000000000,62834,,,
58528419727,1649049483,323069,60028419727,323069,75824828490,1500000000,1500000000
32586348978,1646302564,60862,34086348978,56062,39065901832,1500000000,1500000000
41176181444,1646321298,60850,42676181444,56050,63084281550,1500000000,1500000000
30396066496,1646310030,60850,31896066496,56050,39599259908,1500000000,1500000000
27108013556,1647582994,55592,28608013556,50792,37575201343,1500000000,1500000000
41922747592,1649233450,60850,43422747592,56050,57049851534,1500000000,1500000000
90934585355,1649207395,54884,92434585355,50084,124384377047,1500000000,1500000000
95043531602,1645032419,67646,96543531602,62846,115029030248,1500000000,1500000000
72760301197,1650651732,67634,74260301197,67634,77275908794,1500000000,1500000000
46096036526,1650668316,334324,47596036526,334324,56865375568,1500000000,1500000000
39773494212,1650613832,52928,41773494212,48128,60275727461,2000000000,2000000000
45249119745,1650667954,67646,47351769789,62846,,,
49366799641,1649092045,330563,50000000000,330563,50000000000,2200000000,633200359
41344940107,1649230853,319257,42844940107,319257,51606765274,1500000000,1500000000
63058100102,1649218912,330535,64558100102,330535,67326546603,1500000000,1500000000
45545393635,1649039219,55592,47045393635,50792,57438091010,1500000000,1500000000
57849114540,1650645323,67646,59349114540,62846,71102607554,1500000000,1500000000
87903918831,1649102830,67634,89403918831,67634,103241964164,1500000000,1500000000
228563876921,1643303081,56504,230523235320,51704,324062993157,1959358399,1959358399
127898506699,1642327929,67634,129398506699,67634,144713895274,1500000000,1500000000
73767715402,1649269380,52916,75267715402,48116,98629656410,1500000000,1500000000
73767715402,1649269380,324192,75267715402,324192,80145965294,1500000000,1500000000
28679766531,1650630079,55608,30000000000,50808,30000000000,1500000000,1320233469
85718670580,1649088305,60862,87218670580,56062,88000000000,1500000000,1500000000
132215127837,1642298095,60862,133715127837,56062,177337031294,1500000000,1500000000
63230166124,1647570185,67622,65049445015,67622,88633317107,1819278891,1819278891
56081858133,1649254542,63200,57581858133,63200,112552573312,1500000000,1500000000
38548740084,1644979516,343207,40048740084,343207,50000000000,1500000000,1500000000
29546435894,1650601875,317264,31046435894,317264,40191398650,1500000000,1500000000
48581950972,1650670160,67634,50081950972,58034,84143859758,1500000000,1500000000
39092670764,1650630894,326788,40592670764,326788,54041978245,1500000000,1500000000
45324929459,1650632078,60862,46824929459,56062,58795128305,1500000000,1500000000
70251658601,1649091272,60862,71751658601,56062,111174811877,1500000000,1500000000
44262560256,1649043475,60850,46262560256,56050,58583161196,2000000000,2000000000
115990580716,1642308248,325144,117490580716,325144,141921913633,1500000000,1500000000
23806249917,1647585249,67634,25306249917,62834,33441480058,1500000000,1500000000
57256038736,1649285453,321859,58756038736,321859,78914967864,1500000000,1500000000
35854225773,1650671886,22742,37239897694,22742,37239897694,1500000000,1385671921
72074660313,1650641685,60862,73574660313,56062,88172664484,1500000000,1500000000
32887075223,1650632406,59958,34387075223,55158,46315809484,1500000000,1500000000
113101536907,1642297341,54848,114601536907,50048,166380596725,1500000000,1500000000
70809705738,1649109696,67634,72309705738,67634,84742955794,1500000000,1500000000
109006097527,1642342671,336863,110506097527,336863,121889619952,1500000000,1500000000
31334596394,1646286701,342677,33334596394,342677,43299797113,2000000000,2000000000
44531674796,1650653507,67646,46031674796,62846,46946349752,1500000000,1500000000
44531674796,1650653507,66754,46031674796,61954,67043471133,1500000000,1500000000
108015621974,1649100292,67646,109515621974,67646,123738622885,1500000000,1500000000
90588832493,1642326230,60850,92238832493,56050,95000000000,1650000000,1650000000
82224920710,1646272078,67646,83724920710,62846,106137825654,1500000000,1500000000
61354571853,1649262442,48639,62854571853,48639,78499025718,1500000000,1500000000
59932083144,1649091572,60850,61432083144,60850,80428110774,1500000000,1500000000
81749865859,1642343046,66730,83249865859,61930,107952648445,1500000000,1500000000
28986602956,1647584737,331183,30486602956,331183,42421606710,1500000000,1500000000
39523382002,1647599929,67634,41023382002,62834,41862500357,1500000000,1500000000
31264698129,1650609681,334314,32764698129,334314,45880810140,1500000000,1500000000
31264698129,1650609681,336887,32764698129,336887,45880810140,1500000000,1500000000
31220813685,1650619466,101451,36000000000,62834,,,
46388294757,1649035583,67634,47888294757,62834,65236404443,1500000000,1500000000
65534760445,1646349971,55592,67034760445,50792,82447387669,1500000000,1500000000
63073261808,1644978525,314001,64483261808,314001,67313772370,1410000000,1410000000
42753158020,1650593251,60862,44253158020,56062,63249986684,1500000000,1500000000
73138964028,1650640056,305685,74638964028,305685,114168333729,1500000000,1500000000
73138964028,1650640056,67634,74638964028,67634,125367290005,1500000000,1500000000
78440012046,1650644601,67646,79940012046,62846,112188155924,1500000000,1500000000
38266539742,1650629577,60862,39766539742,60862,45726720660,1500000000,1500000000
78726559328,1649115256,67634,80226559328,67634,82957813064,1500000000,1500000000
29709886807,1646314818,346398,31209886807,346398,32987370393,1500000000,1500000000
67078355259,1649208936,336863,68578355259,336863,91011463948,1500000000,1500000000
84570127338,1649280433,67722,86570127338,67722,106627215253,2000000000,2000000000
30649906072,1650629483,67646,31757051667,62846,31757051667,2000000000,1107145595
30108171594,1650616206,60862,31608171594,56062,34443093798,1500000000,1500000000
64036278028,1650642045,55592,65536278028,50792,71292370545,1500000000,1500000000
50499393080,1649045606,60838,51999393080,60838,64148980449,1500000000,1500000000
123414631733,1643257503,331394,125414631733,331394,136680149429,2000000000,2000000000
33410836783,1650620741,67646,34910836783,62846,38322458364,1500000000,1500000000
57028983350,1650643079,55592,58528983350,50792,70396830992,1500000000,1500000000
32334922518,1650607543,60850,33834922518,56050,46508336025,1500000000,1500000000
59882907995,1649094676,322919,61382907995,322919,103983187843,1500000000,1500000000
42075338517,1649068290,316564,43575338517,316564,52961412194,1500000000,1500000000
108131696808,1642319284,67634,109131696808,67634,110000000000,1000000000,1000000000
75240995582,1642332717,331165,76740995582,331165,98007341313,1500000000,1500000000
52649096677,1649232082,60850,54149096677,56050,59383930710,1500000000,1500000000
41855537590,1649249103,66778,43355537590,61978,55357962364,1500000000,1500000000
84131378820,1645043610,67646,85631378820,62846,96152320646,1500000000,1500000000
40714137319,1650628221,60850,42214137319,60850,49671888423,1500000000,1500000000
108339265887,1642342643,337500,109839265887,337500,121889619952,1500000000,1500000000
24560188877,1646305344,307708,26060188877,307708,34971427417,1500000000,1500000000
29411863371,1647592148,317264,30911863371,317264,40992643395,1500000000,1500000000
167200818570,1644973689,337524,168282777603,337524,168282777603,1500000000,1081959033
38218462087,1649036450,63200,39718462087,63200,88856484770,1500000000,1500000000
162023352348,1642355025,309162,163523352348,309162,164831957468,1500000000,1500000000
39583992136,1646278314,67658,41083992136,62858,44000000000,1500000000,1500000000
33340932281,1649235326,67722,34840932281,67722,45646959247,1500000000,1500000000
38537510738,1650628192,319751,40037510738,319751,60000000000,1500000000,1500000000
38537510738,1650628192,319745,40037510738,319745,60000000000,1500000000,1500000000
40966518166,1649036000,63200,42466518166,63200,80726613494,1500000000,1500000000
39187395882,1649077709,66838,41187395882,62038,56282250544,2000000000,2000000000
122450789807,1642298838,67634,123950789807,67634,183135059412,1500000000,1500000000
44230687627,1647596550,327327,45730687627,327327,46782096920,1500000000,1500000000
70180818596,1649258321,55705,71680818596,50905,88453385044,1500000000,1500000000
32784182687,1645014208,323608,34284182687,323608,44869748938,1500000000,1500000000
47338628161,1650594809,55592,48838628161,50792,67891558312,1500000000,1500000000
70913559556,1643279310,332609,72413559556,332609,116254048364,1500000000,1500000000
89093341441,1642342353,63188,91593341441,63188,195463412988,2500000000,2500000000
90523565140,1645185476,64729,92023565140,59929,100625225254,1500000000,1500000000
125353395643,1645208927,337486,127353395643,337486,150221130592,2000000000,2000000000
46359692008,1649256543,63200,47859692008,63200,84647689056,1500000000,1500000000
42498948356,1650671076,55592,43998948356,50792,54526536679,1500000000,1500000000
25408044865,1650611342,318502,26908044865,318502,27000000000,1500000000,1500000000
40877069221,1649043773,55660,42377069221,50860,49786564720,1500000000,1500000000
66592372068,1649093070,314182,68092372068,314182,71037646300,1500000000,1500000000
29597514158,1646303269,60850,31097514158,56050,38464927254,1500000000,1500000000
38293525514,1645007865,52916,39793525514,48116,50676541168,1500000000,1500000000
51653391197,1645001993,56729,52741912885,47129,56531889514,1088521688,1088521688
35833705878,1650608328,67634,37330824257,62834,37330824257,1500000000,1497118379
87036868445,1650640479,67646,88536868445,62846,111557054165,1500000000,1500000000
40902998184,1646266331,60862,42402998184,56062,58551967174,1500000000,1500000000
40323748152,1649249685,334350,41323748152,334350,42039913818,1000000000,1000000000
26330141480,1650617679,60862,27830141480,56062,35212393829,1500000000,1500000000
109784755349,1642346103,326778,111284755349,251416,123936821630,1500000000,1500000000
32808122251,1646296766,67634,34308122251,62834,45655652742,1500000000,1500000000
37645593104,1646293136,304574,39145593104,304574,43848056628,1500000000,1500000000
37163307049,1649284711,60850,38663307049,60850,53205500998,1500000000,1500000000
40589799711,1649252177,67634,42089799711,67634,56464028955,1500000000,1500000000
58526531379,1650650928,55580,61392330491,50780,,,
29056121594,1650619737,54712,30556121594,49912,39378346592,1500000000,1500000000
25672007437,1650619027,55705,27172007437,50905,38373873505,1500000000,1500000000
48132699749,1649055514,67722,49632699749,62922,50479841104,1500000000,1500000000
115921684659,1642351888,67646,117421684659,62846,131446088883,1500000000,1500000000
29929528826,1646304822,314186,31386856517,314186,31386856517,1500000000,1457327691
29570719003,1646299175,67634,31070719003,67634,34442950484,1500000000,1500000000
51434043402,1645813630,337480,52934043402,337480,65092302010,1500000000,1500000000
51434043402,1645813630,56504,52934043402,51704,65092302010,1500000000,1500000000
51802416789,1645759924,343787,53302416789,343787,67616204369,1500000000,1500000000
48365149105,1650602822,60850,49865149105,60850,58860990542,1500000000,1500000000
156639999516,1642301208,343839,158139999516,343839,175277461263,1500000000,1500000000
70692576449,1649210155,67634,72192576449,62834,87149701054,1500000000,1500000000
145757161306,1650589898,55693,147257161306,50893,150397366764,1500000000,1500000000
145757161306,1650589898,316592,147757161306,316592,211199909295,2000000000,2000000000
31375528177,1650610783,91407,36000000000,56138,,,
44624791491,1650669450,67634,46124791491,62834,50657719305,1500000000,1500000000
52224797099,1649091985,60850,53224797099,56050,57000000000,1000000000,1000000000
81855017639,1642322665,340015,83355017639,340015,122734950534,1500000000,1500000000
36876935286,1646315638,60850,38376935286,56050,43131374908,1500000000,1500000000
31462385970,1646291121,60850,32962385970,56050,43518129459,1500000000,1500000000
79283393792,1647617329,60850,80783393792,56050,85781266898,1500000000,1500000000
52101325967,1645154403,67634,53601325967,67634,68879797224,1500000000,1500000000
100430359369,1645211409,339456,101930359369,339456,139788193854,1500000000,1500000000
37133739007,1649229403,60850,38633739007,60850,58885418283,1500000000,1500000000
37133739007,1649229403,67634,38633739007,62834,40000000000,1500000000,1500000000
37069397869,1650609884,67646,38569397869,62846,50303662595,1500000000,1500000000
39131964838,1650671046,55592,40631964838,50792,43555873392,1500000000,1500000000
63329270112,1649102980,67634,64829270112,67634,83792878622,1500000000,1500000000
76122870782,1642322293,327112,77622870782,327112,101717262155,1500000000,1500000000
65092931673,1645809360,60926,66592931673,60926,87554800639,1500000000,1500000000
53161709739,1647642043,60862,54661709739,56062,76494175694,1500000000,1500000000
107674115535,1645225857,320635,109174115535,320635,150101129557,1500000000,1500000000
37810066683,1649239407,66730,39310066683,66730,51680710703,1500000000,1500000000
45512543368,1650639344,67658,47012543368,67658,58687110964,1500000000,1500000000
45512543368,1650639344,67622,47512543368,67622,61474595403,2000000000,2000000000
59153661806,1649104845,331133,61153661806,331133,84075954612,2000000000,2000000000
49838666733,1649030860,55717,52838666733,50917,69015064191,3000000000,3000000000
76545395641,1649082898,60862,78045395641,56062,88286535422,1500000000,1500000000
105523490571,1642346271,333762,107023490571,333762,132737043407,1500000000,1500000000
49880746638,1646276462,321006,51380746638,321006,56951960393,1500000000,1500000000
80279317833,1645227909,317330,81779317833,317330,90702572270,1500000000,1500000000
51928208189,1645166324,67646,53428208189,62846,72536714197,1500000000,1500000000
58392148387,1649219935,55717,60392148387,50917,79725081464,2000000000,2000000000
88475401435,1650640018,49571,90475401435,44771,122624212369,2000000000,2000000000
46887860863,1650661065,55681,48387860863,55681,69298488483,1500000000,1500000000
46887860863,1650661065,67646,48887860863,62846,62428332529,2000000000,2000000000
50780888736,1650657093,66778,52280888736,66778,60014713770,1500000000,1500000000
45570590639,1650613580,67646,47070590639,67646,60052925279,1500000000,1500000000
74375910802,1649107410,328384,75875910802,328384,77015672664,1500000000,1500000000
37241039259,1649035154,54921,38741039259,50121,42174293838,1500000000,1500000000
38395453289,1649072924,60850,39895453289,60850,54944315165,1500000000,1500000000
38395453289,1649072924,60862,39895453289,56062,55287739624,1500000000,1500000000
70898188195,1647619272,63200,72398188195,63200,141007853160,1500000000,1500000000
55382399450,1649224181,340019,57061717770,340019,63877109369,1679318320,1679318320
25416007932,1650619919,60850,26916007932,56050,37045481539,1500000000,1500000000
32019625232,1650612467,340621,32538778314,340621,32538778314,1500000000,519153082
28998012790,1650616439,101469,32000000000,62846,,,
59852500107,1649114810,317334,60620839995,317334,60620839995,1500000000,768339888
113149109971,1642373887,67622,114649109971,67622,152253390618,1500000000,1500000000
23764016949,1646312082,54759,25264016949,49959,45456663175,1500000000,1500000000
66764679443,1645171816,55717,68264679443,50917,100578408244,1500000000,1500000000
53545706216,1644976497,343957,55045706216,337488,60000000000,1500000000,1500000000
58642838319,1650654405,67646,60142838319,62846,83854847477,1500000000,1500000000
43020431335,1650600538,67734,44520431335,62934,58738647103,1500000000,1500000000
93243308960,1650664881,55592,99000000000,50792,,,
131791450333,1650589707,329978,133291450333,329978,173554446824,1500000000,1500000000
55739187342,1649046561,67646,57239187342,62846,64192302513,1500000000,1500000000
29012556739,1646306819,55592,31012556739,50792,44651370154,2000000000,2000000000
24373364296,1646314856,60850,25873364296,56050,38194673869,1500000000,1500000000
53474706994,1644994396,56729,54974706994,47129,65168892049,1500000000,1500000000
68112005954,1649105724,67634,69612005954,62834,78465965790,1500000000,1500000000
66976215526,1649077922,49483,68476215526,49483,76289300170,1500000000,1500000000
36223748972,1650614454,327932,37723748972,327932,47374160382,1500000000,1500000000
42787335557,1650656429,55720,44287335557,50920,200000000000,1500000000,1500000000
87476318545,1642340980,325158,88476318545,325158,96923200307,1000000000,1000000000
59210539796,1650642754,67622,59984379478,67622,59984379478,1500000000,773839682
59210539796,1650642754,55234,60710539796,50434,61347371954,1500000000,1500000000
86533644274,1650639715,338688,88533644274,338688,102004760089,2000000000,2000000000
46125567386,1650592122,67646,47625567386,62846,53734299587,1500000000,1500000000
46125567386,1650592122,67646,47625567386,62846,53734299587,1500000000,1500000000
216101234575,1643304562,333720,217601234575,333720,317817874228,1500000000,1500000000
116787700315,1643250336,67646,118287700315,62846,131604504147,1500000000,1500000000
57618691783,1646326614,313451,59118691783,313451,96439446362,1500000000,1500000000
89998054487,1645222718,335497,91998054487,335497,130120775543,2000000000,2000000000
54745081799,1650639441,55705,61963173847,50905,,,
27084271326,1650623021,66754,28584271326,66754,36065828110,1500000000,1500000000
63777014010,1650644289,55592,65000000000,50792,65000000000,1500000000,1222985990
64842365197,1650641425,60850,66342365197,56050,86536789787,1500000000,1500000000
93474372114,1649098951,67634,94974372114,67634,113687099067,1500000000,1500000000
99924582142,1643266163,102916,109079138308,48116,,,
67602713133,1645150359,48603,69102713133,48603,73933908125,1500000000,1500000000
62122819771,1645159466,54772,63622819771,49972,65000000000,1500000000,1500000000
43442683859,1649227250,64741,44942683859,59941,58569447635,1500000000,1500000000
33910381620,1650612597,67634,35410381620,67634,46808585454,1500000000,1500000000
94417859814,1649102221,67634,95917859814,62834,122618407700,1500000000,1500000000
105516889167,1642347144,60874,107016889167,56074,119761610623,1500000000,1500000000
45962066447,1646270646,67622,47462066447,67622,50364048725,1500000000,1500000000
58181433444,1649271827,63200,59681433444,63200,110122930682,1500000000,1500000000
41772270176,1645004174,340683,43272270176,340683,55287122077,1500000000,1500000000
32651924925,1650624309,67634,34151924925,62834,43737611130,1500000000,1500000000
32651924925,1650624309,60862,34151924925,56062,43737611130,1500000000,1500000000
29500557224,1650627020,67646,37500557224,67646,42000000000,8000000000,8000000000
66755660161,1650587559,60838,68255660161,60838,78003945930,1500000000,1500000000
76401878119,1649101809,56516,77971701607,51716,89990278387,1569823488,1569823488
180060267220,1642367486,60850,181560267220,60850,182517508375,1500000000,1500000000
58698270333,1645751619,343213,60208270333,343213,74668179219,1510000000,1510000000
66392691757,1645169532,334332,67892691757,334332,102055129524,1500000000,1500000000
60164118493,1649260514,63200,61664118493,63200,122661507590,1500000000,1500000000
70295006232,1650660124,60862,71795006232,56062,81015631527,1500000000,1500000000
44489715408,1646282136,67658,45989715408,62858,46000000000,1500000000,1500000000
42793250483,1650587703,55717,44293250483,50917,47177939792,1500000000,1500000000
46669700938,1650598902,55636,48169700938,50836,60204421735,1500000000,1500000000
36087777991,1650600110,67634,37587777991,67634,48646981715,1500000000,1500000000
89954577390,1650642206,60862,91454577390,56062,102788490578,1500000000,1500000000
44662816017,1650659498,67646,46162816017,62846,56340117512,1500000000,1500000000
58656843366,1650641192,67646,60656843366,67646,74210982276,2000000000,2000000000
56522639613,1650645262,55580,58022639613,55580,78027394919,1500000000,1500000000
55615245342,1647572443,67658,57115245342,62858,87905296239,1500000000,1500000000
84527596092,1645216468,355878,85852996092,355878,96427812962,1325400000,1325400000
26631382757,1650631445,337450,27631382757,337450,27733314421,1000000000,1000000000
77679123472,1649102350,67646,79179123472,62846,109519038299,1500000000,1500000000
30965221921,1645794336,325597,32475221921,325597,40381805312,1510000000,1510000000
52607051730,1649266347,67722,54107051730,67722,66109280007,1500000000,1500000000
65629091322,1650642967,67646,67129091322,62846,86236299318,1500000000,1500000000
111379956374,1650643918,60862,112879956374,56062,131976318373,1500000000,1500000000
49793523763,1650588486,67646,51293523763,62846,71316908065,1500000000,1500000000
69856082235,1650640386,67658,71356082235,62858,92921202334,1500000000,1500000000
105274816188,1643302287,333718,106774816188,333718,156168781979,1500000000,1500000000
105274816188,1643302287,349582,106774816188,349582,111000000000,1500000000,1500000000
70906356162,1646335264,55592,72406356162,50792,111000000000,1500000000,1500000000
42201079648,1645766543,67634,43711079648,62834,51366981628,1510000000,1510000000
80178892750,1649208053,311170,81678892750,311170,116876828119,1500000000,1500000000
80178892750,1649208053,67622,82178892750,67622,90000000000,2000000000,2000000000
54370344572,1649104307,63200,55870344572,63200,127955506292,1500000000,1500000000
40903177419,1647605620,67634,42403177419,67634,49982165087,1500000000,1500000000
164557532039,1643297380,56480,166057532039,56480,186635597159,1500000000,1500000000
101414191656,1642329484,67634,103414191656,67634,145838392333,2000000000,2000000000
103915444618,1642320622,54861,106415444618,54861,217458031176,2500000000,2500000000
116943773864,1642325212,55648,118443773864,55648,172542268613,1500000000,1500000000
72819897845,1649099392,64717,74319897845,64717,93884356457,1500000000,1500000000
96810071378,1642349286,56504,98310071378,51704,130792565762,1500000000,1500000000
71507699026,1645169453,60950,73007699026,56150,88082932029,1500000000,1500000000
109525126930,1645016936,67622,111141092619,67622,133131623024,1615965689,1615965689
39326175444,1650669423,60862,40826175444,60862,53416241653,1500000000,1500000000
40977397405,1650616991,343811,42477397405,343811,42589668775,1500000000,1500000000
51819516937,1649042563,67646,53319516937,67646,53676745983,1500000000,1500000000
60525863463,1649044077,67622,62025863463,67622,63537305733,1500000000,1500000000
92172572682,1642351820,60850,93672572682,56050,160632148837,1500000000,1500000000
30580910043,1646327695,67634,32580910043,67634,200000000000,2000000000,2000000000
35889662741,1645782954,323024,37389662741,323024,42626215507,1500000000,1500000000
37374351427,1645154851,49495,38874351427,44695,61055808483,1500000000,1500000000
63133180972,1649214438,320511,65133180972,320511,100000000000,2000000000,2000000000
45194839080,1649235814,67634,47194839080,62834,56905110163,2000000000,2000000000
232107379520,1642352965,329287,252000000000,329287,,,
36108266025,1647631840,60862,37608266025,56062,51538472654,1500000000,1500000000
164344328313,1650590018,60850,165844328313,60850,172880062543,1500000000,1500000000
31934608026,1650620404,330531,33434608026,330531,45592271039,1500000000,1500000000
35136927548,1649046222,55592,36636927548,50792,52030892219,1500000000,1500000000
79231244560,1649112601,67622,80731244560,62822,101721952874,1500000000,1500000000
39981767000,1646289449,54095,41481767000,49295,48321667768,1500000000,1500000000
66307322059,1646320765,60838,67807322059,60838,68010198788,1500000000,1500000000
30710925737,1645758422,304542,32210925737,304542,35474027493,1500000000,1500000000
70354480541,1645185360,66838,71854480541,66838,88950231003,1500000000,1500000000
71849426957,1645182986,343241,73349426957,343241,81000000000,1500000000,1500000000
51509466068,1645002407,55612,53009466068,55612,57621361245,1500000000,1500000000
71644503853,1650664352,337450,73144503853,337450,73850164914,1500000000,1500000000
30753787889,1649058784,64741,32253787889,59941,59526316684,1500000000,1500000000
43982148559,1649050404,324844,45482148559,324844,55128303962,1500000000,1500000000
48216681399,1649074072,67646,49716681399,62846,61562107043,1500000000,1500000000
27670969588,1647608205,67634,29170969588,62834,30274117507,1500000000,1500000000
27611214793,1650622987,101487,38000000000,62858,,,
66117471362,1649107325,55648,68617471362,55648,109911486354,2500000000,2500000000
40753081508,1649036386,54921,42253081508,50121,48425422004,1500000000,1500000000
116101508226,1643274385,54872,117601508226,50072,139492099484,1500000000,1500000000
83648515361,1642311845,333067,85000000000,333067,85000000000,1410000000,1351484639
29637747956,1650624496,331159,31137747956,331159,50472976317,1500000000,1500000000
84873996668,1649107558,64717,86373996668,64717,89350164414,1500000000,1500000000
69758586689,1649083988,67634,71258586689,67634,97880085242,1500000000,1500000000
59905087124,1649104467,67634,61405087124,67634,80552547778,1500000000,1500000000
68201143222,1649263634,67622,69701143222,62822,82299636252,1500000000,1500000000
49280789375,1650659811,55768,50780789375,50968,62420767404,1500000000,1500000000
66781725831,1650650212,67658,68781725831,62858,85809081741,2000000000,2000000000
116059420823,1642318223,67646,117317753427,62846,,,
70394097664,1646330756,67646,71894097664,67646,76672400680,1500000000,1500000000
50231293743,1645002088,67646,51731293743,62846,51992571567,1500000000,1500000000
27728785282,1650612794,66766,29228785282,66766,42544323795,1500000000,1500000000
48826762998,1650587443,67622,50326762998,67622,55024541742,1500000000,1500000000
48826762998,1650587443,64741,50326762998,59941,55024541742,1500000000,1500000000
43583440345,1649105311,63200,45083440345,63200,110953787398,1500000000,1500000000
53443843686,1649069042,67634,54943843686,67634,60424846464,1500000000,1500000000
128577548485,1642316255,67622,129690107193,67622,129690107193,1872100000,1112558708
75387004133,1645217279,55681,76887004133,50881,98209735913,1500000000,1500000000
41331458358,1649249935,67646,42831458358,62846,54398046057,1500000000,1500000000
58072761684,1649267586,320649,60572761684,320649,200000000000,2500000000,2500000000
45169881405,1649223727,67634,46669881405,62834,54570120698,1500000000,1500000000
77918103101,1644990316,309200,79743449101,309200,102031945907,1825346000,1825346000
77918103101,1644990316,323565,79743449101,323565,108287400733,1825346000,1825346000
34968677272,1650615483,316724,36468677272,316724,40356380112,1500000000,1500000000
57060995385,1650654921,67710,58560995385,67710,62357648333,1500000000,1500000000
55824308117,1649060329,318466,57324308117,318466,59504592143,1500000000,1500000000
45751305311,1649034984,318718,47251305311,318718,50832299468,1500000000,1500000000
109797123578,1642292402,55705,111297123578,50905,135513291405,1500000000,1500000000
59358180328,1645796567,63200,61858180328,63200,96324041968,2500000000,2500000000
73267735281,1645051682,60850,74767735281,56050,86664755725,1500000000,1500000000
26681340647,1650619671,30000,27997635897,30000,27997635897,1500000000,1316295250
107084437329,1643269625,324791,108584437329,324791,117093667870,1500000000,1500000000
110775438754,1642295271,53799,112275438754,48999,125668897469,1500000000,1500000000
42766207193,1645761874,60850,44266207193,56050,63369432627,1500000000,1500000000
63643530141,1649267175,60862,65143530141,56062,73101689314,1500000000,1500000000
51068088178,1650670020,63200,52568088178,63200,100082378530,1500000000,1500000000
80766865351,1642324180,60850,82266865351,56050,92459857528,1500000000,1500000000
65610906013,1650591856,60850,67110906013,60850,80063221303,1500000000,1500000000
108634028733,1642345753,54346,110134028733,49546,150944817248,1500000000,1500000000
132484167963,1642346326,334354,133984167963,334354,149891224774,1500000000,1500000000
63416725556,1649210817,67634,64916725556,67634,76008409150,1500000000,1500000000
40659837855,1649249298,63200,42159837855,63200,86526093498,1500000000,1500000000
87573662157,1642333658,67622,89073662157,67622,110832197248,1500000000,1500000000
27292299581,1646306235,60862,28792299581,56062,36830539835,1500000000,1500000000
39994386542,1646307989,55592,41994386542,50792,43484119719,2000000000,2000000000
76962740675,1647617604,60850,78462740675,60850,111446772393,1500000000,1500000000
110657068819,1649204603,52916,112157068819,48116,140516997997,1500000000,1500000000
60675966103,1650649342,336841,62175966103,336841,88101040209,1500000000,1500000000
65350377136,1650646653,67634,66850377136,62834,66938260858,1500000000,1500000000
76103770001,1649099402,331175,78103770001,331175,95889407068,2000000000,2000000000
49610225996,1649045538,67634,54610225996,67634,105000000000,5000000000,5000000000
94298887440,1642349388,67646,95798887440,62846,114081390793,1500000000,1500000000
87036628217,1642330786,314033,88536628217,314033,133242106042,1500000000,1500000000
67403654395,1646319377,60850,68903654395,60850,84729401880,1500000000,1500000000
49767755061,1647614211,56729,51267755061,47129,80292947535,1500000000,1500000000
32694371938,1650658084,60862,34194371938,56062,56112169639,1500000000,1500000000
59969916100,1650633707,60862,61469916100,56062,77637683048,1500000000,1500000000
43863774005,1650654622,48603,45363774005,48603,64473844948,1500000000,1500000000
70273086883,1649104191,60838,71773086883,56038,77736306698,1500000000,1500000000
30671987199,1646312527,302223,32255780373,302223,40208387584,1583793174,1583793174
41596261543,1645156043,54808,43096261543,50008,49397250303,1500000000,1500000000
69776332214,1649285106,64741,71276332214,59941,200000000000,1500000000,1500000000
53423175951,1644987508,322897,54923175951,322897,76862257744,1500000000,1500000000
37708096132,1650658271,314452,39208096132,314452,43869033597,1500000000,1500000000
84894086113,1649106462,48615,86394086113,43815,104944956778,1500000000,1500000000
76479393240,1642344603,60850,77979393240,60850,113537225303,1500000000,1500000000
53087906498,1645145660,55693,54587906498,50893,82269387503,1500000000,1500000000
41469283265,1649245071,60938,42969283265,60938,65428560478,1500000000,1500000000
58860984733,1650648652,66778,60360984733,66778,83789483804,1500000000,1500000000
93952399558,1650646180,60874,96000000000,56074,,,
36560598462,1650607717,67634,38060598462,62834,41439910628,1500000000,1500000000
101629381414,1642347098,334326,103129381414,334326,139751280583,1500000000,1500000000
59809941776,1650587273,67622,61809941776,62822,63440080517,2000000000,2000000000
32599815787,1650602664,67646,34099815787,62846,48266701834,1500000000,1500000000
29907146496,1646287689,67646,31407146496,62846,35910107149,1500000000,1500000000
54369733151,1644981472,332535,55869733151,332535,61866461739,1500000000,1500000000
36651046414,1650598266,60862,38151046414,56062,39926116705,1500000000,1500000000
42514389995,1649060988,67622,44014389995,62822,59383231327,1500000000,1500000000
114469513726,1642376977,346366,115969513726,346366,162071995935,1500000000,1500000000
99898044031,1642347129,67658,101398044031,62858,130743289605,1500000000,1500000000
81940299526,1642337465,60862,89296197042,56062,,,
60326798588,1649213320,56492,61826798588,56492,65481981035,1500000000,1500000000
67905114866,1649267539,55620,69405114866,50820,74024731848,1500000000,1500000000
50703641941,1645018770,55693,52203641941,50893,54888526509,1500000000,1500000000
110458216843,1650643826,67634,111958216843,62834,146907439862,1500000000,1500000000
33708894740,1650602326,67634,35208894740,62834,40158840915,1500000000,1500000000
33817731591,1649056778,335636,35817731591,335636,41286709256,2000000000,2000000000
49648323080,1647627248,333718,51148323080,333718,67377761208,1500000000,1500000000
46766488058,1645054663,55644,49266488058,55644,107093154192,2500000000,2500000000
125362839438,1645027392,60838,126862839438,56038,135005376088,1500000000,1500000000
29745507832,1650619760,60850,31245507832,60850,39378346592,1500000000,1500000000
76821023401,1642343094,336895,78321023401,336895,116382949942,1500000000,1500000000
55036985862,1649276551,67646,57036985862,67646,78630884457,2000000000,2000000000
167855433558,1644971619,313447,169355433558,313447,195391976817,1500000000,1500000000
33836112104,1650609792,315313,35336112104,315313,48442376632,1500000000,1500000000
28186062829,1650610127,60850,29686062829,60850,38733778718,1500000000,1500000000
26406401314,1650614883,330531,27906401314,330531,38366596503,1500000000,1500000000
46787503582,1650642711,67634,48287503582,67634,89273076328,1500000000,1500000000
44137365636,1649056037,60838,45761922814,60838,52798977374,1624557178,1624557178
64510269973,1649061661,337520,66010269973,337520,69671199928,1500000000,1500000000
67588834316,1643286818,64741,69088834316,59941,99238137877,1500000000,1500000000
67588834316,1643286818,60838,69088834316,60838,99238137877,1500000000,1500000000
35287456573,1650609453,60006,36787456573,55206,43324167939,1500000000,1500000000
74607127572,1649084285,67646,75825722917,67646,75825722917,1500000000,1218595345
91482229782,1642291859,340017,92982229782,340017,97358566572,1500000000,1500000000
40252316124,1647624934,67646,41752316124,62846,54127408328,1500000000,1500000000
42324084688,1650650442,336875,43824084688,336875,44000000000,1500000000,1500000000
45095042356,1649060159,67646,46595042356,62846,60675240504,1500000000,1500000000
26474772496,1646314846,55592,27974772496,45992,30000000000,1500000000,1500000000
155306709972,1645195845,329417,156806709972,329417,231119707003,1500000000,1500000000
35927880376,1649287504,60938,37427880376,60938,38195515652,1500000000,1500000000
32217628940,1650621299,75657,35000000000,60938,,,
103638361986,1649100426,67634,105138361986,67634,114654125394,1500000000,1500000000
103638361986,1649100426,67634,105138361986,67634,107535323352,1500000000,1500000000
126993222440,1642293696,67646,128993222440,62846,168495573182,2000000000,2000000000
33014681702,1647610996,67634,34514681702,62834,46884700117,1500000000,1500000000
31493203075,1650623897,55693,32969105623,50893,32969105623,1500000000,1475902548
40177400954,1650662174,60850,43177400954,60850,420000000000,3000000000,3000000000
64472041052,1650646392,331997,65972041052,331997,93969259873,1500000000,1500000000
74886661356,1642343938,67634,76386661356,67634,97020148774,1500000000,1500000000
32844596378,1647594607,327383,34344596378,327383,45036595803,1500000000,1500000000
51839327332,1649276142,66790,53339327332,66790,66293836348,1500000000,1500000000
39909717503,1645002345,323547,41488135474,323547,,,
55577155217,1644981679,55705,57077155217,50905,66891251580,1500000000,1500000000
33970993273,1646349021,67622,35470993273,67622,36000000000,1500000000,1500000000
27948248897,1646312971,60850,33235442837,56050,,,
38832349913,1646315299,321662,40332349913,321662,46099183892,1500000000,1500000000
97062164914,1647571941,55705,98562164914,50905,130099774630,1500000000,1500000000
79252198621,1645213975,337697,80752198621,337697,81402248168,1500000000,1500000000
63858547601,1645182624,340683,65358547601,340683,66000000000,1500000000,1500000000
74389054443,1649212406,55680,75889054443,50880,99359396633,1500000000,1500000000
51541537750,1650595678,60862,53541537750,56062,71155961517,2000000000,2000000000
105393684833,1642330766,325647,106893684833,308547,128654200334,1500000000,1500000000
78286816690,1642332957,67634,80286816690,67634,105621386945,2000000000,2000000000
34748610475,1645793116,54933,36748610475,50133,200000000000,2000000000,2000000000
128516556284,1645199329,60850,130516556284,60850,159318128608,2000000000,2000000000
41039913818,1649249556,343199,42539913818,343199,48974949218,1500000000,1500000000
69324184106,1649090777,67634,71324184106,62834,93637743993,2000000000,2000000000
43964566283,1646279724,60850,45464566283,56050,55925663032,1500000000,1500000000
27084470161,1646300511,67658,28584470161,62858,33576679020,1500000000,1500000000
81764854605,1649254039,63200,83264854605,63200,154941450400,1500000000,1500000000
51571490159,1645003793,55648,54071490159,55648,109927605456,2500000000,2500000000
31982956989,1650629902,67634,33482956989,67634,38844178645,1500000000,1500000000
31982956989,1650629902,55668,33482956989,50868,37852139449,1500000000,1500000000
33359507581,1650604849,66730,34859507581,61930,50938788914,1500000000,1500000000
45431828952,1650599272,67710,46931828952,67710,53852115025,1500000000,1500000000
45431828952,1650599272,67646,46931828952,58046,48041169292,1500000000,1500000000
36042254967,1646305858,67622,37542254967,67622,44132140794,1500000000,1500000000
75423584622,1645828562,67622,76923584622,62822,80000000000,1500000000,1500000000
61690400412,1650653753,67658,63190400412,62858,79483260718,1500000000,1500000000
69338131587,1650641637,346356,70988131587,346356,73168041367,1650000000,1650000000
98785745026,1642374775,60850,100285745026,60850,124545795883,1500000000,1500000000
47875045527,1645167223,60938,49375045527,60938,58014089540,1500000000,1500000000
40550319069,1650605277,321895,42050319069,321895,50412882209,1500000000,1500000000
48653470781,1650587349,325155,50153470781,325155,62371542209,1500000000,1500000000
48653470781,1650587349,319877,50153470781,319877,67986157923,1500000000,1500000000
59287858941,1650664275,331153,60787858941,331153,88974965362,1500000000,1500000000
146596590524,1643250812,67634,148096590524,62834,192032903088,1500000000,1500000000
93306739725,1642299021,55592,94806739725,45992,118772696150,1500000000,1500000000
52668299547,1647572874,328841,54168299547,328841,60504233999,1500000000,1500000000
48441816116,1645014573,56729,49941816116,47129,55328619392,1500000000,1500000000
61662074223,1649104089,67634,62231903498,67634,62231903498,1500000000,569829275
47497801889,1647575619,316592,48997801889,316592,59551273908,1500000000,1500000000
77947485197,1645151651,340057,79447485197,340057,80000000000,1500000000,1500000000
173345251126,1645175027,55632,174845251126,50832,203787189375,1500000000,1500000000
34930760593,1649235594,304845,36430760593,304845,40314491233,1500000000,1500000000
34600384971,1650610590,60862,36100384971,56062,45260356669,1500000000,1500000000
68123413366,1650664396,67646,71123413366,62846,98819161952,3000000000,3000000000
64165223410,1649115039,54748,65665223410,49948,70573923613,1500000000,1500000000
26288304798,1646303194,64044,27788304798,59244,28000000000,1500000000,1500000000
86116593024,1645221386,336305,87616593024,336305,91743523707,1500000000,1500000000
49896290807,1650632104,67634,51396290807,67634,58795128305,1500000000,1500000000
25922338647,1646300432,313455,27422338647,313455,37165764874,1500000000,1500000000
39620962123,1646314000,60838,41120962123,60838,57656576007,1500000000,1500000000
44641981694,1646284828,310900,46141981694,310900,46689478239,1500000000,1500000000
41988745540,1645787003,55580,43488745540,50780,53726016614,1500000000,1500000000
65271853090,1650660019,337462,66771853090,337462,94141484295,1500000000,1500000000
80733292484,1643267189,64705,82733292484,59905,113277425616,2000000000,2000000000
84441154028,1642306598,67646,85941154028,62846,125954469910,1500000000,1500000000
165656199199,1642354335,67646,167156199199,62846,233521407284,1500000000,1500000000
69167151657,1645801231,322937,70667151657,322937,103758781397,1500000000,1500000000
53425859648,1649221968,328220,55425859648,328220,65788822443,2000000000,2000000000
45888792433,1650602781,67634,47388792433,62834,47573108432,1500000000,1500000000
108298537332,1642341321,60850,109798537332,60850,112414833317,1500000000,1500000000
139854882027,1642364206,55592,141354882027,50792,249079504610,1500000000,1500000000
29816015713,1646303174,60838,30570566602,60838,30570566602,1500000000,754550889
42578597877,1645771188,313345,44078597877,313345,45164700983,1500000000,1500000000
26510414877,1645787546,60926,28010414877,60926,33545892123,1500000000,1500000000
33731604472,1645791718,346977,35231604472,346977,40768474414,1500000000,1500000000
32948615579,1647588795,327996,34997666166,327996,,,
28380872336,1646351181,314148,29880872336,314148,47204170417,1500000000,1500000000
46350070187,1647634886,63200,47850070187,63200,88324165118,1500000000,1500000000
38293266656,1649225323,317292,39793266656,317292,49540253265,1500000000,1500000000
55930917835,1650670680,317318,57430917835,317318,76671005887,1500000000,1500000000
45199668952,1649068997,60862,46269668952,56062,56608455595,1070000000,1070000000
94601379390,1642320495,336289,95847255390,336289,100942057652,1245876000,1245876000
40153875658,1646285127,59994,41653875658,55194,50958226097,1500000000,1500000000
44507762739,1646328524,60862,46007762739,60862,54412106178,1500000000,1500000000
48398316766,1647609125,60850,49898316766,60850,66614994267,1500000000,1500000000
54060125450,1650586606,67646,55560125450,62846,70521696609,1500000000,1500000000
60193173674,1645223268,55600,61693173674,50800,92134291229,1500000000,1500000000
59699599014,1649214795,67634,61199599014,67634,76581832375,1500000000,1500000000
39333300123,1650613924,67646,40833300123,62846,57423538644,1500000000,1500000000
20108119623,1650634910,307734,21608119623,307734,22000000000,1500000000,1500000000
52863532804,1649103506,64717,54363532804,64717,82203875970,1500000000,1500000000
51550049377,1649030813,54921,53050049377,50121,200000000000,1500000000,1500000000
92787855668,1650639986,67622,94287855668,67622,153529717753,1500000000,1500000000
49275277322,1650601666,48615,50775277322,43815,68191795169,1500000000,1500000000
48936465649,1650666299,330503,50436465649,330503,66038323048,1500000000,1500000000
54376144064,1649112729,54861,56876144064,54861,123592744580,2500000000,2500000000
60711947587,1645827982,60838,61364965167,60838,61364965167,1530000000,653017580
43088820351,1645806326,64741,44618820351,59941,55412847663,1530000000,1530000000
41701765284,1649237239,55693,43201765284,50893,57361859777,1500000000,1500000000
35097616584,1650604951,54700,36597616584,54700,49523833029,1500000000,1500000000
85282870061,1649098057,67634,87282870061,67634,142505006180,2000000000,2000000000
80702583245,1649108902,67710,82202583245,67710,87592912512,1500000000,1500000000
40968291612,1649037551,59970,42378291612,55170,45864983607,1410000000,1410000000
52226200489,1646315862,55705,53726200489,50905,58716914370,1500000000,1500000000
44098689799,1649037756,60862,45598689799,56062,61697723439,1500000000,1500000000
81743993834,1643290122,60850,83243993834,56050,95131187128,1500000000,1500000000
33201513066,1646297228,67634,34701513066,62834,42212598843,1500000000,1500000000
54672862178,1647563979,67634,56172862178,62834,72722475567,1500000000,1500000000
47887163898,1647632156,48603,49387163898,43803,62309528987,1500000000,1500000000
45425357644,1649247557,63188,46925357644,63188,85398541640,1500000000,1500000000
52292857391,1650595728,67646,53792857391,62846,65926922188,1500000000,1500000000
71029439401,1649112455,67622,72529439401,67622,95581348512,1500000000,1500000000
80280464063,1642336761,59994,81780464063,55194,106739754165,1500000000,1500000000
103387305538,1642299191,54896,104887305538,50096,135168796994,1500000000,1500000000
39500581722,1645773410,343213,41010581722,343213,49873762064,1510000000,1510000000
43061318149,1649243417,336907,44561318149,336907,58763076709,1500000000,1500000000
55474855035,1644979645,60862,56974855035,56062,72060553040,1500000000,1500000000
89174362922,1650648079,60850,90184407467,56050,90184407467,1500000000,1010044545
48971893588,1649052386,67646,50471893588,62846,67002529144,1500000000,1500000000
36956123192,1649055688,67658,38456123192,62858,47301754477,1500000000,1500000000
65696250435,1649091396,67646,67196250435,62846,86486417554,1500000000,1500000000
25734432286,1647582079,325653,26920644234,325653,26920644234,1500000000,1186211948
55749140060,1645228773,323644,57249140060,323644,69505088352,1500000000,1500000000
38030584810,1650629359,60850,39530584810,56050,47223590095,1500000000,1500000000
32871735020,1650616934,325637,34775395446,325637,,,
71285632543,1649102688,67622,73285632543,62822,105632364891,2000000000,2000000000
37210144683,1646348733,324106,38710144683,324106,41000000000,1500000000,1500000000
57646040641,1645162941,54700,59146040641,49900,65558551614,1500000000,1500000000
82656887503,1649253102,329255,84156887503,329255,99633078310,1500000000,1500000000
38561795468,1646308100,67634,40061795468,67634,56702655209,1500000000,1500000000
77330878734,1650659921,67646,78728822247,62846,78728822247,1500000000,1397943513
26310965878,1650627422,55668,27810965878,50868,31663994303,1500000000,1500000000
67090804227,1643289827,64741,68590804227,59941,88731165899,1500000000,1500000000
94299737007,1645830039,63200,96799737007,63200,196278186452,2500000000,2500000000
101918109709,1645187852,59994,102153453170,59994,102153453170,1410000000,235343461
39114444459,1650668513,67646,40614444459,62846,54387668174,1500000000,1500000000
64670555780,1649082699,60850,66170555780,56050,88898281785,1500000000,1500000000
54786134377,1647577476,67634,56286134377,67634,71027769568,1500000000,1500000000
80235346786,1647574704,67646,81735346786,62846,113881865683,1500000000,1500000000
59580993875,1649238609,60838,61080993875,56038,76671453830,1500000000,1500000000
26231269156,1650620530,60838,27731269156,60838,36918500155,1500000000,1500000000
49729951065,1649045367,67646,51229951065,67646,62834342850,1500000000,1500000000
49729951065,1649045367,67634,51229951065,67634,69853741222,1500000000,1500000000
46387199846,1650641707,67646,47887199846,62846,53850139832,1500000000,1500000000
63209771910,1649115735,66838,64709771910,62038,88057441413,1500000000,1500000000
81693034259,1645179886,343845,83193034259,343845,109630571670,1500000000,1500000000
106624247629,1649212647,320457,108124247629,320457,136493101062,1500000000,1500000000
38248620398,1649243683,52916,39748620398,52916,53530220892,1500000000,1500000000
103225418493,1645027525,55632,104725418493,55632,123130222529,1500000000,1500000000
62467600611,1650633858,67646,63967600611,62846,82995263839,1500000000,1500000000
62467600611,1650633858,67646,63967600611,62846,82995263839,1500000000,1500000000
38361224675,1649043205,336909,39861224675,336909,49706830919,1500000000,1500000000
40812074434,1646310752,55681,42312074434,55681,54892194637,1500000000,1500000000
55218028962,1646335384,55592,57218028962,50792,89807472396,2000000000,2000000000
48894369557,1645806581,343819,50454369557,343819,55000000000,1560000000,1560000000
117721525178,1645194346,337466,119221525178,337466,137660432678,1500000000,1500000000
53436719078,1649209519,317188,54846719078,317188,59777046582,1410000000,1410000000
43525313001,1645004158,56516,45525313001,51716,64066747439,2000000000,2000000000
41138984564,1647612106,60850,42788984564,60850,50956834064,1650000000,1650000000
77404931345,1645187180,54748,78904931345,49948,89861693755,1500000000,1500000000
59058464727,1650593028,66874,60558464727,62074,62462102548,1500000000,1500000000
42266338287,1650613414,67646,43766338287,62846,45504636594,1500000000,1500000000
90771202078,1643290652,60862,92271202078,56062,103267825844,1500000000,1500000000
33865131866,1646348749,317290,35365131866,317290,48732611952,1500000000,1500000000
36468253986,1647633080,67646,37968253986,62846,45743855970,1500000000,1500000000
65981447065,1650641231,67646,67481447065,62846,70933636804,1500000000,1500000000
65981447065,1650641231,67610,67481447065,62810,70933636804,1500000000,1500000000
43061025114,1650620234,67634,44561025114,62834,54898178182,1500000000,1500000000
39779721043,1650591032,316813,40979721043,316813,49000000000,1200000000,1200000000
83857109398,1642338336,67646,94427445493,62846,,,
42246063418,1646339188,64056,42395665968,54456,42395665968,42395665968,149602550
42246063418,1646339188,55592,86465265987,50792,111000000000,44219202569,44219202569
47273205289,1650603792,60874,48773205289,56074,63458875698,1500000000,1500000000
56885134090,1650633779,55592,61000000000,50792,,,
177189130498,1642367935,60862,178689130498,56062,218203408988,1500000000,1500000000
72491818981,1646272656,67646,73991818981,62846,81949530372,1500000000,1500000000
22911224726,1645788969,55648,25411224726,55648,53313239192,2500000000,2500000000
80183112112,1645808129,320398,81683112112,320398,89626510282,1500000000,1500000000
51467245419,1649251072,60862,52967245419,56062,66903578625,1500000000,1500000000
35920013388,1649249446,55580,37420013388,55580,43000000000,1500000000,1500000000
64127595373,1649256985,301432,65627595373,301432,71889445020,1500000000,1500000000
37535426137,1649231489,323060,38535426137,323060,39948487817,1000000000,1000000000
55474388829,1645025026,312858,56974388829,312858,64192139215,1500000000,1500000000
48311243974,1650593938,55580,49811243974,50780,65149195015,1500000000,1500000000
41358215957,1650616845,55705,42858215957,50905,56948522942,1500000000,1500000000
34726778899,1650655618,67634,36226778899,62834,49419583499,1500000000,1500000000
186933450025,1642362838,55632,188433450025,50832,196363141960,1500000000,1500000000
37031925881,1649227024,67634,40131925881,67634,66000000000,3100000000,3100000000
48228827694,1645007463,60066,49728827694,55266,58025716012,1500000000,1500000000
49497174917,1650654942,101469,52000000000,62846,,,
54214872244,1650660713,67622,55714872244,67622,61738885130,1500000000,1500000000
26034091555,1650623945,67646,27534091555,62846,34091807810,1500000000,1500000000
82356383308,1649107475,55768,83856383308,50968,106083529064,1500000000,1500000000
82356383308,1649107475,63200,83856383308,63200,133734942724,1500000000,1500000000
61946741014,1649112896,56634,79000000000,56576,,,
53306084676,1646349743,60838,54806084676,56038,60862510654,1500000000,1500000000
77907634917,1646321051,55592,79907634917,50792,83807042403,2000000000,2000000000
47680417185,1645008185,335148,49180417185,335148,67379733237,1500000000,1500000000
90752629171,1645172137,55668,92252629171,50868,99838868253,1500000000,1500000000
43669809224,1650655416,67634,45169809224,67634,48375513129,1500000000,1500000000
36238734727,1649062440,331153,37738734727,331153,37821232710,1500000000,1500000000
35198602397,1646302125,60862,36698602397,56062,39804737134,1500000000,1500000000
49191192732,1649285633,315556,50691192732,315556,57285288355,1500000000,1500000000
40663562932,1649249432,326275,42163562932,326275,57261565844,1500000000,1500000000
63617695918,1650650795,67646,65617695918,67646,86000000000,2000000000,2000000000
33415121678,1649031649,333720,34915121678,333720,50177752009,1500000000,1500000000
50574850432,1646317707,317342,52074850432,317342,64916655200,1500000000,1500000000
66306720401,1649101490,67634,67806720401,67634,69228107093,1500000000,1500000000
84901085950,1649086501,67634,86401085950,62834,133814715225,1500000000,1500000000
61596698154,1649097773,60850,63596698154,56050,100169170466,2000000000,2000000000
45402783493,1649043057,67646,46902783493,67646,57747801685,1500000000,1500000000
92460582063,1642334964,55781,93960582063,55781,132212421738,1500000000,1500000000
41295898363,1646279098,52916,42795898363,52916,43778728452,1500000000,1500000000
42753789753,1649229653,54700,44253789753,49900,58764009405,1500000000,1500000000
60849362096,1650596754,67646,62349362096,62846,67127310565,1500000000,1500000000
33485090482,1650601775,60850,34985090482,56050,39147757614,1500000000,1500000000
48611911346,1650649935,55604,50111911346,50804,78460481084,1500000000,1500000000
49593740380,1649077798,60838,51093740380,56038,53374863425,1500000000,1500000000
108602006880,1642375253,334284,110102006880,334284,151198733254,1500000000,1500000000
30070098926,1646306697,67634,31570098926,62834,32222343655,1500000000,1500000000
55583963984,1649211311,323632,57083963984,323632,63269522980,1500000000,1500000000
55724630455,1650654442,67634,57224630455,67634,83854847477,1500000000,1500000000
70471494775,1650663882,67646,71971494775,67646,93538765995,1500000000,1500000000
42962672346,1650629421,67646,44962672346,62846,45949959144,2000000000,2000000000
46748449986,1650653428,55604,48248449986,50804,70807726409,1500000000,1500000000
40697963171,1649043145,67634,42197963171,67634,48532294799,1500000000,1500000000
118053343418,1643298897,312324,118264784162,312324,118264784162,1500000000,211440744
36878439033,1646290302,67622,38378439033,67622,55033382370,1500000000,1500000000
55668513344,1645797831,350153,57178513344,350153,70168376127,1510000000,1510000000
45356707591,1649228000,60862,46856707591,56062,50886297534,1500000000,1500000000
52739036594,1650647791,60862,54239036594,56062,85034689653,1500000000,1500000000
31603282739,1650630000,55672,33103282739,50872,46455196369,1500000000,1500000000
65031270188,1645186300,60950,66531270188,56150,100850354570,1500000000,1500000000
77277096999,1645040681,346394,78777096999,346394,96096758768,1500000000,1500000000
102434495227,1642333269,67634,103934495227,67634,145113045225,1500000000,1500000000
26433909215,1646309605,60850,27933909215,60850,44280598888,1500000000,1500000000
79872836952,1650647978,67646,81372836952,62846,84743455415,1500000000,1500000000
34347246161,1650626720,60862,35847246161,56062,40106809504,1500000000,1500000000
59168761726,1649104316,67646,62168761726,62846,69462930715,3000000000,3000000000
141170879541,1642365268,335574,142670879541,335574,183292300668,1500000000,1500000000
137556708670,1642315149,67634,139056708670,67634,176643295329,1500000000,1500000000
52188021947,1645760647,67646,53688021947,62846,56791915915,1500000000,1500000000
52264122298,1649211889,55680,53764122298,55680,73836347703,1500000000,1500000000
113456708899,1644976354,67634,114956708899,62834,126074202488,1500000000,1500000000
33261788702,1650598935,55684,34761788702,50884,50208760903,1500000000,1500000000
34541891282,1649037840,49519,36190891282,44719,40350363683,1649000000,1649000000
94169235899,1642316470,55705,95579235899,50905,97596994101,1410000000,1410000000
52375362269,1646318264,60862,53875362269,56062,86768028550,1500000000,1500000000
52375362269,1646318264,60862,56966953514,56062,,,
37706358153,1647598906,67646,39206358153,62846,45787807505,1500000000,1500000000
56492241292,1645146037,67622,57992241292,67622,66991210509,1500000000,1500000000
44187003301,1649284590,310927,45114254815,310927,45114254815,1500000000,927251514
56880120630,1650670623,55592,58252047530,50792,58252047530,1500000000,1371926900
33477910572,1650628754,55592,34977910572,50792,47525689044,1500000000,1500000000
42127976987,1649034264,54921,43627976987,50121,100000000000,1500000000,1500000000
85730956912,1642338773,326111,87230956912,326111,107655096655,1500000000,1500000000
166835954171,1642363825,60006,168335954171,55206,237885015967,1500000000,1500000000
166835954171,1642363825,67634,168335954171,67634,173173742835,1500000000,1500000000
79885593200,1642320454,60862,86545969654,60862,,,
44486792960,1645758119,335108,45786792960,335108,47250496148,1300000000,1300000000
40718332224,1649225350,55720,42218332224,50920,100000000000,1500000000,1500000000
27571364483,1650617343,55592,29071364483,50792,41495736420,1500000000,1500000000
85021326581,1642333463,336841,86431326581,336841,91311280179,1410000000,1410000000
38094742871,1646337855,67634,38533725997,62834,38533725997,38533725997,438983126
26265842706,1647581721,336887,27765842706,336887,36027714658,1500000000,1500000000
80575227153,1647574550,321704,82075227153,321704,85000000000,1500000000,1500000000
31381589696,1645754309,336881,32881589696,336881,48991457128,1500000000,1500000000
23813063806,1647580429,324786,25245026038,324786,25245026038,1500000000,1431962232
23813063806,1647580429,314152,25313063806,314152,37096218415,1500000000,1500000000
83879846011,1645182167,326099,85379846011,326099,113502529693,1500000000,1500000000
77041987405,1645226006,320567,78541987405,320567,117550378595,1500000000,1500000000
56794326425,1650662041,55592,58294326425,50792,65853729480,1500000000,1500000000
56794326425,1650662041,55592,58294326425,50792,65853729480,1500000000,1500000000
95158456020,1649094920,303852,97158456020,303852,130432897614,2000000000,2000000000
66379765231,1649111477,67622,67879765231,67622,92644962689,1500000000,1500000000
79315273684,1649108463,67622,80815273684,67622,102271147680,1500000000,1500000000
79315273684,1649108463,67634,80815273684,62834,102271147680,1500000000,1500000000
112194184523,1642294510,60862,113694184523,56062,131456111425,1500000000,1500000000
71216921412,1645215165,337703,73216921412,337703,96917378650,2000000000,2000000000
40860213696,1650668824,67634,42360213696,67634,49968449675,1500000000,1500000000
46842340223,1650613552,101469,53000000000,62846,,,
38962116324,1646339170,67646,85273241813,62846,111000000000,46311125489,46311125489
37690803360,1645794880,55720,39690803360,50920,300000000000,2000000000,2000000000
40020481736,1649227712,60850,41520481736,56050,52324894638,1500000000,1500000000
48977758416,1649277607,320406,49881198449,320406,49881198449,1500000000,903440033
42504065507,1649237419,52916,43168473968,52916,43168473968,1500000000,664408461
36731492614,1650624361,67646,38231492614,62846,42314906157,1500000000,1500000000
68042050067,1643262306,328837,69542050067,328837,70000000000,1500000000,1500000000
101911719848,1643268109,346376,103411719848,346376,123474813704,1500000000,1500000000
157829852806,1642361907,337522,159307827224,337522,159307827224,1500000000,1477974418
65044505586,1645153331,55681,66544505586,55681,92692782253,1500000000,1500000000
86723926975,1645189410,60838,88223926975,60838,119471281867,1500000000,1500000000
57885194266,1649204128,331177,59385194266,331177,62000000000,1500000000,1500000000
83171510663,1650641300,67634,84671510663,67634,87926847967,1500000000,1500000000
100000314757,1649098412,67622,137000000000,62822,,,
39907157774,1649036549,55717,42907157774,50917,59463050912,3000000000,3000000000
89331238361,1642329618,55705,90831238361,50905,124397542215,1500000000,1500000000
48691296388,1650590860,55693,50191296388,50893,63136676597,1500000000,1500000000
41559684619,1650617097,510082,43000000000,340055,,,
72955445154,1649093191,331117,74455445154,331117,88153910808,1500000000,1500000000
72955445154,1649093191,325661,74455445154,325661,88153910808,1500000000,1500000000
46844100175,1649039304,64741,48344100175,59941,67474419377,1500000000,1500000000
48164454666,1649101316,60926,79000000000,60926,,,
41918936448,1649048573,49583,43418936448,44783,44729248905,1500000000,1500000000
98355047816,1642324495,60862,99855047816,56062,102748812557,1500000000,1500000000
63769637299,1646332277,60862,65269637299,60862,70954674597,1500000000,1500000000
58365741702,1649265966,48591,59313404265,43791,,,
33895226877,1650658244,60850,35395226877,56050,41988971180,1500000000,1500000000
50681306052,1649256055,55592,52181306052,50792,64037173690,1500000000,1500000000
124866677352,1649204587,67646,126366677352,62846,155517394445,1500000000,1500000000
106772195860,1645029483,334346,108272195860,334346,138922101165,1500000000,1500000000
59305176924,1650664287,67634,60805176924,62834,88974965362,1500000000,1500000000
49342897975,1650597137,60862,50842897975,56062,62850029312,1500000000,1500000000
47679790760,1650600973,316781,49179790760,316781,49193729960,1500000000,1500000000
61354097684,1650640567,67646,62854097684,62846,93617248705,1500000000,1500000000
39963729723,1649053803,331185,41463729723,331185,54696864498,1500000000,1500000000
62451334749,1646326186,55592,63951334749,50792,91741697377,1500000000,1500000000
28313041248,1645784098,67634,29823041248,67634,35186535493,1510000000,1510000000
67732705334,1645025784,55717,69024503335,50917,82052462296,1291798001,1291798001
54409760391,1650586670,60850,56409760391,56050,80086365198,2000000000,2000000000
70159405666,1649109304,64717,71659405666,64717,81408702129,1500000000,1500000000
69711957977,1649102330,340011,71211957977,340011,133374855354,1500000000,1500000000
81075302232,1642305865,336861,82575302232,336861,103330029280,1500000000,1500000000
81230493428,1642316761,67622,87272784640,67622,,,
33439988254,1646349039,313022,34939988254,313022,35000000000,1500000000,1500000000
36425507840,1646288121,60838,37925507840,60838,54128179843,1500000000,1500000000
28136888036,1645776084,335629,29636888036,335629,34028935118,1500000000,1500000000
36087087826,1645792252,346374,37587087826,346374,52486306308,1500000000,1500000000
60762616246,1650665472,55580,62262616246,50780,72441702545,1500000000,1500000000
51849368797,1649105659,54921,53349368797,50121,200000000000,1500000000,1500000000
34505884224,1646312579,316640,35801378762,316640,35801378762,1583793174,1295494538
68205581518,1645145626,340015,69705581518,340015,94675044010,1500000000,1500000000
36759526591,1649225294,328264,38259526591,328264,100000000000,1500000000,1500000000
32930664631,1650619644,67622,34430664631,62822,36433048265,1500000000,1500000000
68154975078,1649100980,67634,69654975078,67634,96454772250,1500000000,1500000000
43244046186,1649067758,60862,44744046186,56062,58033299064,1500000000,1500000000
117254147932,1643283783,326737,118754147932,326737,120486672530,1500000000,1500000000
39508820633,1646290062,310309,41008820633,310309,43489073520,1500000000,1500000000
48129823966,1647576567,67646,49629823966,62846,68000000000,1500000000,1500000000
61049480354,1649092654,333736,62549480354,333736,64906020114,1500000000,1500000000
44513294637,1645800534,340685,46013294637,340685,58316975443,1500000000,1500000000
49136489107,1650613756,60850,50636489107,56050,60896328530,1500000000,1500000000
27151946721,1650621450,67622,28651946721,67622,46908544325,1500000000,1500000000
87298471807,1649096682,67622,88798471807,62822,120434287218,1500000000,1500000000
50814312481,1646283709,48603,52314312481,48603,72630612318,1500000000,1500000000
41698147864,1649257561,60950,46698147864,56150,79000000000,5000000000,5000000000
39856384928,1650593697,67634,41356384928,62834,52359357547,1500000000,1500000000
39856384928,1650593697,67646,41356384928,62846,52359357547,1500000000,1500000000
40808308563,1650600830,67722,42308308563,67722,54606595473,1500000000,1500000000
50277440942,1649048087,67622,51777440942,67622,65178380520,1500000000,1500000000
142463759851,1642360431,59958,143963759851,55158,192839720653,1500000000,1500000000
113246094046,1642365947,54334,114746094046,49534,120000000000,1500000000,1500000000
30826106598,1650624504,60850,32326106598,56050,49074838610,1500000000,1500000000
59072240866,1650594755,60838,60572240866,56038,61438114468,1500000000,1500000000
67883158411,1649116332,67634,69383158411,62834,88306164040,1500000000,1500000000
97589074312,1642346080,326778,99089074312,326778,123936821630,1500000000,1500000000
37335850901,1646297114,60850,38835850901,56050,52168091149,1500000000,1500000000
69558430179,1645767552,329380,71558430179,329380,97846281446,2000000000,2000000000
104615892680,1649268711,67634,106115892680,62834,137188825234,1500000000,1500000000
29907108874,1650670997,328841,31417108874,328841,32000000000,1510000000,1510000000
59534633827,1650647848,60850,61034633827,56050,67717926630,1500000000,1500000000
33639130318,1650621261,60862,35139130318,56062,50402614860,1500000000,1500000000
98284226982,1642347015,67646,120000000000,62846,,,
37621996780,1646270701,319325,39121996780,319325,67639953529,1500000000,1500000000
49104453058,1647605924,334338,50604453058,334338,71511728904,1500000000,1500000000
63784420598,1649257142,60950,65284420598,56150,69000000000,1500000000,1500000000
123427258585,1650639898,67634,125427258585,67634,129484720634,2000000000,2000000000
96479804415,1649094879,310850,98479804415,310850,110056477940,2000000000,2000000000
72726457720,1649091288,67622,74726457720,67622,106373892778,2000000000,2000000000
95206321146,1649094947,52928,96706321146,48128,120448070025,1500000000,1500000000
28216427527,1646286806,67634,29716427527,67634,42967296717,1500000000,1500000000
29809934094,1647601541,67634,31309934094,62834,41566226004,1500000000,1500000000
47560402958,1650658344,55592,49060402958,50792,53124247572,1500000000,1500000000
36923863208,1650600600,67622,38423863208,67622,50065939087,1500000000,1500000000
58607359424,1650660735,67646,60107359424,62846,69268590305,1500000000,1500000000
29696020820,1649031728,64741,31000000000,59941,31000000000,1500000000,1303979180
277508846606,1642353263,56504,279008846606,51704,295586837738,1500000000,1500000000
35951885368,1646308993,67634,37451885368,67634,37835373425,1500000000,1500000000
43486724106,1645802839,346955,44996724106,346955,51595090095,1510000000,1510000000
89341239330,1645211903,330403,90841239330,330403,112379193689,1500000000,1500000000
94390882539,1650651964,67622,95890882539,67622,96784162674,1500000000,1500000000
47334848048,1650595958,67622,48834848048,67622,60281857927,1500000000,1500000000
249654231521,1642356648,60850,251154231521,56050,315796039003,1500000000,1500000000
83525313203,1642338110,67634,85025313203,62834,100463439393,1500000000,1500000000
46305312938,1646348546,60862,47805312938,56062,53628762903,1500000000,1500000000
48992497528,1646339958,60850,50717155777,56050,50717155777,50717155777,1724658249
39623423516,1645003989,52940,41123423516,48140,60605119647,1500000000,1500000000
33238639948,1650631719,67634,34738639948,62834,48278037195,1500000000,1500000000
38097190079,1649031507,330541,39597190079,330541,40947193347,1500000000,1500000000
79546096925,1647577324,60850,81046096925,60850,110775691792,1500000000,1500000000
74351945580,1649082635,67634,75851945580,67634,99561849009,1500000000,1500000000
113891343664,1649098147,66778,115391343664,66778,131458789443,1500000000,1500000000
140477204625,1649098385,317236,142477204625,317236,178792237355,2000000000,2000000000
83334036903,1642338395,54759,84834036903,49959,103221773825,1500000000,1500000000
33822982761,1646279045,55592,35322982761,50792,57308211899,1500000000,1500000000
43059395919,1649228404,336849,44559395919,336849,64878860313,1500000000,1500000000
58171046076,1645040793,56729,59543446076,47129,60609442358,1372400000,1372400000
73152902282,1650641397,67646,74652902282,67646,76981391842,1500000000,1500000000
75185127687,1650652065,101451,77000000000,62834,,,
73936012949,1650641271,67634,75436012949,62834,87926847967,1500000000,1500000000
54913620564,1649032970,55705,56413620564,50905,60842913299,1500000000,1500000000
241566089510,1643304549,60030,243066089510,55230,325548118937,1500000000,1500000000
202334929972,1642354917,55693,203834929972,50893,236008299987,1500000000,1500000000
55526286656,1649254510,54736,57026286656,49936,57651506394,1500000000,1500000000
59622814070,1649258560,60938,61122814070,60938,61138881982,1500000000,1500000000
44341229480,1650594195,67634,45841229480,62834,74123130067,1500000000,1500000000
31085104089,1650615443,67646,32585104089,62846,39731047610,1500000000,1500000000
31085104089,1650615443,60850,32585104089,60850,44390524824,1500000000,1500000000
67464292522,1650666545,63200,68964292522,63200,124184995276,1500000000,1500000000
99641420717,1649100490,322472,101141420717,322472,104838664279,1500000000,1500000000
44162124167,1646308087,67634,45662124167,62834,58580710727,1500000000,1500000000
39167819636,1645768311,334316,40677819636,334316,41892310167,1510000000,1510000000
61410325042,1647567386,334330,62910325042,334330,78882079544,1500000000,1500000000
68122197349,1645160284,343153,69622197349,343153,72310479130,1500000000,1500000000
52526506690,1649282473,67646,54526506690,62846,78411990977,2000000000,2000000000
36036559202,1644984551,54676,37536559202,49876,58408386863,1500000000,1500000000
72682682490,1649111470,67646,74182682490,62846,103919413575,1500000000,1500000000
80266726706,1649111421,67622,81766726706,67622,88695795640,1500000000,1500000000
82741116089,1643266463,67646,96740254605,62846,,,
35421700816,1646305948,67634,36921700816,67634,44258737879,1500000000,1500000000
55984968972,1647614233,60862,57484968972,56062,67013248808,1500000000,1500000000
58406140522,1649216472,67646,59906140522,62846,87847886009,1500000000,1500000000
40903756956,1650657957,67634,42403756956,62834,43432807974,1500000000,1500000000
36621718386,1649043558,67634,38621718386,67634,48952312474,2000000000,2000000000
96044279738,1642310813,48615,97544279738,43815,120193146130,1500000000,1500000000
58369819608,1645142919,318692,60369819608,318692,78505354665,2000000000,2000000000
77816008843,1649215275,67634,79316008843,67634,88369368682,1500000000,1500000000
53003966827,1650587091,67622,54503966827,67622,57674372483,1500000000,1500000000
21999258497,1650634849,313324,23499258497,313324,25000000000,1500000000,1500000000
32921578920,1650628005,328008,34421578920,328008,35594451349,1500000000,1500000000
83189094609,1649088391,60850,84689094609,60850,104189433909,1500000000,1500000000
60206929906,1646317448,67634,61706929906,62834,99748566339,1500000000,1500000000
46751810390,1649238690,49495,48251810390,44695,67537118214,1500000000,1500000000
75812084035,1649116109,67622,77312084035,67622,108793628224,1500000000,1500000000
101194522032,1642326686,67646,102694522032,62846,124602768694,1500000000,1500000000
59614284869,1645157397,66790,61114284869,61990,66972048330,1500000000,1500000000
69445971554,1649257106,60938,70945971554,56138,92596636834,1500000000,1500000000
76720725200,1649254035,60950,78220725200,56150,109041585628,1500000000,1500000000
71530223008,1645031208,55705,73030223008,50905,73092128208,1500000000,1500000000
68183612207,1649082964,60862,69683612207,56062,86253959905,1500000000,1500000000
45629146677,1646321515,60850,47129146677,56050,61629576858,1500000000,1500000000
37969996023,1646300862,60862,39469996023,56062,40000000000,1500000000,1500000000
34862965811,1649235652,64741,42000000000,59941,,,
30708698568,1649250525,55592,32208698568,50792,42462279799,1500000000,1500000000
34101963046,1650613062,323618,35187748504,323618,35187748504,1500000000,1085785458
52308395077,1650641704,60862,54308395077,56062,92139571064,2000000000,2000000000
46726637590,1650588710,55592,48226637590,50792,52549252105,1500000000,1500000000
59136449550,1649076130,67634,60513174230,67634,60513174230,1500000000,1376724680
100954591546,1642374364,60862,102954591546,56062,162368915146,2000000000,2000000000
55289660019,1647642656,67646,56789660019,67646,66036501850,1500000000,1500000000
32016849965,1647584290,60006,33516849965,55206,40664366532,1500000000,1500000000
60060088134,1649254609,60018,61560088134,55218,76856519419,1500000000,1500000000
31012837069,1650623548,60862,32512837069,56062,39071697542,1500000000,1500000000
45417321794,1650597880,327371,46917321794,327371,47715017825,1500000000,1500000000
59217647812,1649052597,67646,60717647812,62846,75066252347,1500000000,1500000000
54302242276,1645798059,60850,55812242276,56050,78233544244,1510000000,1510000000
243503616432,1644970582,67634,245003616432,67634,300870664130,1500000000,1500000000
70543644548,1649101547,49483,72043644548,49483,88477208552,1500000000,1500000000
52493501225,1647597624,319938,53993501225,319938,67519089179,1500000000,1500000000
95080769660,1649208211,56492,96580769660,56492,123742849242,1500000000,1500000000
66293905855,1650596720,67646,68011373906,62846,80217609484,1717468051,1717468051
129098770977,1643298678,60850,130598770977,60850,131165839577,1500000000,1500000000
194671939701,1642367671,60030,196171939701,55230,214076668522,1500000000,1500000000
95317353382,1646318983,67634,96817353382,67634,124173389585,1500000000,1500000000
95317353382,1646318983,55580,96817353382,55580,124173389585,1500000000,1500000000
42059662549,1646293232,327385,43559662549,327385,54438392507,1500000000,1500000000
45827487362,1645759533,52940,47327487362,48140,55731951624,1500000000,1500000000
58843493431,1647637860,63188,60343493431,63188,114125395488,1500000000,1500000000
57253685022,1649277948,60950,58753685022,56150,65588220984,1500000000,1500000000
54510218171,1649220340,55717,56010218171,50917,86049863715,1500000000,1500000000
68693037242,1649111712,67622,70343037242,67622,102220198393,1650000000,1650000000
45166791205,1649060406,64741,47166791205,59941,69797912900,2000000000,2000000000
77763903015,1642343164,67622,79763903015,67622,114345862017,2000000000,2000000000
77856563089,1642331284,60850,78856563089,60850,80000000000,1000000000,1000000000
26802440195,1647604958,327419,28302440195,327419,33334985904,1500000000,1500000000
43503325842,1649285928,67646,45003325842,62846,48972394772,1500000000,1500000000
41368741216,1649242377,55071,42868741216,55071,49409285584,1500000000,1500000000
26657567479,1650621475,327992,28157567479,327992,42192750653,1500000000,1500000000
69012255213,1649108245,54308,70512255213,54308,82746195233,1500000000,1500000000
30990855097,1646309267,67634,32490855097,62834,41202169799,1500000000,1500000000
35154676849,1647595322,337502,36654676849,337502,38614949527,1500000000,1500000000
92465015149,1645033459,56717,93965015149,51917,110836196677,1500000000,1500000000
78888808703,1650640305,59934,80388808703,55134,100151948292,1500000000,1500000000
79481782901,1649103073,55592,80981782901,50792,100639215533,1500000000,1500000000
79481782901,1649103073,54921,80981782901,50121,100639215533,1500000000,1500000000
164613896565,1642371608,49445,166113896565,44645,167114855165,1500000000,1500000000
79222229351,1642332547,60838,80722229351,60838,119806445495,1500000000,1500000000
36763299164,1650615760,67646,38263299164,62846,49709625710,1500000000,1500000000
79994789145,1649108950,53871,81494789145,49071,114984763418,1500000000,1500000000
140517349798,1642345384,334362,142017349798,334362,160183732614,1500000000,1500000000
61771483805,1646322056,60862,63271483805,56062,71236674473,1500000000,1500000000
73485628452,1649222682,67646,75485628452,62846,83168243039,2000000000,2000000000
49595604145,1649267650,54921,52095604145,50121,200000000000,2500000000,2500000000
72981941798,1650642552,60850,74481941798,56050,88679765777,1500000000,1500000000
26791323967,1650612051,67634,28291323967,67634,47666312822,1500000000,1500000000
76075457331,1649103755,56492,77725457331,51692,82431084479,1650000000,1650000000
60509796791,1649038827,67634,62009796791,62834,63286227870,1500000000,1500000000
80447626073,1645829282,66778,81947626073,61978,106388001070,1500000000,1500000000
68443023607,1645186889,329380,84000000000,329380,,,
60363599646,1645159367,54700,61863599646,49900,66595600918,1500000000,1500000000
61461817050,1650645518,325068,62961817050,325068,65784731572,1500000000,1500000000
63369072060,1650646471,67634,64869072060,62834,90830852395,1500000000,1500000000
94899517734,1642344905,60862,96399517734,56062,113261207282,1500000000,1500000000
49912308044,1645827398,67634,51412308044,62834,67352247604,1500000000,1500000000
30860842012,1650619452,67634,32360842012,67634,44921965897,1500000000,1500000000
35905431582,1649031825,60838,37405431582,56038,46433200404,1500000000,1500000000
68230703818,1646326293,60850,69730703818,56050,89851257113,1500000000,1500000000
52559431274,1646320458,60850,54559431274,56050,68851964732,2000000000,2000000000
59953872886,1645831442,67634,61463872886,62834,77456196054,1510000000,1510000000
56959990242,1649275706,63200,58459990242,63200,103391058512,1500000000,1500000000
28673315831,1650606441,312115,30173315831,312115,38995599059,1500000000,1500000000
28673315831,1650606441,67622,30173315831,62822,50516499867,1500000000,1500000000
34493128683,1650601862,325215,35993128683,325215,51522945137,1500000000,1500000000
36086831123,1650626444,55592,39086831123,50792,49735831127,3000000000,3000000000
51347864367,1649103671,67622,52847864367,67622,65348134030,1500000000,1500000000
58312631482,1645755979,66778,59812631482,61978,84624110042,1500000000,1500000000
33470853843,1650609272,67634,34970853843,62834,41524049940,1500000000,1500000000
67425971854,1649099444,63200,68925971854,63200,145206618678,1500000000,1500000000
71244574150,1649103004,67622,72744574150,67622,86039484245,1500000000,1500000000
60691477621,1649111210,66790,62191477621,66790,66285630426,1500000000,1500000000
135465595653,1645192744,67622,136965595653,67622,144459532323,1500000000,1500000000
135465595653,1645192744,60850,136965595653,60850,144459532323,1500000000,1500000000
31912153323,1650601865,338859,33412153323,338859,51522945137,1500000000,1500000000
31912153323,1650601865,326966,33412153323,326966,51522945137,1500000000,1500000000
73680357338,1645159085,332410,150000000000,332410,,,
62681204238,1649272450,120000,64181204238,119052,71761176585,1500000000,1500000000
45042875196,1649225622,326826,46542875196,326826,48239220514,1500000000,1500000000
30709289510,1650617465,325052,32209289510,325052,33441204804,1500000000,1500000000
53988025355,1649111150,67622,55488025355,67622,83082883685,1500000000,1500000000
113899803501,1642302670,67646,115399803501,62846,146428808425,1500000000,1500000000
72351949572,1649268086,63200,73851949572,63200,137951094502,1500000000,1500000000
36083332341,1650620064,67622,37583332341,62822,38939376282,1500000000,1500000000
36083332341,1650620064,67658,37583332341,62858,38137152242,1500000000,1500000000
44311442911,1650602028,321877,45811442911,321877,51526246354,1500000000,1500000000
114264496742,1649085620,60838,115764496742,60838,136968758700,1500000000,1500000000
80621400614,1642332607,335558,82121400614,335558,100600797958,1500000000,1500000000
22529064069,1646304241,312938,23657811052,312938,24744905188,1128746983,1128746983
39133491190,1645167941,60066,40633491190,55266,48627452250,1500000000,1500000000
32892771365,1650602570,67622,34392771365,67622,43158625297,1500000000,1500000000
33761399725,1646348697,321861,35261399725,321861,36000000000,1500000000,1500000000
71845631109,1649208701,60862,73345631109,56062,79791934177,1500000000,1500000000
50791307073,1650670331,55705,52291307073,50905,63536063892,1500000000,1500000000
31511883996,1650605651,54712,33011883996,49912,41760653159,1500000000,1500000000
39400876401,1646299841,330529,40900876401,330529,46374859579,1500000000,1500000000
32340206012,1650618123,101451,34000000000,62834,,,
49983638185,1650587393,60850,51983638185,60850,65249512016,2000000000,2000000000
36445908546,1649056455,60874,37945908546,56074,48906414038,1500000000,1500000000
124748347830,1642349150,60862,126221710310,56062,126221710310,1500000000,1473362480
88661264326,1642323843,67646,90071264326,62846,114689733566,1410000000,1410000000
45159064109,1646324049,60862,46659064109,60862,51700936194,1500000000,1500000000
35748624515,1645767057,339993,36100000000,339993,36100000000,1510000000,351375485
35748624515,1645767057,329915,36000000000,329915,36000000000,1500000000,251375485
190509758643,1645195337,343829,192009758643,343829,213023006535,1500000000,1500000000
190509758643,1645195337,329266,192009758643,329266,213023006535,1500000000,1500000000
43226053869,1649220187,60850,44726053869,60850,53740573140,1500000000,1500000000
27401453616,1650623699,55580,31565403671,50780,,,
56618818932,1650594069,55705,58118818932,50905,69435591842,1500000000,1500000000
98854784452,1649096983,63200,100354784452,63200,177258098350,1500000000,1500000000
64798771022,1649106089,67634,66298771022,62834,66311710997,1500000000,1500000000
66046885489,1649256678,67646,67546885489,62846,76468734340,1500000000,1500000000
39504453178,1649235434,60850,41004453178,56050,57023721749,1500000000,1500000000
91147989754,1650645957,67634,92647989754,67634,110106761760,1500000000,1500000000
66144828903,1650650258,67658,67644828903,62858,82377886897,1500000000,1500000000
25633163818,1646296564,60862,27133163818,56062,36721789573,1500000000,1500000000
25633163818,1646296564,60850,27133163818,60850,32810486433,1500000000,1500000000
40398364910,1650671135,67634,41898364910,62834,49687581272,1500000000,1500000000
43463061521,1650634075,327948,44963061521,327948,46520549962,1500000000,1500000000
36278314552,1650609957,64729,37778314552,59929,45447900234,1500000000,1500000000
103992110678,1650644077,67622,105492110678,67622,155077859748,1500000000,1500000000
49457077661,1646279762,310989,50957077661,310989,55925663032,1500000000,1500000000
29877665906,1646296177,312992,31011868633,312992,31011868633,1500000000,1134202727
39617150120,1649222331,60838,41117150120,60838,55386072740,1500000000,1500000000
51482983584,1650662007,101469,86000000000,62846,,,
77997435267,1642308765,64741,79497435267,59941,80000000000,1500000000,1500000000
26232772742,1646304870,49483,27732772742,49483,39183707659,1500000000,1500000000
80576925973,1645191525,66766,82326925973,61966,90383650280,1750000000,1750000000
52673759527,1649256077,60862,54173759527,56062,60074867899,1500000000,1500000000
62600443637,1650650945,55580,64100443637,55580,83150127582,1500000000,1500000000
71064122825,1650664544,67634,72564122825,67634,79714204858,1500000000,1500000000
97666025848,1649084906,60850,99166025848,56050,117122803862,1500000000,1500000000
57454060802,1649093449,59958,58954060802,59958,79146158540,1500000000,1500000000
86419893859,1642343125,333708,87919893859,333708,108748865953,1500000000,1500000000
42707311672,1646321372,60850,44707311672,60850,57440214463,2000000000,2000000000
48910294798,1650654135,59946,50910294798,59946,73857522308,2000000000,2000000000
61807952945,1646326632,321638,63307952945,321638,82647183420,1500000000,1500000000
56193943625,1650659728,328368,57693943625,321899,77126904673,1500000000,1500000000
36267085921,1650631976,55592,37767085921,50792,49047081632,1500000000,1500000000
47544402995,1650660493,67622,49044402995,67622,64389471352,1500000000,1500000000
49121202650,1650628533,67634,50621202650,62834,57284841254,1500000000,1500000000
25428718018,1646298368,67622,26928718018,67622,32200848843,1500000000,1500000000
48044680240,1647578749,60862,49544680240,56062,61688404659,1500000000,1500000000
49382729081,1649225442,67634,50882729081,67634,55820446950,1500000000,1500000000
43029618977,1649243726,60862,44529618977,56062,53530220892,1500000000,1500000000
45683184933,1650591252,67646,47183184933,67646,62866484500,1500000000,1500000000
71137517826,1650639555,67646,73137517826,62846,90639790226,2000000000,2000000000
58095122549,1650649753,329296,59595122549,329296,66857012867,1500000000,1500000000
74307514984,1649101783,64717,75807514984,64717,78969929433,1500000000,1500000000
45698828962,1647644446,340035,47198828962,340035,52277781195,1500000000,1500000000
39351065780,1650602412,67646,40851065780,62846,50005943013,1500000000,1500000000
61799159738,1645055771,328825,63299159738,328825,70255177168,1500000000,1500000000
68506742467,1646316413,55568,70006742467,55568,84720090580,1500000000,1500000000
54435369471,1645142665,302533,55935369471,302533,82233206218,1500000000,1500000000
70024237337,1650648738,64044,71524237337,59244,84165260292,1500000000,1500000000
164024863909,1642354418,60862,165524863909,56062,221901312023,1500000000,1500000000
48489791207,1645778288,64729,49989791207,59929,59926722177,1500000000,1500000000
46870136541,1649244461,49607,48370136541,44807,50579158485,1500000000,1500000000
58588724436,1645001378,56516,60588724436,51716,80780878981,2000000000,2000000000
36212846941,1650618625,60850,37712846941,56050,38631395308,1500000000,1500000000
87649181523,1646317121,55592,89149181523,50792,108349026913,1500000000,1500000000
26132412940,1646302984,324210,27632412940,324210,28669566597,1500000000,1500000000
59459794308,1649217379,331163,60959794308,331163,75706080068,1500000000,1500000000
44736305512,1645011001,59994,46236305512,59994,52141095179,1500000000,1500000000
59353730170,1650666204,340069,60853730170,340069,73038904700,1500000000,1500000000
50095870452,1650653513,55604,51595870452,50804,52620419304,1500000000,1500000000
40666738934,1650656558,67646,42166738934,67646,49346905415,1500000000,1500000000
36472519548,1650615817,60850,37972519548,60850,52000000000,1500000000,1500000000
33174147256,1650602244,67634,34674147256,62834,48498149940,1500000000,1500000000
151852097869,1642360307,59958,153352097869,55158,167607947027,1500000000,1500000000
149551585711,1645204306,60078,150961585711,55278,188582055166,1410000000,1410000000
45514700330,1649249229,67734,47014700330,62934,58161215933,1500000000,1500000000
41647874682,1645001157,55648,44147874682,55648,89917129022,2500000000,2500000000
29700979104,1650625845,56588,31200979104,51788,32217346243,1500000000,1500000000
60568300169,1650593066,67734,62068300169,67734,75323080909,1500000000,1500000000
116983620608,1650644083,67634,118483620608,67634,162378329209,1500000000,1500000000
91233000755,1649106884,60838,92733000755,60838,111869957968,1500000000,1500000000
26664273411,1647604233,67622,28164273411,67622,33677357848,1500000000,1500000000
90011577542,1650644613,55705,91511577542,50905,111803112998,1500000000,1500000000
35427586294,1650602051,330521,37427586294,330521,61910380367,2000000000,2000000000
88162942014,1650640175,60862,89662942014,56062,94870554840,1500000000,1500000000
88272205624,1642334010,67622,89772205624,67622,129039546455,1500000000,1500000000
50929371325,1646321248,55592,52429371325,50792,67635416742,1500000000,1500000000
31851582941,1646329297,321006,33791582941,321006,37766813122,1940000000,1940000000
42489322530,1645764925,60950,43489322530,56150,62343070688,1000000000,1000000000
31837470334,1650624178,67646,33662816334,62846,44626405702,1825346000,1825346000
40501744995,1649256383,60926,42001744995,60926,59233347008,1500000000,1500000000
48385316656,1645000529,340037,49885316656,340037,66086311317,1500000000,1500000000
40704469264,1645007292,320479,42204469264,320479,52278881817,1500000000,1500000000
46840692724,1649060482,64705,48340692724,64705,59490193259,1500000000,1500000000
102579883859,1642321312,337454,104079883859,337454,129697072927,1500000000,1500000000
102579883859,1642321312,56516,104079883859,51716,129592347235,1500000000,1500000000
43030058792,1646351339,55681,44530058792,55681,61136296198,1500000000,1500000000
51156954183,1645055621,336303,52656954183,336303,72992141608,1500000000,1500000000
30071675579,1647592139,67634,31571675579,67634,39732974045,1500000000,1500000000
84363744197,1649268727,63200,85863744197,63200,188009054640,1500000000,1500000000
88404487968,1650640447,64741,88820102794,59941,88820102794,1500000000,415614826
68184454020,1650639522,67634,69684454020,62834,77550139832,1500000000,1500000000
65353495623,1649082012,55680,66853495623,50880,94482742863,1500000000,1500000000
94976676813,1642336674,67622,96476676813,67622,135678234965,1500000000,1500000000
94032010119,1642345015,332597,95532010119,332597,123978081399,1500000000,1500000000
94032010119,1642345015,329294,95532010119,329294,123978081399,1500000000,1500000000
94032010119,1642345015,334282,95532010119,334282,128427936875,1500000000,1500000000
23861371568,1646301571,60862,25361371568,56062,33263308453,1500000000,1500000000
33931728157,1645748718,337695,35471728157,337695,36000000000,1540000000,1540000000
60339541229,1645805753,326097,61869541229,326097,69288004110,1530000000,1530000000
32003926704,1650608418,67622,33503926704,62822,44937572043,1500000000,1500000000
31563445548,1650608542,305392,33063445548,305392,42537734053,1500000000,1500000000
50620978456,1650591916,314037,52120978456,314037,74996979119,1500000000,1500000000
80066460272,1649263756,60850,81566460272,56050,99300524757,1500000000,1500000000
75096912365,1649264138,298191,76596912365,298191,85802394283,1500000000,1500000000
71977124271,1650642415,60850,73477124271,56050,85568047998,1500000000,1500000000
115305223242,1642350282,54872,117805223242,54872,247345133880,2500000000,2500000000
88909650822,1642338267,55259,90409650822,55259,112890818433,1500000000,1500000000
116053548845,1645192451,54676,117553548845,49876,137836821617,1500000000,1500000000
37160946300,1649248995,60950,38660946300,56150,50096985289,1500000000,1500000000
56104290646,1649276041,63200,57604290646,63200,113709528546,1500000000,1500000000
33646533841,1650599639,60862,35000000000,56062,35000000000,1500000000,1353466159
67644191877,1650666992,63200,69144191877,63200,121757438576,1500000000,1500000000
44781950291,1649063390,67634,46281950291,67634,77555913942,1500000000,1500000000
34542837617,1649035244,314146,36042837617,314146,43417629875,1500000000,1500000000
105625625929,1642327056,60862,107125625929,60862,139567632844,1500000000,1500000000
54842525953,1646324077,67634,56342525953,62834,65000670605,1500000000,1500000000
87625445399,1645188469,337486,89125445399,337486,92846338849,1500000000,1500000000
60019800439,1650670037,67634,61519800439,62834,73311946290,1500000000,1500000000
52621716997,1650659827,300200,54121716997,300200,56262425510,1500000000,1500000000
75915132089,1646318823,55592,77415132089,50792,109081449848,1500000000,1500000000
75915132089,1646318823,60862,77415132089,56062,109081449848,1500000000,1500000000
34546692488,1646349210,60862,36046692488,56062,43084445452,1500000000,1500000000
71608130895,1645223303,342923,73108130895,342923,76741467093,1500000000,1500000000
42374620525,1650621046,67634,43874620525,62834,52651860562,1500000000,1500000000
74764716499,1649112262,55705,76264716499,50905,111012847168,1500000000,1500000000
80851814897,1649078398,67646,82351814897,62846,100078406794,1500000000,1500000000
100846213311,1642335302,60862,102346213311,56062,123815041548,1500000000,1500000000
129997142398,1642303268,60862,131497142398,56062,161790466398,1500000000,1500000000
52051908707,1647628007,67634,53551908707,67634,55500628027,1500000000,1500000000
49493053050,1645161267,54676,50993053050,49876,72960041998,1500000000,1500000000
42684129891,1647624778,322971,44184129891,322971,61920304648,1500000000,1500000000
54860126497,1650592962,335128,56360126497,335128,60417865695,1500000000,1500000000
74550233698,1642332807,312898,76050233698,312898,103265228828,1500000000,1500000000
71199263359,1646326108,307168,72699263359,307168,89592302987,1500000000,1500000000
42850943549,1649249549,67646,44350943549,62846,51282176365,1500000000,1500000000
51950752104,1646284717,327403,53450752104,327403,78637041060,1500000000,1500000000
34800611798,1650630972,67634,36800611798,62834,52820471994,2000000000,2000000000
44203578425,1649069976,60850,45703578425,60850,55026740173,1500000000,1500000000
86705344864,1649112124,67622,88205344864,67622,88269677737,1500000000,1500000000
74719394012,1642336883,67646,76249624110,62846,84558284096,1530230098,1530230098
35131168480,1645790487,336835,36631168480,336835,41477065138,1500000000,1500000000
80081109004,1645151844,337490,81581109004,337490,109106514838,1500000000,1500000000
66890962880,1649263561,55580,68390962880,55580,88184530745,1500000000,1500000000
61844416078,1649103880,55580,63344416078,55580,71000000000,1500000000,1500000000
61844416078,1649103880,67634,64844416078,67634,77000000000,3000000000,3000000000
119916096810,1642299823,60862,121416096810,56062,155756581424,1500000000,1500000000
28920433728,1646304930,67634,30000000000,62834,30000000000,1500000000,1079566272
31514776663,1646311503,67634,32514776663,67634,36700817139,1000000000,1000000000
79124412675,1645825347,322883,80534412675,322883,84837731532,1410000000,1410000000
77079635882,1650646119,67646,78579635882,62846,103828238279,1500000000,1500000000
46174478719,1650587988,67634,47674478719,62834,59370986665,1500000000,1500000000
54078147920,1649057974,60862,55578147920,56062,59959278234,1500000000,1500000000
90591832397,1642317602,60850,92091832397,56050,111392294915,1500000000,1500000000
108420417475,1642326556,67646,109920417475,67646,154130898164,1500000000,1500000000
57612648987,1650642990,67646,59112648987,62846,79450751213,1500000000,1500000000
33785108118,1650599704,67646,35285108118,62846,48770865897,1500000000,1500000000
30511665583,1650605366,67634,32011665583,67634,43859475019,1500000000,1500000000
59554641956,1649111128,67646,61054641956,62846,66663601401,1500000000,1500000000
100217378821,1649113345,67634,101717378821,67634,121270443543,1500000000,1500000000
44322228231,1649063912,320457,45822228231,320457,56839780312,1500000000,1500000000
139368777777,1643248852,55705,140868777777,50905,142529084447,1500000000,1500000000
55563739677,1646332221,67646,57063739677,67646,92682953982,1500000000,1500000000
101014208423,1645180277,67634,102514208423,67634,106415920624,1500000000,1500000000
58367508945,1649210835,67634,59867508945,62834,83541496832,1500000000,1500000000
30185366207,1650608027,319717,31685366207,319717,38000000000,1500000000,1500000000
84138645943,1649108663,67634,86078645943,67634,97013331249,1940000000,1940000000
31306257999,1649070527,333692,33231000000,333692,33231000000,33231000000,1924742001
76838074290,1646316805,67646,78338074290,62846,105073338677,1500000000,1500000000
49116683075,1646327130,333153,50616683075,333153,56096274570,1500000000,1500000000
40171480688,1649241296,55083,41671480688,55083,48438291924,1500000000,1500000000
54647006309,1649256233,319753,56147006309,319753,67049084237,1500000000,1500000000
50272147696,1644984295,67634,51772147696,62834,61458472997,1500000000,1500000000
31353845048,1650630306,56588,32471743113,51788,32471743113,1500000000,1117898065
56128043595,1649112822,60838,57628043595,60838,76850308607,1500000000,1500000000
100175655703,1642330470,56504,101675655703,51704,103711002687,1500000000,1500000000
65791504276,1646320293,55592,67291504276,50792,71030294273,1500000000,1500000000
48891897263,1646310876,60850,50391897263,56050,60474997382,1500000000,1500000000
99626885385,1645192461,67634,101626885385,67634,141247831982,2000000000,2000000000
37539084571,1649236889,323648,39539084571,323648,55000000000,2000000000,2000000000
41364400798,1649284680,49495,42864400798,44695,57666833314,1500000000,1500000000
77243289270,1650645896,67646,78743289270,62846,83634507084,1500000000,1500000000
38322204175,1649064521,67646,39822204175,67646,54090268707,1500000000,1500000000
53952440749,1649069066,67646,55022440749,62846,60424846464,1070000000,1070000000
27956703127,1646329168,338856,29456703127,338856,37783697722,1500000000,1500000000
52585760168,1645751570,340685,54085760168,340685,93686768958,1500000000,1500000000
40394057253,1645002049,55648,42894057253,55648,83134242284,2500000000,2500000000
56425949026,1650590596,55793,57925949026,50993,71065736342,1500000000,1500000000
45574406736,1650656088,67634,47074406736,67634,56515638120,1500000000,1500000000
64757682381,1649112362,67622,66257682381,67622,93032331202,1500000000,1500000000
51340008004,1649072100,67622,52840008004,67622,66218399925,1500000000,1500000000
61393729384,1649078115,331067,62893729384,331067,64524552267,1500000000,1500000000
188889566259,1645195319,332623,190389566259,332623,213023006535,1500000000,1500000000
84250402832,1650642899,54700,86250402832,49900,111575885045,2000000000,2000000000
93573787425,1649088392,60838,95073787425,60838,96407155380,1500000000,1500000000
56122714540,1646326642,310285,57622714540,310285,77990919198,1500000000,1500000000
22289726383,1647594968,67634,23789726383,62834,34649596680,1500000000,1500000000
129034165225,1645198565,55592,130534165225,50792,159762468852,1500000000,1500000000
90984966872,1645215875,346358,92634966873,346358,146027862316,1650000001,1650000001
51963864559,1650596279,67646,53463864559,62846,63407554863,1500000000,1500000000
41787439669,1650592069,66790,43287439669,61990,58067491462,1500000000,1500000000
41505105985,1650592743,67634,51000000000,67634,,,
143963761172,1643254682,67634,145463761172,67634,151601913105,1500000000,1500000000
34515973058,1646287400,67622,36015973058,67622,50939248887,1500000000,1500000000
55975885152,1646286168,67622,57975885152,67622,65788156083,2000000000,2000000000
37486799225,1649242467,55119,38986799225,50319,43366452897,1500000000,1500000000
43817220678,1650597541,329267,45817220678,329267,57634643041,2000000000,2000000000
62157595205,1649090624,319755,63567595205,319755,74438010153,1410000000,1410000000
109097165713,1645198321,67622,110597165713,67622,186440338474,1500000000,1500000000
60437864486,1649218627,67646,62437864486,62846,81329567827,2000000000,2000000000
24804974934,1650618224,25000,26304974934,25000,29899635133,1500000000,1500000000
26100310538,1650622920,67634,27600310538,67634,37619445749,1500000000,1500000000
26507000049,1646296420,55693,28007000049,55693,36454964964,1500000000,1500000000
40029464228,1649222058,336883,41529464228,336883,45716180568,1500000000,1500000000
39199230265,1649246277,60850,40699230265,56050,50863026252,1500000000,1500000000
46353180314,1649219305,66766,47853180314,66766,61609457153,1500000000,1500000000
30033952242,1649246178,66766,32033952242,66766,41305354020,2000000000,2000000000
33060955117,1650619790,67634,34560955117,62834,37820151993,1500000000,1500000000
28726173072,1650617637,67646,30226173072,62846,35849949868,1500000000,1500000000
64772512083,1649040753,67622,66272512083,67622,91341553877,1500000000,1500000000
37838747419,1649065603,320451,39338747419,320451,44214682890,1500000000,1500000000
128777169909,1642377034,334340,130277169909,334340,149715564455,1500000000,1500000000
98138711668,1646318962,60862,99638711668,56062,136829726088,1500000000,1500000000
53269704746,1645000501,337500,54769704746,337500,66155664094,1500000000,1500000000
37413361467,1650602620,60862,38913361467,56062,44333817149,1500000000,1500000000
44443510023,1646294898,67622,46443510023,67622,57937197916,2000000000,2000000000
46443332138,1647576535,325649,47943332138,325649,74710367129,1500000000,1500000000
31636937577,1647598933,60850,33636937577,60850,51018265599,2000000000,2000000000
69773357604,1645190315,60018,71273357604,55218,80358344085,1500000000,1500000000
64460471722,1649213003,337502,65960471722,337502,77003783948,1500000000,1500000000
97031980579,1642348408,55636,99531980579,55636,208070159454,2500000000,2500000000
73466224612,1642339379,60850,74966224612,60850,81440666603,1500000000,1500000000
54807313671,1645147923,311711,56307313671,311711,61147900072,1500000000,1500000000
114523992366,1645193641,60850,116023992366,56050,149470745930,1500000000,1500000000
115374157078,1645225884,332414,116874157078,332414,140478958067,1500000000,1500000000
102111523989,1645053672,340051,103611523989,340051,114958489077,1500000000,1500000000
70238069174,1650645548,51428,71738069174,46628,78327271313,1500000000,1500000000
105118237651,1642313624,67646,106618237651,62846,161354204510,1500000000,1500000000
86969675466,1642323092,55681,88469675466,50881,113035221993,1500000000,1500000000
78440496456,1646349913,60862,79940496456,56062,82440037315,1500000000,1500000000
36243153932,1649286295,321016,41000000000,321016,41000000000,41000000000,4756846068
68077853296,1649263410,48663,69577853296,43863,77085523550,1500000000,1500000000
49665392816,1649267392,63200,51165392816,63200,110550876190,1500000000,1500000000
62147255315,1649039781,67646,63972601315,62846,70081113434,1825346000,1825346000
66686469743,1649109534,67646,68186469743,62846,94586380762,1500000000,1500000000
129478824505,1642294382,60862,130978824505,56062,176863337159,1500000000,1500000000
129478824505,1642294382,56516,131478824505,51716,184377870646,2000000000,2000000000
52986890814,1647578169,66778,54486890814,61978,58000000000,1500000000,1500000000
78921907843,1649257068,63200,80421907843,63200,141808780828,1500000000,1500000000
69251735152,1650595586,67622,70751735152,62822,78985150174,1500000000,1500000000
69251735152,1650595586,67634,70751735152,67634,78482156218,1500000000,1500000000
40087860513,1645814131,64705,41129442155,59905,41129442155,1510000000,1041581642
100486676585,1645220868,339462,101986676585,339462,134343926944,1500000000,1500000000
105551173860,1645202953,54712,107051173860,49912,148133383332,1500000000,1500000000
48666363755,1650591556,66862,50166363755,62062,62140425712,1500000000,1500000000
85901205735,1642343080,340063,87401205735,340063,92423555735,1500000000,1500000000
55985969096,1646345572,336271,57485969096,336271,63920081152,1500000000,1500000000
49271081980,1646322810,55592,57648567050,50792,,,
33712748877,1650607501,67634,35712748877,62834,46102181682,2000000000,2000000000
61783057797,1650659851,55648,63283057797,55648,118986082554,1500000000,1500000000
61783057797,1650659851,67634,63783057797,67634,70408232097,2000000000,2000000000
61783057797,1650659851,55720,64283057797,50920,200000000000,2500000000,2500000000
39868444431,1650588942,67646,41868444431,67646,64647176781,2000000000,2000000000
48484579800,1649061534,67622,49984579800,67622,69461931794,1500000000,1500000000
48484579800,1649061534,66742,49984579800,61942,69461931794,1500000000,1500000000
49954041531,1649105357,67646,52954041531,62846,63500375869,3000000000,3000000000
112300367769,1642312091,54860,113800367769,50060,129736022680,1500000000,1500000000
40886321660,1646293592,60850,42211431997,56050,42211431997,1500000000,1325110337
33110811267,1647611089,55580,34610811267,50780,42620065834,1500000000,1500000000
78376687241,1650640134,67658,80376687241,62858,99105377034,2000000000,2000000000
29186798058,1650610655,464715,41000000000,309810,,,
46622170466,1650657488,67646,48122170466,62846,81533355260,1500000000,1500000000
72882103862,1649094641,52916,74382103862,52916,111477430793,1500000000,1500000000
48303809876,1649092871,325183,49803809876,325183,300000000000,1500000000,1500000000
45719358959,1645813624,343169,47229358959,343169,58698148283,1510000000,1510000000
46627714152,1645162340,67634,48127714152,62834,53431624783,1500000000,1500000000
30042600538,1650658101,67646,31452600538,62846,39000000000,1410000000,1410000000
44542715632,1644805366,323666,46042715632,323666,56748087755,1500000000,1500000000
86028757242,1644869199,56468,87528757242,51668,100353590788,1500000000,1500000000
39061902227,1649766459,60862,41375950053,56062,,,
31252870891,1649766782,67634,32752870891,67634,52736716532,1500000000,1500000000
46532851202,1649759175,326115,48032851202,326115,55627796462,1500000000,1500000000
27551453763,1650775091,67622,29051453763,62822,31672218444,1500000000,1500000000
25654329048,1650794242,64032,27154329048,54432,31579181969,1500000000,1500000000
30382483381,1649858942,67634,31882483381,67634,32000000000,1500000000,1500000000
31977498137,1649745324,67722,33477498137,67722,38572490884,1500000000,1500000000
26842511451,1650838991,91293,34000000000,56062,,,
17798975879,1650769230,55681,19298975879,55681,22453673642,1500000000,1500000000
29240806358,1649838590,60862,30740806358,56062,31300000000,1500000000,1500000000
28229428476,1649848530,66754,29729428476,61954,38229194840,1500000000,1500000000
27218045126,1649846142,60862,28718045126,56062,36881622632,1500000000,1500000000
41523878449,1649853583,55693,43023878449,36429,76057226143,1500000000,1500000000
14615758727,1647247197,312968,16115758727,312968,22605484108,1500000000,1500000000
56117038594,1649807520,63200,57617038594,63200,112340025022,1500000000,1500000000
32899710404,1650839597,67734,34399710404,62934,35640511890,1500000000,1500000000
21570319836,1650789064,67622,23070319836,67622,31530492192,1500000000,1500000000
67425832320,1649860800,67622,68925832320,67622,95505025014,1500000000,1500000000
34312977286,1649821143,49583,35812977286,44783,47769236159,1500000000,1500000000
27704482497,1647275641,307106,29204482497,307106,30000000000,1500000000,1500000000
26177367722,1647711447,67634,27677367722,62834,27973536529,1500000000,1500000000
22854874537,1650798691,66766,24354874537,61966,25945722369,1500000000,1500000000
20863280034,1647701058,66706,22363280034,61906,34768696153,1500000000,1500000000
29972753561,1649731301,331406,31622753561,331406,46287510590,1650000000,1650000000
29831896111,1649737332,67646,31331896111,62846,33935327147,1500000000,1500000000
39010504826,1649768084,56588,40510504826,51788,50033552397,1500000000,1500000000
42015689140,1650810784,67646,43665689140,62846,56179432247,1650000000,1650000000
17357573371,1650771295,331073,18857573371,331073,26945594693,1500000000,1500000000
37200351348,1649881206,326135,38700351348,326135,49523002820,1500000000,1500000000
39985368507,1649836221,56576,41485368507,51776,49246142113,1500000000,1500000000
39334130359,1647648933,67634,40834130359,67634,42825809899,1500000000,1500000000
21208424401,1647723816,67634,22708424401,67634,28500208040,1500000000,1500000000
25972640365,1649804480,66766,27472640365,66766,36141777834,1500000000,1500000000
51479020463,1649775526,64741,52979020463,59941,85749637797,1500000000,1500000000
51479020463,1649775526,340063,52979020463,340063,53679346219,1500000000,1500000000
31949611722,1649741540,331125,33449611722,331125,38660317063,1500000000,1500000000
40559995588,1647649414,67646,42059995588,62846,59999916699,1500000000,1500000000
37241928544,1649769769,337498,38741928544,337498,53924518030,1500000000,1500000000
37781632316,1649738730,67634,39281632316,62834,50124351033,1500000000,1500000000
23433979263,1649752625,55648,24933979263,55648,54990102698,1500000000,1500000000
69752641154,1649796900,59922,71252641154,55122,115045854208,1500000000,1500000000
26725127831,1650837233,326107,30883951394,326107,,,
33558687272,1647668335,67634,35058687272,67634,50533707682,1500000000,1500000000
23891201020,1647248122,314160,25391201020,314160,27395701929,1500000000,1500000000
36551913221,1644820412,67634,38051913221,67634,42119172678,1500000000,1500000000
28814631799,1649753896,60862,30314631799,56062,38772610195,1500000000,1500000000
65184080107,1649776548,66790,66684080107,66790,93690248420,1500000000,1500000000
14826728117,1647684822,60926,16326728117,60926,20070317547,1500000000,1500000000
52417130716,1649767876,56564,53917130716,56564,63726720714,1500000000,1500000000
35828493865,1650830041,316694,37328493865,316694,38838250588,1500000000,1500000000
70982791118,1649808555,66766,72482791118,61966,89197866877,1500000000,1500000000
44960427850,1649837618,67710,46460427850,67710,49694308174,1500000000,1500000000
37354399288,1649841133,67710,38854399288,62910,47799700037,1500000000,1500000000
54242682150,1649890853,335174,55742682150,335174,61040847155,1500000000,1500000000
62999269679,1649779224,54700,64499269679,54700,79730280283,1500000000,1500000000
34800291259,1649740115,60950,36300291259,60950,44083979253,1500000000,1500000000
72979497066,1649774747,60838,74479497066,56038,89442377737,1500000000,1500000000
49541352688,1649885106,60926,51041352688,56126,60568286844,1500000000,1500000000
65137966420,1649782977,67722,66637966420,62922,76476064243,1500000000,1500000000
65137966420,1649782977,67634,66637966420,62834,76476064243,1500000000,1500000000
31448831014,1649754584,60850,32948831014,60850,45444053823,1500000000,1500000000
15856753906,1650788419,67646,17356753906,62846,20284297477,1500000000,1500000000
39413409861,1650815070,67646,41413409861,62846,53130450687,2000000000,2000000000
22767927818,1650792937,55580,24267927818,50780,29035932354,1500000000,1500000000
38200381815,1649842295,60838,39700381815,56038,46043598208,1500000000,1500000000
25211783909,1650840632,67634,27211783909,62834,34115196597,2000000000,2000000000
27329440373,1650769873,60850,28829440373,60850,33032155490,1500000000,1500000000
32205063585,1649723374,67646,33705063585,62846,38000000000,1500000000,1500000000
66717349900,1649779366,51476,68217349900,46676,100253892402,1500000000,1500000000
40258807510,1649729842,336877,41758807510,336877,51506318585,1500000000,1500000000
21594160798,1647240364,67646,23094160798,62846,31882456443,1500000000,1500000000
42682833628,1647724923,319887,44182833628,319887,48926121062,1500000000,1500000000
16249383944,1647687996,60850,17749383944,56050,20040124533,1500000000,1500000000
40051130367,1650835428,67634,41551130367,62834,56125670562,1500000000,1500000000
21355690330,1647244728,324212,22855690330,324212,26495465815,1500000000,1500000000
37665751452,1644824220,341907,38707815503,341907,38707815503,1500000000,1042064051
35143557640,1649816830,55816,36643557640,51016,41083327344,1500000000,1500000000
57667627626,1644879882,55705,59667627626,50905,83924586863,2000000000,2000000000
14564935857,1647696549,55717,16064935857,50917,23019633538,1500000000,1500000000
28805443149,1649756829,67722,30305443149,62922,41907873467,1500000000,1500000000
52637418149,1649779437,60862,54000000000,56062,,,
45443467928,1649769292,59958,46943467928,55158,71309765040,1500000000,1500000000
63151095083,1649860070,340667,64651095083,340667,95489576003,1500000000,1500000000
48430984062,1649882295,64044,49930984062,54444,49946012292,1500000000,1500000000
41226378658,1647648788,66790,42726378658,61990,48964882593,1500000000,1500000000
28887398785,1649750199,66802,30387398785,66802,41170878378,1500000000,1500000000
37650169335,1649793558,55568,39150169335,50768,43625639595,1500000000,1500000000
20414556013,1650760854,333706,21914556013,333706,30169502027,1500000000,1500000000
44819386499,1649872794,67658,46819386499,62858,62436996059,2000000000,2000000000
33162039681,1649885467,48663,34662039681,43863,45000000000,1500000000,1500000000
29092415568,1649831113,338770,30592415568,338770,39183861595,1500000000,1500000000
64625639378,1649872325,55705,66125639378,50905,71244017047,1500000000,1500000000
18754127892,1647240912,340701,20254127892,340701,22733910657,1500000000,1500000000
46400897272,1650812501,48615,47900897272,43815,56992731742,1500000000,1500000000
91783614516,1649869244,67646,93283614516,62846,118336734409,1500000000,1500000000
22671818341,1647221861,55592,24171818341,50792,32464793130,1500000000,1500000000
82411423379,1644866192,352745,83911423379,352745,85000000000,1500000000,1500000000
82411423379,1644866192,350181,83911423379,350181,85000000000,1500000000,1500000000
20266062612,1647723671,67622,21766062612,67622,27478756613,1500000000,1500000000
38497113580,1649739866,340063,39997113580,340063,42921918112,1500000000,1500000000
14147484363,1647238154,60850,15647484363,60850,18016094299,1500000000,1500000000
68531760649,1649862317,67734,70031760649,62934,105048134445,1500000000,1500000000
61104109897,1649876321,67646,62604109897,62846,83846304318,1500000000,1500000000
29115038768,1650783773,67658,30115039768,62858,33924381243,1000001000,1000001000
18776775852,1650803361,337490,19366557319,337490,,,
43952067255,1649795488,67646,45452067255,62846,100000000000,1500000000,1500000000
78084201613,1649771074,333710,79584201613,333710,106217216155,1500000000,1500000000
39121461689,1649768110,67634,40621461689,67634,47333662579,1500000000,1500000000
33060472284,1647656458,316734,34560472284,316734,37940238522,1500000000,1500000000
16994893609,1647675951,67634,18494893609,62834,23716752652,1500000000,1500000000
31080750190,1649803358,55668,32580750190,50868,40968320164,1500000000,1500000000
33004999447,1650813544,60862,34504999447,56062,55103692135,1500000000,1500000000
36230329356,1644814744,331955,38230329356,331955,50047050516,2000000000,2000000000
28300427469,1649748520,67646,34586580367,62846,,,
42580631261,1649732777,60838,44080631261,60838,50471944190,1500000000,1500000000
29092912512,1649759504,60850,30592912512,60850,39086081040,1500000000,1500000000
22382627852,1650836763,49495,23882627852,44695,32959327400,1500000000,1500000000
57032706398,1647650859,331139,58532706398,331139,61105477793,1500000000,1500000000
47736167312,1650813532,55580,49146167312,50780,51397381906,1410000000,1410000000
28604134730,1649822489,49595,30104134730,44795,43862726427,1500000000,1500000000
38336134712,1649842461,54330,39836134712,49530,51422934178,1500000000,1500000000
70954769900,1644846449,59946,72454769900,59946,75906933689,1500000000,1500000000
34167788589,1644807278,340635,35667788589,340635,42935947302,1500000000,1500000000
48710059692,1650824177,67634,50210059692,62834,63054995707,1500000000,1500000000
35640530347,1649853925,322919,37140530347,322919,37211059907,1500000000,1500000000
14305631666,1647257206,343263,15805631666,343263,17000000000,1500000000,1500000000
55358033203,1649772220,64741,56858033203,59941,76984332344,1500000000,1500000000
41650455008,1649816495,334350,42798630556,334350,49693707449,1148175548,1148175548
35210148412,1649843987,66730,36662989649,61930,36662989649,1500000000,1452841237
38110019495,1649850926,336889,39610019495,336889,44479270299,1500000000,1500000000
54053605968,1649892758,343223,59784432077,343223,,,
16779751263,1647258645,67634,18279751263,62834,19663935857,1500000000,1500000000
37707008564,1649765229,67646,39207008564,62846,60555948454,1500000000,1500000000
31677335986,1649740774,67646,33177335986,62846,36596089464,1500000000,1500000000
16701172036,1650792429,67658,18201172036,67658,22778430702,1500000000,1500000000
28666351989,1650769950,55592,30166351989,50792,36467403504,1500000000,1500000000
67168296803,1649891553,67634,68668296803,62834,83092170873,1500000000,1500000000
35529630576,1649892947,67634,37029630576,62834,49268256427,1500000000,1500000000
52508334831,1647283599,329495,54008334831,329495,70798599689,1500000000,1500000000
30270374748,1647725330,63200,31770374748,63200,68721711876,1500000000,1500000000
34808236571,1649747755,55592,36308236571,55592,37000000000,1500000000,1500000000
30685243005,1649744603,55681,32185243005,50881,45276059502,1500000000,1500000000
30685243005,1649744603,56516,32185243005,51716,45276059502,1500000000,1500000000
28746677755,1649760864,67646,30746677755,62846,40034968650,2000000000,2000000000
42195378883,1649770455,59982,43695378883,59982,53060631222,1500000000,1500000000
16959881329,1650786386,67646,18459881329,62846,24436387749,1500000000,1500000000
46576736283,1647275118,55359,48076736283,55359,65606215962,1500000000,1500000000
19097793450,1647699627,60926,20597793450,60926,27508663267,1500000000,1500000000
39561392671,1649739103,65530,41061392671,60730,55341014933,1500000000,1500000000
16111203912,1650759015,329948,17611203912,329948,23327056228,1500000000,1500000000
28171664384,1647725422,317290,29671664384,317290,34662681615,1500000000,1500000000
32611986175,1650808160,60850,34111986175,60850,46483853122,1500000000,1500000000
49586225108,1647650196,59970,51086225108,55170,60349654589,1500000000,1500000000
31755006999,1649757468,53340,33255006999,43740,36784900277,1500000000,1500000000
37338806724,1649744514,343209,38838806724,343209,44987884597,1500000000,1500000000
30267284777,1649889816,66802,31767284777,66802,44052997198,1500000000,1500000000
53403216617,1647291672,343231,54903216617,343231,56797726955,1500000000,1500000000
30891806674,1649739939,60950,32391806674,56150,45666523800,1500000000,1500000000
47111195119,1649769101,319811,48611195119,319811,55262878293,1500000000,1500000000
28401342711,1649741508,64717,29901342711,64717,38601486230,1500000000,1500000000
53508617877,1649781143,325655,55000000000,325655,55000000000,1500000000,1491382123
13586774503,1647260520,67634,15086774503,67634,17150819549,1500000000,1500000000
115242043989,1644872556,343847,116742043989,343847,118003711158,1500000000,1500000000
42864928328,1649827423,55717,44364928328,55717,61255414809,1500000000,1500000000
23752033623,1647222692,334306,25252033623,334306,31917299139,1500000000,1500000000
45218698820,1649728449,63200,46718698820,63200,109875324302,1500000000,1500000000
73796655138,1650823144,337522,75296655138,337522,94487586057,1500000000,1500000000
123905945444,1650821427,60862,126330945444,56062,162821444504,2425000000,2425000000
31214159762,1649856557,49583,32864159762,44783,35000000000,1650000000,1650000000
50290003319,1649767945,60938,51790003319,56138,70820903134,1500000000,1500000000
42515142588,1650832275,67634,44515142588,62834,48777040769,2000000000,2000000000
10963261904,1647260356,67646,12065691080,62846,12065691080,1504570190,1102429176
59468480132,1650817040,67622,60968480132,67622,77024567558,1500000000,1500000000
16066533384,1650782468,60862,17566533384,56062,24749143338,1500000000,1500000000
33668102359,1650820782,320461,35168102359,320461,40460480652,1500000000,1500000000
37589035218,1647656082,56729,39089035218,47129,54888382159,1500000000,1500000000
39794857305,1650812458,60950,41294857305,56150,63157318063,1500000000,1500000000
44914205663,1649893527,67722,46414205663,67722,56818301515,1500000000,1500000000
47630121799,1649820166,55680,49130121799,50880,59029598857,1500000000,1500000000
39385928518,1647220639,60862,40410007512,56062,40410007512,1500000000,1024078994
41449516183,1649740831,323553,42949516183,323553,43610652985,1500000000,1500000000
37243966878,1650839485,60850,38743966878,56050,43452917158,1500000000,1500000000
52333522047,1649801338,52904,53833522047,48104,62987341818,1500000000,1500000000
38294270489,1650813177,91275,42000000000,60850,,,
24302535621,1649821441,326820,25302535621,326820,26000000000,1000000000,1000000000
42920513530,1649729701,316624,43897296225,316624,43897296225,1500000000,976782695
42920513530,1649729701,319775,43897296225,319775,43897296225,1500000000,976782695
20280905266,1650775857,55592,21780905266,50792,28000000000,1500000000,1500000000
48585021644,1650827729,346366,50085021644,346366,64501995367,1500000000,1500000000
29792291944,1649844263,67634,31292291944,62834,42765602399,1500000000,1500000000
18646444282,1647242301,60838,20146444282,60838,31454794470,1500000000,1500000000
35343891780,1644813214,334306,36843891780,334306,40000000000,1500000000,1500000000
17249285802,1647712888,67622,18749285802,67622,24615725873,1500000000,1500000000
37908153177,1649741995,60950,39408153177,56150,46820103843,1500000000,1500000000
25926152949,1650791124,60838,27426152949,60838,35163898917,1500000000,1500000000
23715120886,1650791115,60862,25215120886,56062,35163898917,1500000000,1500000000
30027730048,1647708879,67634,31527730048,67634,41081442768,1500000000,1500000000
19044534126,1650771744,67622,20544534126,67622,29279324427,1500000000,1500000000
39868111131,1647277052,331091,41368111131,331091,47047636742,1500000000,1500000000
24406403080,1647268218,60862,25906403080,56062,35609212980,1500000000,1500000000
40159866112,1649776995,63200,41659866112,63200,78293303114,1500000000,1500000000
15403442539,1647237290,60850,17403442539,56050,20342902296,2000000000,2000000000
42345139719,1647658879,60850,43361298525,60850,43361298525,1500000000,1016158806
55080300469,1649722923,332438,56580300469,332438,62705729204,1500000000,1500000000
29927214499,1649834356,64741,31427214499,59941,38929859919,1500000000,1500000000
35923122977,1647273428,322947,37423122977,322947,45288957613,1500000000,1500000000
27686336844,1649751785,64741,29686336844,59941,47518997075,2000000000,2000000000
29617148291,1650797845,60850,31117148291,56050,42412186215,1500000000,1500000000
42508720461,1649725386,60938,44008720461,56138,66126751649,1500000000,1500000000
109245310786,1649797678,63200,110745310786,63200,196607662032,1500000000,1500000000
19486175795,1650779549,54920,20986175795,50120,27355925350,1500000000,1500000000
21435334486,1650768385,60862,22935334486,56062,27073719262,1500000000,1500000000
44575948750,1649856363,60006,46000000000,60006,46000000000,1500000000,1424051250
30831304960,1649816976,67634,32331304960,67634,38645217603,1500000000,1500000000
38365101339,1647275337,67634,39596150782,67634,39596150782,1500000000,1231049443
25691723909,1649746282,310257,27191723909,310257,35070717798,1500000000,1500000000
51409377641,1649772847,48651,52909377641,43851,81335900597,1500000000,1500000000
50129604852,1649786562,333680,51629604852,333680,62823035743,1500000000,1500000000
56165022387,1649775467,64741,57665022387,59941,85087500997,1500000000,1500000000
44598346507,1649771249,66766,46098346507,61966,84666609554,1500000000,1500000000
31991971344,1649803255,64705,33491971344,64705,37476411934,1500000000,1500000000
29215870423,1650842437,67622,30715870423,67622,41996210645,1500000000,1500000000
36635861059,1647701755,66730,38135861059,61930,40624227189,1500000000,1500000000
35815214758,1649794722,67622,37315214758,67622,43696629758,1500000000,1500000000
35791361305,1650836315,328789,37291361305,328789,47969671609,1500000000,1500000000
29342905362,1644822928,322812,30842905362,322812,42060530514,1500000000,1500000000
42763978254,1649738156,67634,44263978254,67634,50710585578,1500000000,1500000000
30652416992,1649835173,59970,32152416992,55170,39488353667,1500000000,1500000000
38027545493,1649812858,335542,39527545493,335542,46265254195,1500000000,1500000000
22653109830,1647247537,318700,24153109830,318700,25706898530,1500000000,1500000000
34772707293,1647300638,67634,36272707293,67634,42621924213,1500000000,1500000000
82822646187,1649776505,343233,84322646187,343233,85557865880,1500000000,1500000000
18800488309,1650779401,54676,20072069215,49876,20072069215,1500000000,1271580906
44921671377,1650817951,55592,46421671377,50792,60396034872,1500000000,1500000000
27497726514,1650789665,60938,28997726514,56138,31351171142,1500000000,1500000000
29357402479,1649834425,67646,30857402479,62846,38647273622,1500000000,1500000000
39847596583,1650827777,55592,41347596583,50792,58425137975,1500000000,1500000000
34895884646,1649822082,326107,36395884646,326107,38400918230,1500000000,1500000000
21919655510,1647265735,314138,23150528515,314138,23150528515,1500000000,1230873005
20654626116,1647683151,60862,22154626116,56062,25142630993,1500000000,1500000000
19024642819,1647681717,313528,20524642819,313528,24617127555,1500000000,1500000000
57764687072,1649799474,343853,59174687072,343853,63742520501,1410000000,1410000000
14151347004,1647259084,343865,15651347004,343865,16974219430,1500000000,1500000000
63934465301,1644852167,67622,65434465301,67622,78389688458,1500000000,1500000000
37183711314,1649732132,326778,38683711314,326778,45092689708,1500000000,1500000000
45588564295,1649782307,60862,47088564295,60862,55112641925,1500000000,1500000000
56477194089,1649778805,328230,57977194089,328230,65497224848,1500000000,1500000000
26719503239,1647240264,67646,28219503239,62846,33354299054,1500000000,1500000000
22935601621,1650760823,333277,24435601621,326808,200000000000,1500000000,1500000000
67192522147,1649810775,302753,68692522147,302753,87453570648,1500000000,1500000000
24975362735,1649823411,60838,26475362735,56038,30780374654,1500000000,1500000000
18456459775,1647248896,331971,19956459775,331971,27493400018,1500000000,1500000000
14921080392,1647250098,67634,16421080392,67634,19344797998,1500000000,1500000000
34657768325,1649755058,67710,35735131717,67710,35735131717,1500000000,1077363392
38679298817,1649786057,59946,40179298817,55146,60860851868,1500000000,1500000000
24487455531,1650800405,337464,25987455531,337464,29969168600,1500000000,1500000000
41607020210,1649867110,67634,43107020210,67634,66989681174,1500000000,1500000000
15108163896,1647256762,315594,16608163896,315594,24580352468,1500000000,1500000000
30408514200,1647657727,325657,32408514200,325657,43546858329,2000000000,2000000000
20656824676,1650805091,67634,22156824676,62834,22161575724,1500000000,1500000000
37731574323,1650801692,67634,38772855682,62834,38772855682,1500000000,1041281359
19524298463,1650796793,67646,21024298463,62846,27160324008,1500000000,1500000000
25734862903,1650798382,335566,27234862903,335566,27625968799,1500000000,1500000000
67059654809,1644871524,332474,68559654809,332474,70887607157,1500000000,1500000000
30845549595,1649731357,325631,32845549595,325631,46831546070,2000000000,2000000000
46499028689,1647286110,67634,47999028689,62834,59964760058,1500000000,1500000000
28710260431,1647701338,333686,30210260431,333686,37440241147,1500000000,1500000000
58325137070,1649891722,64741,59825137070,59941,62082932442,1500000000,1500000000
33372582899,1649829533,63200,34872582899,63200,48387114496,1500000000,1500000000
35656984685,1649841168,55717,37156984685,50917,48192999110,1500000000,1500000000
53156970859,1649888940,67646,54656970859,62846,73122107888,1500000000,1500000000
45165087397,1649732216,48651,46665087397,43851,46773938150,1500000000,1500000000
42570179775,1649856685,49583,44070179775,44783,58908915539,1500000000,1500000000
59610477032,1649880580,66778,61110477032,61978,85937533833,1500000000,1500000000
12403686711,1647259878,60862,13903686711,56062,17949739443,1500000000,1500000000
19249904820,1647710768,316510,20749904820,316510,28635152449,1500000000,1500000000
64952310567,1649779676,60926,66452310567,60926,72489805099,1500000000,1500000000
23268201172,1650764071,67646,24768201172,62846,33395856519,1500000000,1500000000
36512720579,1649817560,66814,38012720579,62014,59838626627,1500000000,1500000000
39300717211,1649854343,313963,40800717211,313963,57183386578,1500000000,1500000000
26043673406,1647241048,343165,27543673406,326065,28175341793,1500000000,1500000000
26043673406,1647241048,336885,27543673406,336885,30175380237,1500000000,1500000000
27374735191,1649794994,316717,28874735191,316717,31503195212,1500000000,1500000000
23123999880,1650772459,67634,24623999880,62834,28156440030,1500000000,1500000000
16073382342,1650775920,337450,18073382342,337450,24731999726,2000000000,2000000000
56719786891,1649872867,59970,57524233124,59970,57524233124,1500000000,804446233
37674152492,1649831972,55580,39174152492,50780,46818132014,1500000000,1500000000
51372041785,1647280756,321859,52872041785,321859,56004252288,1500000000,1500000000
51372041785,1647280756,60862,52872041785,56062,56004252288,1500000000,1500000000
44131758904,1649879102,64056,45383407094,54456,,,
21688800272,1647687305,60838,23188800272,60838,35699688902,1500000000,1500000000
44832744130,1649722264,67722,46332744130,62922,55783268110,1500000000,1500000000
51889962672,1649784826,60862,53389962672,56062,78866201417,1500000000,1500000000
15031801704,1647256184,67634,16531801704,67634,18480672384,1500000000,1500000000
62477879627,1644867512,67622,63977879627,67622,75470448277,1500000000,1500000000
44283839389,1649779031,55705,55000000000,50905,,,
37108901084,1649815320,64741,38608901084,59941,100000000000,1500000000,1500000000
22085938476,1647674922,319793,23585938476,319793,25207924899,1500000000,1500000000
53577807253,1649805783,67710,55077807253,67710,56436916295,1500000000,1500000000
45997049087,1649797981,59994,47497049087,55194,74749882493,1500000000,1500000000
45081481858,1649881895,60938,46581481858,60938,58729622648,1500000000,1500000000
45081481858,1649881895,67722,46581481858,62922,58729622648,1500000000,1500000000
74075637870,1649781758,336907,75575637870,336907,81998915828,1500000000,1500000000
34817788108,1649741445,64741,36317788108,59941,44996438123,1500000000,1500000000
22580251519,1650777244,67646,24080251519,62846,28562370009,1500000000,1500000000
19718763430,1647221739,340073,21218763430,340073,28604203490,1500000000,1500000000
48665803839,1644818882,59958,50165803839,55158,51937683108,1500000000,1500000000
31757256737,1649748191,60838,33257256737,60838,40428091758,1500000000,1500000000
42882953708,1650813494,67646,44382953708,67646,55579168830,1500000000,1500000000
44047805450,1649851325,64741,56047805450,59941,350000000000,12000000000,12000000000
13325143887,1647253708,321654,14825143887,304554,14899339977,1500000000,1500000000
46021431308,1650818740,59958,47521431308,55158,54935449058,1500000000,1500000000
39966397472,1644818617,332414,41466397472,332414,52055201730,1500000000,1500000000
61731169255,1649775714,337480,63231169255,337480,67000000000,1500000000,1500000000
41012868391,1649842024,67622,42512868391,62822,57535203593,1500000000,1500000000
16628226097,1647237973,67634,18128226097,67634,27215983297,1500000000,1500000000
13888253073,1647245599,55604,15388253073,50804,17509174904,1500000000,1500000000
16438901370,1647681656,326115,17938901370,326115,27645456569,1500000000,1500000000
47826756183,1649876568,54921,49326756183,50121,200000000000,1500000000,1500000000
31891161407,1649843992,60862,35000000000,56062,,,
28609008195,1647277666,296508,30109008195,296508,40940807698,1500000000,1500000000
37327514893,1647272907,315321,39327514893,315321,40346565751,2000000000,2000000000
18345691312,1647681487,336877,19845691312,336877,24973223172,1500000000,1500000000
39356359492,1649723518,317232,40856359492,317232,49984659709,1500000000,1500000000
36381515123,1649841515,67622,37881515123,67622,51952658645,1500000000,1500000000
49533936223,1644881678,336843,51033936223,336843,52631302303,1500000000,1500000000
18889005436,1650782556,55592,20389005436,50792,21583166730,1500000000,1500000000
19872962616,1647710547,59994,21372962616,55194,26955088759,1500000000,1500000000
27099928361,1649760813,310095,28599928361,310095,29518213983,1500000000,1500000000
54311513754,1649785525,59982,55811513754,55182,67935259878,1500000000,1500000000
50251186601,1649863464,60862,52251186601,56062,55302099298,2000000000,2000000000
31205776848,1647302203,60006,32705776848,55206,40522592478,1500000000,1500000000
74942907668,1649780967,346382,76355346922,346382,76355346922,1500000000,1412439254
13954245710,1647253706,324836,15604245710,324836,16207900658,1650000000,1650000000
59149872753,1649770904,67646,60649872753,62846,68260896797,1500000000,1500000000
45069236732,1650826262,66754,46569236732,61954,58033585922,1500000000,1500000000
35451548058,1650818259,67646,36951548058,62846,58156435253,1500000000,1500000000
19066856718,1650770453,315320,20566856718,315320,23415973154,1500000000,1500000000
124700827471,1644872982,56516,126982509971,46916,206025027407,2281682500,2281682500
29648377312,1649792173,317210,31148377312,317210,33000000000,1500000000,1500000000
47436944387,1649723202,51440,48936944387,46640,51535163153,1500000000,1500000000
39331115913,1650815048,67634,40831115913,62834,56757160699,1500000000,1500000000
70498679848,1649859744,66790,71998679848,61990,75704398772,1500000000,1500000000
17361796632,1647237858,60838,18861796632,56038,22914514982,1500000000,1500000000
25616643054,1647699555,67646,27116643054,62846,30554541173,1500000000,1500000000
39316115587,1647725004,66790,40816115587,66790,52702793078,1500000000,1500000000
31167307841,1647650527,324816,32667307841,324816,41420220299,1500000000,1500000000
59925591927,1649783545,67646,61335591927,62846,63197317584,1410000000,1410000000
28297612719,1649760049,48651,29797612719,43851,32944770208,1500000000,1500000000
35530314193,1649768398,63200,37030314193,63200,74498121076,1500000000,1500000000
70331491391,1650822513,331179,71831491391,331179,73148704510,1500000000,1500000000
36989982139,1650806682,340077,38489982139,340077,44406359764,1500000000,1500000000
44583814403,1649884599,49583,46083814403,49583,48948365275,1500000000,1500000000
14644198734,1647256921,67634,15970929910,62834,15970929910,1500000000,1326731176
20499551477,1647246435,60850,21999551477,60850,30038904578,1500000000,1500000000
18675535531,1647232391,309285,20175535531,292185,26544119897,1500000000,1500000000
38107638144,1644802671,333714,42101728471,333714,,,
49728527169,1649790871,49583,51228527169,44783,67024622309,1500000000,1500000000
33425093952,1649732065,317877,34925093952,317877,45644892112,1500000000,1500000000
29702802349,1650794066,67646,31202802349,62846,39295951085,1500000000,1500000000
28456483333,1649867866,54724,29956483333,49924,32200000000,1500000000,1500000000
90768856691,1644857620,66730,92268856691,61930,102721162794,1500000000,1500000000
35892501716,1649766345,67634,37567221732,62834,,,
29547551504,1647271834,67634,31047551504,67634,33152258819,1500000000,1500000000
15214903850,1647259109,313584,15478185090,313584,15478185090,1500000000,263281240
35186579752,1647705996,60850,36686579752,60850,40167609955,1500000000,1500000000
31448550322,1649813875,60862,32948550322,56062,45941182092,1500000000,1500000000
24277141193,1649828950,55680,26277141193,50880,37533731932,2000000000,2000000000
42996749705,1649726768,67634,44496749705,67634,57425901329,1500000000,1500000000
44425375966,1649763477,55644,45925375966,55644,51369596062,1500000000,1500000000
19534198144,1650789837,317254,21034198144,317254,26381037127,1500000000,1500000000
36728425965,1649875389,67622,38228425965,67622,52009176505,1500000000,1500000000
13339553772,1647255612,67634,14839553772,67634,19083471942,1500000000,1500000000
18978594487,1650787651,329260,20478594487,329260,26422597765,1500000000,1500000000
37904119772,1649838240,54736,39404119772,54736,40246399389,1500000000,1500000000
15119034274,1647255441,66718,16619034274,61918,18718760222,1500000000,1500000000
21869629799,1647721660,55592,23369629799,50792,24000000000,1500000000,1500000000
38074109023,1649732804,60850,40074109023,56050,49431874583,2000000000,2000000000
40189001343,1649802340,60950,41689001343,56150,46867598082,1500000000,1500000000
55949024408,1650819700,67634,57449024408,62834,64097216497,1500000000,1500000000
21800728930,1647266358,67634,23300728930,67634,26068158985,1500000000,1500000000
52867197291,1650816998,60926,54367197291,60926,55749839144,1500000000,1500000000
31460269652,1649829728,66742,32460269652,61942,44000000000,1000000000,1000000000
28863003405,1647704956,60862,30363003405,56062,42929460975,1500000000,1500000000
22887825792,1647660715,67634,24387825792,58034,35594655692,1500000000,1500000000
48607972230,1649776154,60862,50607972230,56062,65843025328,2000000000,2000000000
34073175624,1649848984,67634,35573175624,62834,40214235553,1500000000,1500000000
34888168747,1649813265,67634,36388168747,62834,50829910979,1500000000,1500000000
31517880331,1649836622,54712,33517880331,49912,36810301411,2000000000,2000000000
29613077018,1647269858,52928,31113077018,48128,37314864370,1500000000,1500000000
19945248149,1647261361,307845,21445248149,307845,23661889990,1500000000,1500000000
21747114454,1647687336,67622,23247114454,67622,31238420475,1500000000,1500000000
54266293468,1649790909,331187,55766293468,331187,70214724207,1500000000,1500000000
25908807571,1649833782,64729,27408807571,59929,33106348165,1500000000,1500000000
34716575631,1644849257,319518,36216575631,319518,41263265548,1500000000,1500000000
29972195803,1649803013,67634,31472195803,67634,43000000000,1500000000,1500000000
29389436132,1649844427,66754,31389436132,61954,33000000000,2000000000,2000000000
44049886223,1649874345,60850,45549886223,56050,63716416953,1500000000,1500000000
12944771095,1647237097,60850,14444771095,60850,16051550958,1500000000,1500000000
27432101266,1644838224,330469,28932101266,330469,30024816102,1500000000,1500000000
27432101266,1644838224,67634,28932101266,67634,30024816102,1500000000,1500000000
35363237207,1649793324,67634,36863237207,67634,41390909249,1500000000,1500000000
32494323034,1649762035,55717,33994323034,50917,39379006047,1500000000,1500000000
46219895914,1649880641,59970,47719895914,55170,64517770934,1500000000,1500000000
28838599063,1649848518,66742,30338599063,66742,35631387909,1500000000,1500000000
28838599063,1649848518,66742,30338599063,66742,41014387952,1500000000,1500000000
28838599063,1649848518,66742,30338599063,66742,34259301939,1500000000,1500000000
29239675109,1649840372,56600,30739675109,51800,39717373318,1500000000,1500000000
32099609446,1649787212,67646,33599609446,62846,43731967895,1500000000,1500000000
49195290235,1649723912,319799,50695290235,319799,57032805535,1500000000,1500000000
50871709036,1649764743,60950,52871709036,56150,54258511707,2000000000,2000000000
25552671858,1647275846,66730,27052671858,61930,36075619779,1500000000,1500000000
33022021837,1649735011,334368,35022021837,334368,50000000000,2000000000,2000000000
16125090739,1647249495,314168,17625090739,314168,25827929564,1500000000,1500000000
57737281412,1650820241,67646,59737281412,62846,101048835655,2000000000,2000000000
53793427796,1644808498,67634,55293427796,67634,69724550874,1500000000,1500000000
36515851184,1649744105,55580,41021277378,50780,,,
38427330878,1649824402,67734,40427330878,58134,51803038374,2000000000,2000000000
27588921464,1649819203,320362,29088921464,320362,36098415122,1500000000,1500000000
44121910727,1650818661,334338,45621910727,334338,56216125954,1500000000,1500000000
37961677802,1649845199,56588,39461677802,51788,49913784000,1500000000,1500000000
21017471204,1647662658,67634,22517471204,67634,31267258520,1500000000,1500000000
30585928475,1649756382,67646,32085928475,62846,45194183535,1500000000,1500000000
39431095768,1649770480,60850,40931095768,60850,54244223604,1500000000,1500000000
20273143595,1650773118,101451,23000000000,62834,,,
27007026834,1649833861,67634,28507026834,67634,31712641754,1500000000,1500000000
47580272573,1649884631,64793,49080272573,64793,54871450419,1500000000,1500000000
43455247798,1649739158,67634,44955247798,62834,52384532899,1500000000,1500000000
32891869484,1649838610,346995,34391869484,260871,49547199943,1500000000,1500000000
60376173742,1649783102,60030,61876173742,55230,72397005437,1500000000,1500000000
60376173742,1649783102,67634,61876173742,67634,68405755403,1500000000,1500000000
33759165867,1650826749,67634,35259165867,67634,51374817797,1500000000,1500000000
28646019798,1649840530,59946,30146019798,59946,37253235633,1500000000,1500000000
43005497669,1649806066,122053,44505497669,117253,51105432852,1500000000,1500000000
32775293629,1649744737,336885,34275293629,336885,48736947278,1500000000,1500000000
32775293629,1649744737,55592,34295293629,50792,52000000000,1520000000,1520000000
15729764144,1650788113,333710,17229764144,333710,18769111009,1500000000,1500000000
36493284715,1649836849,63188,37993284715,63188,66387613004,1500000000,1500000000
56966224186,1649810818,67622,58466224186,67622,85490652684,1500000000,1500000000
17291752668,1647233529,52940,18791752668,48140,19263901373,1500000000,1500000000
19575789761,1647223798,335208,20985789761,335208,21907050832,1410000000,1410000000
35509671111,1649741873,64741,40509671111,59941,100000000000,5000000000,5000000000
19939900865,1650768782,55592,21439900865,50792,29211298212,1500000000,1500000000
24922930496,1650760943,334308,26116250964,334308,26116250964,1500000000,1193320468
24470557605,1649817908,328222,25970557605,328222,30723388740,1500000000,1500000000
17636878166,1647247141,307096,19136878166,307096,22029212107,1500000000,1500000000
47299693970,1644811891,333676,48799693970,333676,60298671207,1500000000,1500000000
41668652510,1649806729,67622,43168652510,67622,45852690372,1500000000,1500000000
44400708069,1649722362,66838,47400708069,66838,60851840102,3000000000,3000000000
54711260464,1649773055,60862,56211260464,56062,56278741592,1500000000,1500000000
30485862003,1649760822,320469,31704347294,320469,31704347294,1500000000,1218485291
26303831247,1649763884,322965,27803831247,322965,35768638939,1500000000,1500000000
24114217284,1649760942,307738,27902645092,307738,,,
53838434550,1649877310,60006,55338434550,55206,79010589309,1500000000,1500000000
35390831232,1649822068,67734,36890831232,62934,38400918230,1500000000,1500000000
19716943760,1647232275,312421,21216943760,312421,26814407830,1500000000,1500000000
15779505972,1647243489,334346,17279505972,334346,22888138565,1500000000,1500000000
43505307637,1644836498,64729,45005307637,59929,59458963187,1500000000,1500000000
70931560320,1649776256,55704,72431560320,55704,79698141392,1500000000,1500000000
32694380831,1649730557,60950,34194380831,56150,45006678573,1500000000,1500000000
59628547854,1649783448,60850,61128547854,56050,70101784824,1500000000,1500000000
22140408508,1650771944,67658,23640408508,62858,31192122148,1500000000,1500000000
41114441092,1649864478,52384,42614441092,47584,57162687574,1500000000,1500000000
58221271551,1647286499,343225,59721271551,343225,73811645507,1500000000,1500000000
84490559835,1644877170,56705,85990559835,51905,111385329609,1500000000,1500000000
38762011338,1647280414,298446,40262011338,298446,47035905177,1500000000,1500000000
13480930882,1647685192,60950,14980930882,56150,16365608257,1500000000,1500000000
63424766936,1649772179,48651,64924766936,43851,76420406840,1500000000,1500000000
44902393970,1649883486,66742,46402393970,61942,263206190149,1500000000,1500000000
21091842197,1647246550,301408,22591842197,301408,29014485504,1500000000,1500000000
20269777151,1647232389,318728,21769777151,318728,26544119897,1500000000,1500000000
41055519931,1649768389,64741,42555519931,59941,49890789194,1500000000,1500000000
32180702640,1649758049,60862,33680702640,56062,41812150817,1500000000,1500000000
17913157932,1650761593,67634,19413157932,67634,25924591873,1500000000,1500000000
20446412027,1647671424,331183,21946412027,331183,27200084868,1500000000,1500000000
36147928933,1649744545,67634,38147928933,67634,52024328318,2000000000,2000000000
21664147294,1647246506,317875,23164147294,317875,28185355975,1500000000,1500000000
34067918726,1649849287,64717,35567918726,59917,44198957999,1500000000,1500000000
33666331991,1649729724,319751,35166331991,319751,55150641913,1500000000,1500000000
33666331991,1649729724,319761,35166331991,319761,55150641913,1500000000,1500000000
49395062525,1649769109,60950,50895062525,60950,56012270222,1500000000,1500000000
35003292558,1650807384,322939,36503292558,322939,46629283862,1500000000,1500000000
36993552598,1649848251,66850,38493552598,62050,48620957755,1500000000,1500000000
28770954331,1649824484,60862,30270954331,56062,38577900065,1500000000,1500000000
17351866450,1647259574,55580,18851866450,50780,21030598082,1500000000,1500000000
21056201369,1647710741,322498,22556201369,322498,30636286769,1500000000,1500000000
21056201369,1647710741,331139,22556201369,331139,30636286769,1500000000,1500000000
18386952459,1647692659,67646,19886952459,62846,25574187248,1500000000,1500000000
20466986098,1650776733,343831,20942079552,343831,20942079552,1410000000,475093454
31255124426,1649853305,60030,32755124426,55230,37143298769,1500000000,1500000000
32791667367,1649816137,340063,34291667367,340063,40720578640,1500000000,1500000000
46442669807,1644846524,323559,47942669807,323559,74652351627,1500000000,1500000000
15949498367,1647699010,52940,17449498367,52940,18935509480,1500000000,1500000000
20240534391,1650766975,60850,21740534391,56050,31672609109,1500000000,1500000000
17940664620,1647243614,60862,19440664620,56062,23002669737,1500000000,1500000000
22689544574,1647248263,60862,24189544574,56062,26717731240,1500000000,1500000000
40962234462,1647724985,302729,42462234462,302729,50951580938,1500000000,1500000000
54038984331,1649800889,67646,55538984331,62846,72305081194,1500000000,1500000000
37853798411,1649849420,66754,39353798411,61954,46856582870,1500000000,1500000000
22038079275,1647228058,67646,23538079275,62846,36655014563,1500000000,1500000000
22559391722,1647708091,327930,23736020135,327930,23736020135,1325400000,1176628413
42015400762,1649790348,60862,43515400762,56062,45637700313,1500000000,1500000000
23616638405,1650765040,60850,25116638405,56050,31550097630,1500000000,1500000000
18713632597,1647244350,312367,20213632597,312367,26350345374,1500000000,1500000000
40532825534,1649771748,65518,42032825534,60718,52977874288,1500000000,1500000000
18475516258,1647247099,324820,19975516258,324820,22368359037,1500000000,1500000000
58106239468,1649722500,48603,59606239468,48603,64701182913,1500000000,1500000000
35192732834,1649849400,67646,36692732834,62846,44666044307,1500000000,1500000000
25363952784,1647710265,66778,26863952784,61978,37156131358,1500000000,1500000000
13808109380,1647690348,59958,15308109380,55158,23176666704,1500000000,1500000000
31428852448,1649752235,60315,32928852448,60315,35461931768,1500000000,1500000000
43699483792,1650813347,55592,45199483792,50792,46703857243,1500000000,1500000000
17801244632,1650773929,60838,19301244632,60838,27265942447,1500000000,1500000000
42020689583,1649859047,67646,43960689583,62846,48035901294,1940000000,1940000000
28130391719,1649843895,55592,31968081293,50792,,,
106405651293,1649780548,54712,107905651293,49912,156722844154,1500000000,1500000000
32007197718,1649725660,60862,33507197718,56062,42144388404,1500000000,1500000000
21716112310,1650772634,54849,23216112310,50049,28275199705,1500000000,1500000000
55395323732,1649851449,64741,60395323732,59941,200000000000,5000000000,5000000000
29199904194,1649848495,60838,30699904194,56038,38770274883,1500000000,1500000000
17118543023,1647250359,67634,18618543023,62834,26296624039,1500000000,1500000000
127137563605,1644865951,335795,128656571353,335795,164775787113,1519007748,1519007748
57579051638,1649784157,67646,59079051638,62846,60808794963,1500000000,1500000000
19235053470,1647670059,64044,20274585456,59244,20274585456,1130702221,1039531986
47482523934,1649782791,67722,48982523934,62922,58020817585,1500000000,1500000000
40207354841,1649845864,60838,50207354841,60838,80000000000,10000000000,10000000000
22173633329,1647266140,299692,23673633329,299692,29805689390,1500000000,1500000000
14794529197,1647250826,318728,16294529197,318728,23870864715,1500000000,1500000000
27679921501,1649759575,322458,29179921501,322458,32637244000,1500000000,1500000000
31585743028,1649740749,60938,33085743028,56138,37820266159,1500000000,1500000000
25700959650,1650768041,48615,27200959650,43815,33542195874,1500000000,1500000000
28909475192,1649731221,67634,30409475192,62834,42799250274,1500000000,1500000000
29179643244,1650801032,55693,30679643244,50893,38555519213,1500000000,1500000000
28556598449,1647277653,327423,42000000000,327423,,,
41396008034,1650831474,343217,42896008034,343217,47501836067,1500000000,1500000000
29056881690,1649830912,67622,30556881690,62822,40151470428,1500000000,1500000000
30618026159,1649744242,59958,32118026159,55158,40966093155,1500000000,1500000000
53509989184,1650823205,67646,55009989184,62846,73561245532,1500000000,1500000000
37026949269,1649824385,67646,38526949269,62846,50046367809,1500000000,1500000000
55482678951,1647730722,60850,56982678951,56050,68135577488,1500000000,1500000000
37412605384,1644804235,52928,38912605384,48128,46895970073,1500000000,1500000000
44083566482,1649769427,55636,45583566482,55636,96628464698,1500000000,1500000000
44083566482,1649769427,56516,46283566482,51716,60955290437,2200000000,2200000000
29142177695,1649737204,67646,30642177695,62846,33889918980,1500000000,1500000000
29356949882,1649792592,49571,30856949882,49571,38798117499,1500000000,1500000000
17123402370,1650770589,320481,18623402370,320481,23638983547,1500000000,1500000000
19622033733,1650788595,337687,21122033733,337687,23696102698,1500000000,1500000000
23508504400,1650796225,340039,25008504400,340039,26157311090,1500000000,1500000000
22647142789,1650840444,67634,24147142789,62834,29093862109,1500000000,1500000000
63166413799,1649863608,67646,64666413799,62846,90896084320,1500000000,1500000000
33146913255,1649827058,60938,34646913255,56138,36922267438,1500000000,1500000000
52143631351,1649879722,332400,53154244886,332400,53935492754,1010613535,1010613535
31632071007,1649745570,48615,33132071007,48615,42829952892,1500000000,1500000000
37610111853,1649813770,67634,39110111853,62834,49551866178,1500000000,1500000000
31164565708,1647288134,332596,32664565708,332596,42896640183,1500000000,1500000000
40179149574,1650824802,350131,41679149574,350131,62629936873,1500000000,1500000000
20239235073,1650775874,66754,21739235073,66754,30016826042,1500000000,1500000000
81473507103,1649863721,67646,82973507103,62846,101428197508,1500000000,1500000000
37338719802,1649819934,67634,38838719802,62834,52591949428,1500000000,1500000000
79610830830,1649866604,55720,81436176830,50920,200000000000,1825346000,1825346000
31741607556,1650802729,67734,33241607556,62934,33457853132,1500000000,1500000000
31797939183,1649731335,59982,33297939183,59982,34808099645,1500000000,1500000000
19523978816,1650777072,60862,21023978816,56062,24995771605,1500000000,1500000000
33131434930,1650825884,340031,34631434930,340031,47728210454,1500000000,1500000000
41308585204,1649877716,346442,42808585204,346442,45598668155,1500000000,1500000000
74366781002,1649877219,64741,75866781002,59941,82048488500,1500000000,1500000000
36245503946,1647709167,48663,37745503946,43863,42623498565,1500000000,1500000000
20369739880,1647716659,67646,21869739880,62846,22526928108,1500000000,1500000000
52919443002,1649773153,67734,54419443002,62934,60943543893,1500000000,1500000000
32320635071,1649761413,52580,33820635071,47780,37674004308,1500000000,1500000000
38463488418,1650836244,336907,39963488418,336907,48298718059,1500000000,1500000000
45217399861,1649882092,66754,46717399861,61954,64338956614,1500000000,1500000000
45217399861,1649882092,67722,46717399861,62922,64338956614,1500000000,1500000000
24115576562,1647253040,67634,25615576562,62834,30219617605,1500000000,1500000000
25749375669,1647719932,60850,27249375669,60850,32907311782,1500000000,1500000000
68030999173,1649775484,64741,88030999173,59941,200000000000,20000000000,20000000000
45671394500,1649738565,321596,47171394500,321596,49154521340,1500000000,1500000000
47263486527,1650810819,343223,48763486527,343223,64953605047,1500000000,1500000000
22189493192,1650791189,67646,23689493192,62846,24611298517,1500000000,1500000000
25423888144,1649815138,317198,26923888144,317198,33135968447,1500000000,1500000000
35376354299,1649831880,66730,37376354299,61930,49130857295,2000000000,2000000000
57223521572,1644852327,343173,58723521572,343173,72852905917,1500000000,1500000000
35971627899,1644806365,332007,36971627899,332007,46974008023,1000000000,1000000000
18674612321,1647721745,67634,20174612321,62834,26255266050,1500000000,1500000000
27351298578,1649841638,317218,28851298578,317218,37357267973,1500000000,1500000000
27351298578,1649841638,60850,28851298578,56050,42344397092,1500000000,1500000000
39850929807,1649841941,336887,41350929807,336887,51448718034,1500000000,1500000000
39850929807,1649841941,67646,41350929807,62846,53084065702,1500000000,1500000000
45013381767,1649864096,338756,45672287114,338756,45672287114,1000000000,658905347
27201994889,1647298030,317336,28701994889,317336,30728813305,1500000000,1500000000
38060136461,1650814516,67646,39560136461,62846,48310917828,1500000000,1500000000
37015963557,1650833357,67646,38515963557,62846,49646267640,1500000000,1500000000
28837538899,1649751358,56516,30337538899,51716,32998901582,1500000000,1500000000
36104844796,1649818607,60862,37604844796,56062,41254146460,1500000000,1500000000
29281391494,1647702573,67634,29546373221,62834,29546373221,1000000000,264981727
36666930063,1649768095,330511,38166930063,330511,48486878169,1500000000,1500000000
65935037757,1649776068,67722,67396175073,62922,67396175073,1500000000,1461137316
27606337450,1649831530,316604,29106337450,316604,34165526528,1500000000,1500000000
28037016485,1650792048,317246,29537016485,317246,38568553757,1500000000,1500000000
42698586526,1649873209,60938,44198586526,56138,64019849022,1500000000,1500000000
25042014197,1649831551,60850,26542014197,60850,36273803602,1500000000,1500000000
65763134499,1649809115,67634,67263134499,62834,76723590132,1500000000,1500000000
14801282192,1647251293,55580,16301282192,50780,22457391988,1500000000,1500000000
16861830837,1647259607,67634,18361830837,67634,24325731608,1500000000,1500000000
32893099719,1649802965,326036,34393099719,326036,50234737559,1500000000,1500000000
46730001031,1649777230,60042,48230001031,60042,65938942078,1500000000,1500000000
36385354868,1649760248,317306,37885354868,317306,43418745734,1500000000,1500000000
21469192834,1650766937,67646,23119192834,62846,26000000000,1650000000,1650000000
38157818148,1649853459,64741,49157818148,59941,200000000000,11000000000,11000000000
29629056086,1649852586,67646,31129056086,67646,34282809207,1500000000,1500000000
17648349082,1647684013,60838,19148349082,60838,25846524277,1500000000,1500000000
51207903382,1649786516,60862,52707903382,56062,59845608329,1500000000,1500000000
48673931085,1650829579,67634,50173931085,62834,56995184802,1500000000,1500000000
39759052143,1649813482,60850,41259052143,60850,51872873184,1500000000,1500000000
55401632655,1647648323,63188,56901632655,63188,89065846368,1500000000,1500000000
66433213013,1649782944,60938,68433213013,56138,79975106813,2000000000,2000000000
37130968489,1650832041,67646,38630968489,62846,48171321509,1500000000,1500000000
54352248301,1650824204,67634,55628836484,62834,55628836484,1500000000,1276588183
36423890096,1650839635,60950,37923890096,56150,38993202337,1500000000,1500000000
57092460438,1649866995,55668,58592460438,55668,89101760329,1500000000,1500000000
26415228844,1649822872,334328,27915228844,334328,42467055313,1500000000,1500000000
50582904833,1649858348,63200,52082904833,63200,102352051032,1500000000,1500000000
46771808046,1647286084,60862,48271808046,56062,75136925034,1500000000,1500000000
34705146776,1647298573,60850,36205146776,60850,44755760814,1500000000,1500000000
23706345471,1647230100,317871,25206345471,317871,28959266657,1500000000,1500000000
24859385007,1647699450,52916,26359385007,48116,29812724808,1500000000,1500000000
26408805036,1647711372,60850,27908805036,56050,37391743474,1500000000,1500000000
17828239352,1647253561,55705,19000000000,50905,,,
28285643451,1649886390,67734,29785643451,62934,133108021214,1500000000,1500000000
19966480900,1647671987,334340,21466480900,334340,30388202072,1500000000,1500000000
20547875892,1650792324,60862,22047875892,56062,27691167038,1500000000,1500000000
41892801132,1650832872,67634,43392801132,62834,44870905664,1500000000,1500000000
10798343270,1647257257,66718,12298343270,61918,19223850735,1500000000,1500000000
28389998336,1650839292,67634,29889998336,62834,37220886499,1500000000,1500000000
12762375301,1647237124,55592,14262375301,50792,17457260175,1500000000,1500000000
43379212739,1650831378,67634,44879212739,62834,53455191032,1500000000,1500000000
43379212739,1650831378,322949,44879212739,322949,53455191032,1500000000,1500000000
41176580059,1650836367,67634,42676580059,62834,46366149115,1500000000,1500000000
24942627206,1644827768,299384,26442627206,299384,34966513907,1500000000,1500000000
49160600994,1650813381,67646,50660600994,62846,55473277457,1500000000,1500000000
56736396981,1649892725,328843,65597754790,328843,,,
33719334188,1649843670,67634,35719334188,67634,47315831090,2000000000,2000000000
45210433893,1649874949,67658,46710433893,62858,51735604683,1500000000,1500000000
52599576908,1644843165,334274,54099576908,334274,62268199254,1500000000,1500000000
17035963683,1650798149,67634,18535963683,62834,23210521485,1500000000,1500000000
18946991368,1650789145,67646,20446991368,62846,24846855375,1500000000,1500000000
35961741261,1649840660,66766,37461741261,66766,51317868397,1500000000,1500000000
36805500771,1649815348,326121,38305500771,326121,50704046328,1500000000,1500000000
41614769509,1649874393,323575,43114769509,323575,59514950438,1500000000,1500000000
45107847061,1649779453,60850,46107847061,56050,50000000000,1000000000,1000000000
44764387545,1649739656,54676,46264387545,49876,47897053607,1500000000,1500000000
28614527028,1649757224,56516,30614527028,51716,38100886080,2000000000,2000000000
53435076556,1649788506,60850,54935076556,56050,57167366062,1500000000,1500000000
22159979378,1650772708,67646,23659979378,62846,28645140388,1500000000,1500000000
29734176062,1650767903,66802,31234176062,62002,38787527893,1500000000,1500000000
29079092995,1650839721,91293,35000000000,56062,,,
28268162039,1644836837,334286,29846316317,334286,,,
48983887460,1644852262,323545,50483887460,323545,61493180309,1500000000,1500000000
28988192784,1649757046,54747,30488192784,49947,43445173217,1500000000,1500000000
50453411628,1649772341,336883,51953411628,336883,63668196218,1500000000,1500000000
50157798689,1649791320,64741,51657798689,59941,59734845613,1500000000,1500000000
31396465838,1650807991,60850,32896465838,56050,44327073545,1500000000,1500000000
35923698275,1649847943,60950,37423698275,56150,51334370549,1500000000,1500000000
30433335685,1649838464,346995,32834335685,329895,46757313897,2401000000,2401000000
32621244039,1649758586,60950,34121244039,56150,41748365417,1500000000,1500000000
47033456816,1649724581,55648,48533456816,55648,96955234960,1500000000,1500000000
18044149869,1650789233,67646,19544149869,62846,23916637294,1500000000,1500000000
37615098059,1649823887,67634,39115098059,62834,45657278049,1500000000,1500000000
60377462172,1649885288,49583,61877462172,49583,79022548170,1500000000,1500000000
23348652983,1649760650,340059,25000000000,340059,25000000000,16500000000,1651347017
31484651281,1650833489,67634,32984651281,62834,36674534545,1500000000,1500000000
49191867242,1650831075,67634,50691867242,62834,57285666868,1500000000,1500000000
69166520285,1650809654,60938,70666520285,60938,91496870090,1500000000,1500000000
57989745614,1649858480,60850,59489745614,56050,64278611037,1500000000,1500000000
34346237101,1649725745,322955,35846237101,322955,39009129479,1500000000,1500000000
40005054868,1649729790,60862,41505054868,56062,43582914989,1500000000,1500000000
51837078823,1650830897,67634,53337078823,67634,59097232945,1500000000,1500000000
37657775675,1649874151,55668,39157775675,55668,50284425657,1500000000,1500000000
21935085502,1649818973,337484,23435085502,337484,30400300005,1500000000,1500000000
70280968862,1649727431,60862,71780968862,56062,84037252664,1500000000,1500000000
36335450899,1649757876,64741,37835450899,59941,42111686523,1500000000,1500000000
36189590860,1649838638,55592,37689590860,50792,41720054897,1500000000,1500000000
29512249140,1647274175,304676,31012249140,304676,41675617282,1500000000,1500000000
30427418038,1649803519,67734,31927418038,62934,39150606919,1500000000,1500000000
31036438001,1650829374,67634,32536438001,62834,54968452690,1500000000,1500000000
24251647381,1650765284,67646,25751647381,62846,28373627693,1500000000,1500000000
21989280509,1647713391,322482,23352856659,322482,23352856659,1410000000,1363576150
28939203446,1649761353,60850,30439203446,56050,32440043432,1500000000,1500000000
56493075539,1649795164,60862,57993075539,56062,58154390090,1500000000,1500000000
31878564479,1650838576,60862,32878564479,56062,35000000000,1000000000,1000000000
31878564479,1650838576,67658,32878564479,62858,35000000000,1000000000,1000000000
25483439243,1647240239,60862,26983439243,56062,29830824422,1500000000,1500000000
89127889916,1644877654,52928,90627889916,48128,108735132768,1500000000,1500000000
26374566976,1649759720,320392,27874566976,320392,31271211700,1500000000,1500000000
39645380332,1649838857,67722,41145380332,67722,52855845602,1500000000,1500000000
39645380332,1649838857,54748,41645380332,49948,51140877016,2000000000,2000000000
37675699085,1649839016,384065,39175699085,384065,43041572773,1500000000,1500000000
38606604387,1649889781,67634,39606604387,62834,40000000000,1000000000,1000000000
35356133912,1647298862,66790,36856133912,61990,44163095768,1500000000,1500000000
31918487683,1644838789,322963,33418487683,322963,39732296503,1500000000,1500000000
25438026402,1649761255,60850,27438026402,60850,36226856265,2000000000,2000000000
20181555869,1650764490,66766,21681555869,61966,31663690474,1500000000,1500000000
22733483929,1650789900,317254,24233483929,241849,27758357029,1500000000,1500000000
35888371154,1647301111,66790,37388371154,61990,37917164304,1500000000,1500000000
33460472378,1644797863,336227,34960472378,336227,48418681649,1500000000,1500000000
60249797248,1649787826,60926,61749797248,56126,72045602872,1500000000,1500000000
34385938043,1647299344,60862,35885938043,56062,52787572917,1500000000,1500000000
36959269627,1644814733,54739,38459269627,49939,46765716258,1500000000,1500000000
26256162858,1649749542,323644,27906162858,323644,28600000000,1650000000,1650000000
21674089598,1650799735,326103,23174089598,326103,30070540344,1500000000,1500000000
23312097527,1650774519,59946,24812097527,55146,27405531495,1500000000,1500000000
28088638556,1649840322,59970,29588638556,55170,35185812804,1500000000,1500000000
50239201203,1649855960,55693,51739201203,50893,57325064199,1500000000,1500000000
55121488562,1647286435,67646,56621488562,62846,77227556428,1500000000,1500000000
20911176093,1647228089,60874,22411176093,56074,29047599094,1500000000,1500000000
55174503952,1649778747,60862,56674503952,56062,100000000000,1500000000,1500000000
24378069949,1650766065,346993,25878069949,346993,26519228102,1500000000,1500000000
24849433772,1647662410,67634,26349433772,67634,28627987812,1500000000,1500000000
25100260710,1649817991,67722,26600260710,67722,32462705170,1500000000,1500000000
27033389570,1647657570,316608,28533389570,316608,37470002143,1500000000,1500000000
36899556667,1649844571,60838,38399556667,60838,53389883435,1500000000,1500000000
58925776639,1644880668,67634,60425776639,62834,80245198825,1500000000,1500000000
46453298705,1649733687,67722,47953298705,62922,54038255228,1500000000,1500000000
20889460075,1650785698,334320,22389460075,334320,23315219520,1500000000,1500000000
38722721361,1649842664,52372,40222721361,47572,51606668968,1500000000,1500000000
22568469368,1647671697,67646,24068469368,62846,24748593218,1500000000,1500000000
42487265151,1649892880,54748,43987265151,49948,71066703679,1500000000,1500000000
42487265151,1649892880,64741,43987265151,59941,71066703679,1500000000,1500000000
32879296517,1649817038,336845,34379296517,336845,40039131200,1500000000,1500000000
65243770778,1649866724,67646,66826987076,62846,81149350817,1583216298,1583216298
20196768780,1647721612,67634,21696768780,67634,30891686453,1500000000,1500000000
86719513477,1649862350,56516,88219513477,51716,97872485728,1500000000,1500000000
18606003361,1647232349,310975,20106003361,310975,28832555482,1500000000,1500000000
77263691712,1644870636,55620,78763691712,50820,87987821928,1500000000,1500000000
20941171333,1647675715,333716,22441171333,333716,22912820960,1500000000,1500000000
47408429780,1650824687,66718,48908429780,66718,68299624453,1500000000,1500000000
26911273169,1649820465,323624,28411273169,323624,37045161968,1500000000,1500000000
72421313638,1649863668,343213,80942558006,343213,,,
31041673329,1644824366,317304,32541673329,317304,40919643134,1500000000,1500000000
49714569884,1649851265,64741,61714569884,59941,350000000000,12000000000,12000000000
21267921783,1647229784,329438,21417088143,329438,,,
33280598331,1647297604,60006,34780598331,55206,34904358063,1500000000,1500000000
55439594641,1649809924,60018,56939594641,55218,90779898107,1500000000,1500000000
29224921305,1649818086,340059,30724921305,340059,37821977404,1500000000,1500000000
24604515459,1650787243,67710,26104515459,67710,30648247308,1500000000,1500000000
24855081140,1649819443,340657,26355081140,340657,34237313417,1500000000,1500000000
29344252942,1650840847,60838,30844252942,60838,40410635669,1500000000,1500000000
40783986920,1649890195,66730,42433986920,61930,53523511089,1650000000,1650000000
36643083464,1649839322,60850,38143083464,56050,46588588898,1500000000,1500000000
51681717906,1649850371,60850,53681717906,60850,60651749080,2000000000,2000000000
47400256769,1649765203,67634,48900256769,62834,60555948454,1500000000,1500000000
47909533606,1649783710,59970,49409533606,55170,62983712407,1500000000,1500000000
38480107455,1650806460,48579,39980107455,48579,46252046602,1500000000,1500000000
24422551914,1650800246,60850,25922551914,60850,31412235903,1500000000,1500000000
22386857017,1647708395,330549,30000000000,330549,,,
20403158971,1650799338,337474,21903158971,337474,29093016698,1500000000,1500000000
33618873493,1647228748,60850,34705869303,60850,34705869303,1500000000,1086995810
26945236514,1649760402,60850,28445236514,56050,36379400492,1500000000,1500000000
48130363687,1650826504,67634,49630363687,62834,51909088440,1500000000,1500000000
28973362495,1650807575,317246,30473362495,317246,40277245094,1500000000,1500000000
34357770524,1644824389,60838,35857770524,60838,35992187743,1500000000,1500000000
14991652203,1647688779,60862,16491652203,56062,19739765313,1500000000,1500000000
41381743147,1649747195,64705,42707443928,59905,42707443928,1500000000,1325700781
47475959578,1649770821,67734,48975959578,62934,62366598697,1500000000,1500000000
38561702210,1649734979,323668,39561702210,323668,40674717952,1000000000,1000000000
28934967593,1650790106,343843,30934967593,343843,34914023018,2000000000,2000000000
32406089461,1649806163,64741,33906089461,59941,200000000000,1500000000,1500000000
40470291607,1650811855,67646,41970291607,62846,44169878895,1500000000,1500000000
56127228276,1650818163,67646,57627228276,62846,68135834333,1500000000,1500000000
32606515262,1649842983,67634,34106515262,62834,40734114265,1500000000,1500000000
41912034867,1649874806,66778,43412034867,66778,65846847212,1500000000,1500000000
37700961607,1647295567,60850,39200961607,60850,41583746920,1500000000,1500000000
17853697830,1650768436,67634,19353697830,62834,31452732968,1500000000,1500000000
31932555085,1649814115,331213,33432555085,331213,36312241047,1500000000,1500000000
25003655957,1649834763,64741,35003655957,59941,200000000000,10000000000,10000000000
27348838749,1647222840,55580,28848838749,50780,29154018959,1500000000,1500000000
21463230699,1647265632,55592,22963230699,50792,23498157827,1500000000,1500000000
77414874262,1644871468,60862,78914874262,56062,99889209778,1500000000,1500000000
40155603866,1647658385,320412,41655603866,320412,57329885335,1500000000,1500000000
27269899197,1647660184,67622,28769899197,62822,29844049138,1500000000,1500000000
60286487031,1649778155,67634,61786487031,67634,71506365440,1500000000,1500000000
40931893559,1649769460,60950,42431893559,60950,57006737733,1500000000,1500000000
40931893559,1649769460,60950,42078612438,60950,42078612438,1500000000,1146718879
66998734508,1649866495,63200,68498734508,63200,105773323326,1500000000,1500000000
26202617295,1649829196,340065,28000000000,340065,28000000000,28000000000,1797382705
48299114818,1649871083,66742,50299114818,66742,68936094703,2000000000,2000000000
22503984659,1647670137,55705,24003984659,50905,27531279290,1500000000,1500000000
30176172167,1649748497,55592,30822178990,50792,,,
34182310919,1649854128,60838,35682310919,56038,43480167364,1500000000,1500000000
37461627569,1649838401,343833,39911627569,343833,45632023437,2450000000,2450000000
29904813099,1647725075,55828,31404813099,51028,50660957103,1500000000,1500000000
39187916237,1649811994,55705,40687916237,50905,58097731508,1500000000,1500000000
70237639228,1649773820,55692,71737639228,55692,94980270949,1500000000,1500000000
28302388731,1649756325,303361,29802388731,303361,41677685647,1500000000,1500000000
45094116109,1649771671,49583,46594116109,49583,74401368980,1500000000,1500000000
24291013131,1650798528,305764,25791013131,305764,29161013198,1500000000,1500000000
54717142758,1649869958,67622,56217142758,67622,73547221717,1500000000,1500000000
19932658729,1647228432,67634,21432658729,67634,29201241075,1500000000,1500000000
14219964719,1647250462,334356,16219964719,334356,18347064757,2000000000,2000000000
34302967829,1649745159,55592,35802967829,50792,50582995973,1500000000,1500000000
28898712424,1650804752,323769,30398712424,323769,37228579865,1500000000,1500000000
22575856518,1647668833,67634,23823691125,62834,23823691125,1500000000,1247834607
35142573516,1649748752,60862,40000000000,56062,,,
36601522355,1644836565,320439,38101522355,320439,51352176382,1500000000,1500000000
36212573006,1644814710,60850,37712573006,56050,43844529818,1500000000,1500000000
19400743588,1647674620,66730,20900743588,66730,28492693868,1500000000,1500000000
27769912369,1649757114,64741,47769912369,59941,200000000000,20000000000,20000000000
32718251790,1650836682,336853,34218251790,336853,34826606139,1500000000,1500000000
37629442889,1650813676,101469,52000000000,62846,,,
42375198346,1650826594,60850,43875198346,56050,53972336847,1500000000,1500000000
40168339937,1649724472,55720,41668339937,50920,200000000000,1500000000,1500000000
73921084481,1649809216,67634,75334062977,67634,75334062977,1500000000,1412978496
45673857102,1647654557,60030,47173857102,55230,62041802532,1500000000,1500000000
28798361582,1649764211,64741,30298361582,59941,43190110805,1500000000,1500000000
66525326264,1649776305,60938,68025326264,56138,75424139610,1500000000,1500000000
16019665970,1647687953,67634,17519665970,58034,20000000000,1500000000,1500000000
38260127739,1649743211,55592,42784123749,50792,,,
63742263190,1649775306,64741,65242263190,59941,200000000000,1500000000,1500000000
32575694354,1649803114,312107,34075694354,312107,39216719183,1500000000,1500000000
44837448017,1649782266,67634,46337448017,67634,61623392899,1500000000,1500000000
41190301318,1650829096,67622,42690301318,67622,52996851944,1500000000,1500000000
35742605273,1649853533,60862,40794642708,56062,,,
34220329592,1649833108,320411,35720329592,320411,42574698847,1500000000,1500000000
56014147965,1649883976,49571,57514147965,49571,63444398839,1500000000,1500000000
26183923493,1647279823,60862,28183923493,56062,37020472809,2000000000,2000000000
35894242156,1647296358,67622,37394242156,67622,47809919347,1500000000,1500000000
33352088644,1649764181,60926,34451378192,56126,34451378192,1500000000,1099289548
41388502933,1650827094,67634,42888502933,62834,51241459962,1500000000,1500000000
14628549172,1650780131,67634,16128549172,62834,26913496518,1500000000,1500000000
28355134566,1649846454,320352,29855134566,320352,36232100935,1500000000,1500000000
12874783234,1647235074,340699,14374783234,340699,14499304209,1500000000,1500000000
45062172097,1644846328,60850,46562172097,56050,61951646877,1500000000,1500000000
45062172097,1644846328,55632,46562172097,55632,67712839123,1500000000,1500000000
52821007857,1649767435,55620,54321007857,50820,68841886482,1500000000,1500000000
30997119511,1649837795,54724,32497119511,49924,36200000000,1500000000,1500000000
18182372780,1647232781,55692,19682372780,50892,20000000000,1500000000,1500000000
29281773536,1649751396,63200,30781773536,63200,59175077798,1500000000,1500000000
42302578524,1650825005,67658,43802578524,62858,56760358043,1500000000,1500000000
10595101610,1647254503,55705,12095101610,50905,14284408068,1500000000,1500000000
19417494654,1647672162,65530,20917494654,60730,26728179507,1500000000,1500000000
31027738149,1649803420,59922,32527738149,59922,33366047943,1500000000,1500000000
18884630682,1650791359,67634,20305389425,67634,20305389425,1510000000,1420758743
23499757601,1650800416,55592,24999757601,50792,30555041372,1500000000,1500000000
44458518029,1649872651,60862,46458518029,60862,65925551194,2000000000,2000000000
45495435531,1647295066,55592,46995435531,50792,69399588904,1500000000,1500000000
40281185751,1649732788,50350,41781185751,50350,56593076468,1500000000,1500000000
32279416289,1649832273,64741,42279416289,59941,200000000000,10000000000,10000000000
47464957156,1649838724,60838,49464957156,60838,57252706181,2000000000,2000000000
35737448663,1649853687,67646,36742605273,67646,,,
17588739561,1647264397,317344,19088739561,317344,26794109270,1500000000,1500000000
36810919062,1644820228,320507,38310919062,320507,40440272843,1500000000,1500000000
38294988992,1649790136,67722,40065574612,67722,47131514600,1770585620,1770585620
49674580088,1649865525,60850,51674580088,60850,59408302349,2000000000,2000000000
37530342032,1649769823,336897,39030342032,336897,44723704577,1500000000,1500000000
32642611978,1649849483,341905,34142611978,341905,35000000000,1500000000,1500000000
17103015634,1647691761,54322,18603015634,54322,23931090007,1500000000,1500000000
32797662440,1649792433,320493,34297662440,320493,42991241069,1500000000,1500000000
48535621635,1649797337,67622,50035621635,67622,58230218413,1500000000,1500000000
26310257060,1647278944,67634,27810257060,62834,37751002037,1500000000,1500000000
22479661067,1647675612,66826,23979661067,51832,28597445658,1500000000,1500000000
22479661067,1647675612,66826,23979661067,62026,28597445658,1500000000,1500000000
45527345133,1649723635,340077,47027345133,340077,65697321198,1500000000,1500000000
28994312291,1649731695,60862,29997454192,60862,29997454192,1500000000,1003141901
27631119197,1644834531,54872,29131119197,50072,36719666533,1500000000,1500000000
22869198495,1647687525,67634,24369198495,62834,26201758922,1500000000,1500000000
50267209619,1649724731,337514,51767209619,337514,53289155885,1500000000,1500000000
50267209619,1649724731,336897,51767209619,336897,53289155885,1500000000,1500000000
46025799477,1649875124,60874,47525799477,56074,52049340697,1500000000,1500000000
46025799477,1649875124,330026,47525799477,330026,52528468164,1500000000,1500000000
35281327503,1649818335,340687,36781327503,340687,49010073789,1500000000,1500000000
43050693351,1649841461,60950,44550693351,56150,53056619582,1500000000,1500000000
52602473111,1649891350,49571,54102473111,49571,76271577333,1500000000,1500000000
24124913850,1647281516,304586,25624913850,304586,35311886888,1500000000,1500000000
29598837721,1649805286,67646,31098837721,62846,34693894228,1500000000,1500000000
56071529509,1649867207,60938,57571529509,56138,59383819929,1500000000,1500000000
22518189739,1650804318,55580,24018189739,55580,26523459405,1500000000,1500000000
35486314298,1650816011,91275,41000000000,56050,,,
25308774757,1649815091,55592,26808774757,50792,28000000000,1500000000,1500000000
46028036051,1644848986,66802,47528036051,66802,57141194988,1500000000,1500000000
87769952384,1644870737,60850,89269952384,60850,96425388293,1500000000,1500000000
33637117666,1647726278,67634,35137117666,67634,37584221342,1500000000,1500000000
46152931568,1649765596,56717,47652931568,47117,68118186513,1500000000,1500000000
17848035075,1647690538,327968,19348035075,327968,21507922450,1500000000,1500000000
16540226696,1647683004,327996,18540226696,327996,23857489968,2000000000,2000000000
42217952346,1649789997,60850,44157952346,56050,59520623028,1940000000,1940000000
43069840881,1649786885,67722,44569840881,62922,46521871697,1500000000,1500000000
20615765392,1647225860,60850,21807719009,56050,22614617855,1191953617,1191953617
26035756383,1647225496,60862,27535756383,56062,35435793365,1500000000,1500000000
33138339462,1647732570,67646,34638339462,67646,39797412872,1500000000,1500000000
27388105373,1649754998,60850,28888105373,56050,40625864818,1500000000,1500000000
48013195938,1649778861,55705,49513195938,50905,67305263265,1500000000,1500000000
48013195938,1649778861,55592,53678105326,50792,,,
20419695305,1650763458,67634,21919695305,67634,27610026657,1500000000,1500000000
24137774755,1650775044,329244,25340993110,329244,25340993110,1500000000,1203218355
19165861034,1650791469,67646,20665861034,62846,25434377443,1500000000,1500000000
33201489939,1649836086,66742,34701489939,61942,51042797939,1500000000,1500000000
40616422543,1649818632,67622,42116422543,62822,46631055995,1500000000,1500000000
23018050209,1647230053,323607,23362855285,323607,23362855285,1325400000,344805076
19910644218,1647692487,67646,21410644218,62846,26757487245,1500000000,1500000000
47813029468,1649858898,55705,49313029468,50905,55887797467,1500000000,1500000000
57276959867,1644878632,55644,59776959867,55644,147122921468,2500000000,2500000000
18150711387,1647232648,307179,19650711387,307179,26601864895,1500000000,1500000000
41431324708,1649724585,60926,42931324708,60926,59329811179,1500000000,1500000000
37239970490,1649759178,308553,38739970490,308553,55627796462,1500000000,1500000000
43071913494,1644814086,60850,44571913494,60850,49271819699,1500000000,1500000000
26974343077,1647261739,309245,28288560768,309245,28288560768,1500000000,1314217691
25188278296,1647695763,60850,26688278296,56050,30137011789,1500000000,1500000000
25188278296,1647695763,320483,26688278296,320483,35049761412,1500000000,1500000000
42373593033,1649739352,67646,42781396018,62846,42781396018,1500000000,407802985
10926147194,1647235602,67634,12426147194,62834,18038357215,1500000000,1500000000
64574430296,1644855442,343193,65687850140,254518,65687850140,1500000000,1113419844
64574430296,1644855442,343193,66074430296,254518,100072593685,1500000000,1500000000
64574430296,1644855442,343193,66074430296,343193,108891441148,1500000000,1500000000
27567444599,1650785857,67646,29067444599,62846,31051315369,1500000000,1500000000
73777575751,1649863835,55717,78777575751,50917,200000000000,5000000000,5000000000
29519513775,1649867852,317262,31019513775,317262,35000000000,1500000000,1500000000
31179190984,1644806153,328819,32679190984,328819,42354412614,1500000000,1500000000
46138850103,1650812782,67634,47638850103,67634,61960949189,1500000000,1500000000
22486192922,1647247903,343237,23986192922,343237,29006218778,1500000000,1500000000
19686735403,1647230973,340693,22825294787,340693,,,
16009586670,1647251428,315572,17509586670,315572,19000000000,1500000000,1500000000
49961664226,1649723301,329521,51961664226,329521,67404369738,2000000000,2000000000
63569103941,1650822620,67634,65069103941,62834,82603993985,1500000000,1500000000
34460684472,1650814751,67634,35870684472,62834,37000000000,1410000000,1410000000
66207978655,1649863859,60838,67707978655,56038,87483971107,1500000000,1500000000
32708924780,1649823495,55592,34208924780,50792,36619015439,1500000000,1500000000
47501244120,1649893365,340023,49001244120,340023,54860146663,1500000000,1500000000
12640131838,1647250437,336875,14640131838,336875,19495268284,2000000000,2000000000
21073697951,1647230077,343251,22759213203,343251,,,
37649486681,1649739020,65530,39149486681,60730,48900607983,1500000000,1500000000
15959465012,1650778292,67610,17459465012,67610,22721841769,1500000000,1500000000
36711050420,1649742933,323650,38651050420,323650,38679521383,1940000000,1940000000
42356381661,1650818331,60862,43856381661,56062,51521623664,1500000000,1500000000
40788210458,1650814698,59934,42788210458,55134,49211266671,2000000000,2000000000
30001507936,1644829140,67646,31501507936,62846,42327343445,1500000000,1500000000
43093873622,1649794781,67622,44593873622,67622,46269018448,1500000000,1500000000
61438208353,1649797868,49571,62938208353,49571,79681616244,1500000000,1500000000
61438208353,1649797868,333704,63143911852,333704,116517962515,1705703499,1705703499
28066693856,1649824470,54676,29566693856,49876,46369087648,1500000000,1500000000
68156357581,1649888310,48603,69656357581,43803,80361555323,1500000000,1500000000
62245646888,1649774601,338758,63745646888,338758,78491023113,1500000000,1500000000
24640605876,1647279302,67634,26140605876,62834,34791357215,1500000000,1500000000
30361349527,1649753192,63200,31861349527,63200,69884688844,1500000000,1500000000
49874612673,1650817314,67634,50773396110,62834,50773396110,1500000000,898783437
20509714132,1650779938,67646,22009714132,62846,26636737469,1500000000,1500000000
67095426861,1649808126,51428,68595426861,46628,82566937644,1500000000,1500000000
25964198831,1647262588,55592,27464198831,50792,29775393823,1500000000,1500000000
68421021885,1649775347,67634,70421021885,67634,79475713162,2000000000,2000000000
33226630433,1649792300,49571,34726630433,49571,43396779163,1500000000,1500000000
20553522992,1650771716,67622,22053522992,67622,32861365110,1500000000,1500000000
28273837499,1649754731,60850,29773837499,56050,33197108832,1500000000,1500000000
62156404948,1649727703,326852,63656404948,326852,74289062858,1500000000,1500000000
62523643724,1650821692,67734,64023643724,62934,75680253608,1500000000,1500000000
36410308027,1649884401,333684,37910308027,333684,55010563293,1500000000,1500000000
26678590886,1647675015,67634,28178590886,67634,31195078902,1500000000,1500000000
32362408824,1649824517,66778,33862408824,61978,36583367320,1500000000,1500000000
24476189194,1649831716,60850,25976189194,56050,27000000000,1500000000,1500000000
102187121880,1643781513,54095,103687121880,49295,128773432375,1500000000,1500000000
78350521482,1643806131,331127,79850521482,331127,89141683823,1500000000,1500000000
86601501654,1643797711,52928,88101501654,48128,97735815437,1500000000,1500000000
78724206863,1643809640,343173,80224206863,343173,81000000000,1500000000,1500000000
141826946037,1643772424,393199,155572174399,343199,,,
173027338279,1643763690,60850,174527338279,56050,191521026584,1500000000,1500000000
204815396529,1643829611,60862,206815396529,56062,321495951371,2000000000,2000000000
75391384466,1643794554,60850,76891384466,60850,89913088578,1500000000,1500000000
132972082227,1643816379,307676,134472082227,307676,179787896347,1500000000,1500000000
179994536136,1643834413,64741,181494536136,59941,221914117447,1500000000,1500000000
167293589071,1643824568,55592,169429144113,50792,169429144113,169429144113,2135555042
138915675129,1643845167,343813,140415675129,343813,140544647608,1500000000,1500000000
76464258077,1643791986,67634,77964258077,67634,96233160868,1500000000,1500000000
115525980371,1646093442,60862,117025980371,56062,144116990020,1500000000,1500000000
146299455515,1643052475,314160,147799455515,314160,160724395135,1500000000,1500000000
39696612922,1648985357,67722,41196612922,67722,45545991634,1500000000,1500000000
51246084622,1648968824,67634,52266084622,67634,61072657269,1020000000,1020000000
49523891289,1646175546,54872,51023891289,50072,56529390543,1500000000,1500000000
122743091318,1642997470,337462,124243091318,337462,131692333529,1500000000,1500000000
147252027664,1642987621,334308,148752027664,334308,174465471737,1500000000,1500000000
20616549603,1649558690,48687,22116549603,48687,26700794428,1500000000,1500000000
25884365769,1650281635,54748,27884365769,49948,36603826881,2000000000,2000000000
33779855519,1649597841,316559,35279855519,316559,38353887902,1500000000,1500000000
18936003678,1650275310,60874,20936003678,56074,28098407364,2000000000,2000000000
45160196335,1646019025,319731,46660196335,319731,52152844570,1500000000,1500000000
46841442415,1646123280,59982,48341442415,59982,49267598997,1500000000,1500000000
56464601772,1646108253,55592,57964601772,50792,73460239388,1500000000,1500000000
20309125828,1650286740,48675,21809125828,43875,33123416094,1500000000,1500000000
50812327024,1648968841,54861,52312327024,50061,59013221965,1500000000,1500000000
33315268083,1648966560,60862,34815268083,56062,39510836409,1500000000,1500000000
69254984376,1643015194,331129,70754984376,331129,83920630904,1500000000,1500000000
113705835808,1643020831,337494,115205835808,337494,120000000000,1500000000,1500000000
38339478657,1646012532,310975,39839478657,310975,49621082193,1500000000,1500000000
30665251840,1648960345,67634,32165251840,67634,44211968060,1500000000,1500000000
27569961527,1650253165,60006,29069961527,55206,36919802062,1500000000,1500000000
34497393125,1648956542,67634,35997393125,67634,47243696924,1500000000,1500000000
33048299976,1648993767,55592,34548299976,50792,44616494103,1500000000,1500000000
22436891949,1649587591,60850,23664379762,56050,23664379762,1500000000,1227487813
60088910968,1649608119,67634,61588910968,67634,85703359278,1500000000,1500000000
78896617203,1648918992,66754,80396617203,66754,89163872725,1500000000,1500000000
36516065601,1648886106,316636,38016065601,316636,46873804797,1500000000,1500000000
112150425681,1643039432,340629,113650425681,340629,120685299897,1500000000,1500000000
30947053154,1646126404,60862,32947053154,56062,41724429032,2000000000,2000000000
30947053154,1646126404,63200,33447053154,63200,57531217478,2500000000,2500000000
32950416507,1648966428,64741,34450416507,59941,42703864158,1500000000,1500000000
34359527771,1649610659,67722,35859527771,62922,38906178085,1500000000,1500000000
18171141186,1649589970,319743,19671141186,319743,24205557913,1500000000,1500000000
50825315504,1648916497,60950,52325315504,56150,74392939497,1500000000,1500000000
115343268354,1646093538,307154,116993268354,307154,120000000000,1650000000,1650000000
51083739687,1646150836,55592,52583739687,50792,63824504510,1500000000,1500000000
24507489100,1649561056,59958,26007489100,59958,32632365829,1500000000,1500000000
47005473477,1650299795,316636,48505473477,316636,62507077580,1500000000,1500000000
47005473477,1650299795,54837,48505473477,50037,67038437240,1500000000,1500000000
115809887792,1646081512,63200,118309887792,63200,243771141010,2500000000,2500000000
57179387786,1649604158,332354,59119387786,332354,66247174674,1940000000,1940000000
40687413769,1650242623,67634,42187413769,62834,46388503605,1500000000,1500000000
58884540777,1649009607,67634,59666082792,62834,59666082792,1500000000,781542015
72266455351,1649017679,67646,73766455351,62846,73942235628,1500000000,1500000000
43536363417,1649016217,60850,45036363417,60850,59474061633,1500000000,1500000000
68844331939,1649013407,64056,72844331939,59256,80579428259,4000000000,4000000000
40203871859,1649619012,67634,41703871859,67634,46176772743,1500000000,1500000000
43318914663,1650311683,333682,44818914663,333682,65851937603,1500000000,1500000000
31707322687,1646122811,60862,33707322687,56062,45533306365,2000000000,2000000000
33182315304,1646042204,307779,34682315304,307779,45065339983,1500000000,1500000000
47770955604,1649028339,63200,49270955604,63200,110562263472,1500000000,1500000000
46793011982,1650241577,337472,48293011982,337472,58882337035,1500000000,1500000000
120786383326,1643040110,346418,122286383326,346418,207173809277,1500000000,1500000000
16716378437,1650270092,336873,18216378437,336873,22211463899,1500000000,1500000000
51219894463,1646150969,54308,52719894463,54308,65563472093,1500000000,1500000000
94977878490,1643026039,325176,96695339952,325176,145369375639,1717461462,1717461462
22698706363,1646045060,324244,24198706363,324244,28976034267,1500000000,1500000000
38787608947,1648983675,55580,40287608947,50780,56672143514,1500000000,1500000000
37919230742,1648874344,56492,39419230742,51692,47058450383,1500000000,1500000000
34624786525,1650322372,66778,36124786525,66778,45793474610,1500000000,1500000000
16459930656,1650270104,60838,17959930656,60838,24329661939,1500000000,1500000000
32109367952,1646136104,55580,33609367952,55580,35171276793,1500000000,1500000000
50275154465,1648949871,55717,53275154465,50917,70946346797,3000000000,3000000000
34689166564,1648957779,55717,36689166564,50917,48432913856,2000000000,2000000000
63924699764,1649020482,67710,64891946077,67710,64891946077,1500000000,967246313
17494855304,1650263772,64741,18781347887,59941,18781347887,1500000000,1286492583
28612039277,1646048834,304524,30112039277,304524,35306021339,1500000000,1500000000
40165971702,1648992846,67646,41665971702,67646,43629504385,1500000000,1500000000
39198095490,1648989003,60838,40698095490,60838,50039510818,1500000000,1500000000
28669973846,1649600183,67634,30669973846,62834,47380952166,2000000000,2000000000
47090676344,1646123295,67646,48590676344,62846,61947270943,1500000000,1500000000
37026002680,1646125411,67646,38526002680,62846,45676910635,1500000000,1500000000
155477474352,1643046177,122053,157477474352,117253,394365828826,2000000000,2000000000
16766084324,1650269063,55705,18000000000,50905,18000000000,1500000000,1233915676
46837682774,1648957491,66766,48337682774,61966,50657404675,1500000000,1500000000
17896471910,1649592718,60950,19396471910,56150,24867189395,1500000000,1500000000
60686051843,1648936238,54813,62186051843,50013,67468691003,1500000000,1500000000
47059769516,1648875045,330567,48559769516,330567,49467504354,1500000000,1500000000
40190385794,1646117977,66790,41690385794,66790,47878875872,1500000000,1500000000
117933256112,1642989304,340075,119433256112,340075,169045232317,1500000000,1500000000
47456165579,1649005277,320583,48956165579,320583,64164859495,1500000000,1500000000
34289603857,1648962624,312397,35789603857,312397,300000000000,1500000000,1500000000
51841502564,1649620935,63200,53341502564,63200,102637017254,1500000000,1500000000
106076922291,1642984129,67646,109076922291,62846,115000000000,3000000000,3000000000
55364593178,1648959054,56492,56864593178,51692,60643348599,1500000000,1500000000
38853280645,1649612791,60938,40353280645,56138,46410998229,1500000000,1500000000
25332883588,1650252683,328805,26832883588,328805,41360196064,1500000000,1500000000
28075185421,1646128471,54736,29575185421,49936,42398665707,1500000000,1500000000
120881715453,1646071247,55648,123381715453,55648,217430227720,2500000000,2500000000
47558280519,1649622197,336881,49058280519,336881,59441091879,1500000000,1500000000
39615763757,1646126057,55580,41615763757,50780,53832354495,2000000000,2000000000
32776311720,1648969454,67646,35878972007,62846,,,
22765375002,1649558160,317262,24265375002,317262,30586617820,1500000000,1500000000
21192816736,1649559502,60862,22692816736,56062,26608603168,1500000000,1500000000
18983001588,1650284170,60938,20483001588,56138,27722011779,1500000000,1500000000
54137076312,1646066222,332460,55637076312,332460,56948644292,1500000000,1500000000
32029088985,1649551356,332382,42029088985,332382,200000000000,10000000000,10000000000
57546601436,1646162497,60850,59046601436,56050,69543835983,1500000000,1500000000
53571720775,1646109003,313441,55071720775,313441,66586148333,1500000000,1500000000
135651791451,1643023865,340033,137151791451,340033,169560797109,1500000000,1500000000
27176752808,1648976019,54700,28676752808,49900,44806230013,1500000000,1500000000
36700483189,1648986464,60862,38200483189,56062,52371127037,1500000000,1500000000
51641456618,1648984304,60838,53141456618,60838,56174721733,1500000000,1500000000
57711462728,1648873534,55717,59211462728,50917,77451614474,1500000000,1500000000
163725130633,1643045313,122029,165725130633,122029,332706423918,2000000000,2000000000
84096729880,1643061546,328771,85506729880,328771,96105085420,1410000000,1410000000
123931654489,1643030886,67634,125931654489,67634,166000000000,2000000000,2000000000
74770114464,1646064752,313455,76270114464,313455,90006736114,1500000000,1500000000
121766378435,1642989294,334214,123266378435,334214,195590359219,1500000000,1500000000
36226031806,1646033471,327371,37726031806,327371,42962765275,1500000000,1500000000
29848489509,1646050952,324828,31348489509,324828,35485769480,1500000000,1500000000
47935021639,1648963268,63200,49435021639,63200,83496852138,1500000000,1500000000
192442712689,1643020086,122053,193953098034,117253,243922414884,1510385345,1510385345
25562848152,1646038798,59958,27062848152,55158,34804361769,1500000000,1500000000
35404620926,1648979784,67622,36904620926,62822,51182917668,1500000000,1500000000
34012204057,1648894362,67634,35512204057,67634,42344741377,1500000000,1500000000
52813942948,1648975137,60850,54313942948,60850,60394496162,1500000000,1500000000
38945870354,1648895996,56492,40445870354,51692,46148645584,1500000000,1500000000
22534314375,1650274576,60938,24034314375,60938,25536277517,1500000000,1500000000
139586629185,1643024117,334312,141086629185,334312,142614825963,1500000000,1500000000
21221526063,1649590376,323583,21846033009,323583,21846033009,1500000000,624506946
30899025590,1650287650,66948,32399025590,56062,36000000000,1500000000,1500000000
28462999385,1646128811,310985,29962999385,310985,44523187547,1500000000,1500000000
20165616478,1649587676,332404,21665616478,332404,30528530227,1500000000,1500000000
149379158069,1643036063,319769,186000000000,319769,,,
36803947553,1648976648,315540,38803947553,315540,56539881347,2000000000,2000000000
52029351312,1649617589,66778,53529351312,61978,57116575728,1500000000,1500000000
68629817538,1648915705,67634,70129817538,62834,88600966232,1500000000,1500000000
70131098180,1648918944,56729,71631098180,47129,85653366959,1500000000,1500000000
94002684595,1643001472,316588,95328084595,316588,99524423011,1325400000,1325400000
47003498548,1646075098,302123,48503498548,302123,50100000000,1500000000,1500000000
48748799115,1649023502,67634,50748799115,67634,57000000000,2000000000,2000000000
98417938298,1643036779,60006,99917938298,55206,108102996855,1500000000,1500000000
53476936832,1648859962,316766,54976936832,316766,56581848048,1500000000,1500000000
40939754955,1648941945,55717,42439754955,50917,51150681037,1500000000,1500000000
45654210553,1646058696,319745,47154210553,319745,54012989054,1500000000,1500000000
44664004384,1648997804,60850,46664004384,60850,60079110152,2000000000,2000000000
20714575321,1649569809,60926,40714575321,60926,100000000000,20000000000,20000000000
35758522380,1648888490,60862,37258522380,56062,44656030908,1500000000,1500000000
46488044334,1649005602,55592,47988044334,50792,74877360918,1500000000,1500000000
137038295480,1643041348,331125,138538295480,331125,174339308204,1500000000,1500000000
32349102329,1648985287,67646,33849102329,62846,43473225869,1500000000,1500000000
19521563141,1649578312,67634,21021563141,67634,35270319023,1500000000,1500000000
44275400856,1650294886,48591,45775400856,43791,57838650383,1500000000,1500000000
89884618158,1646090975,54308,91384618158,54308,139691256462,1500000000,1500000000
18161893553,1649587882,309004,28161893553,309004,200000000000,10000000000,10000000000
23282133626,1649575412,64741,24782133626,59941,28826098488,1500000000,1500000000
28360301031,1650284595,310941,29860301031,310941,34896428375,1500000000,1500000000
68301736716,1646154126,55592,69801736716,50792,76996499243,1500000000,1500000000
87380322531,1643011677,335574,88880322531,335574,116450995109,1500000000,1500000000
53480152405,1649005139,312287,54980152405,312287,60494899518,1500000000,1500000000
28103137467,1650283640,319693,29603137467,319693,36523154068,1500000000,1500000000
64703176423,1646099269,67634,66203176423,67634,78241981972,1500000000,1500000000
37444816637,1646057555,316570,38944816637,316570,51028141370,1500000000,1500000000
26714931555,1649558326,64741,28714931555,59941,50000000000,2000000000,2000000000
77939971584,1650256061,320414,79765317584,320414,88576789668,1825346000,1825346000
108461529342,1643024291,319295,109961529342,319295,135593318429,1500000000,1500000000
39075668817,1648985696,54332,41075668817,49532,58584702475,2000000000,2000000000
39131297152,1649611323,336873,40631297152,336873,46769647165,1500000000,1500000000
17831155025,1649571905,67722,19331155025,62922,32402673764,1500000000,1500000000
57683736829,1649607890,64741,59333736829,59941,220000000000,1650000000,1650000000
31537393963,1648877682,54095,33037393963,49295,38283184949,1500000000,1500000000
34346616508,1650324487,331133,35846616508,331133,43000000000,1500000000,1500000000
44494240319,1646177303,60862,45994240319,56062,55194218448,1500000000,1500000000
44494240319,1646177303,55720,45994240319,50920,55194218448,1500000000,1500000000
34117630280,1648957760,54861,35617630280,50061,46147032554,1500000000,1500000000
19328683047,1649579289,60862,20828683047,56062,26327849609,1500000000,1500000000
59184555460,1648916853,59994,60684555460,55194,73796494057,1500000000,1500000000
41997073227,1648877108,67646,43497073227,67646,54454970658,1500000000,1500000000
42522342820,1648863251,67634,44022342820,67634,53165688857,1500000000,1500000000
49235068813,1648908780,60850,50735068813,56050,54112948275,1500000000,1500000000
33085815153,1650292014,54748,35085815153,49948,47590397863,2000000000,2000000000
19334513086,1650288594,334282,20834513086,334282,26065195608,1500000000,1500000000
21725090246,1650262781,343179,22294397687,343179,22294397687,1410000000,569307441
37670920316,1648969402,55717,39670920316,50917,51755025557,2000000000,2000000000
31661649795,1648875397,66754,33161649795,61954,41270388068,1500000000,1500000000
45523708574,1648920565,67634,47023708574,67634,62322761248,1500000000,1500000000
45523708574,1648920565,67658,47023708574,62858,62322761248,1500000000,1500000000
64453470082,1646100848,54724,65953470082,49924,96954813514,1500000000,1500000000
31435728686,1648972551,64717,32935728686,64717,46231653062,1500000000,1500000000
31435728686,1648972551,60862,32935728686,56062,48308023010,1500000000,1500000000
18424547397,1649578002,343173,18553054959,343173,18553054959,1000000000,128507562
65131132022,1648867066,66754,67131132022,66754,103025930043,2000000000,2000000000
45631221546,1648872229,55580,47131221546,50780,64050068083,1500000000,1500000000
68034186265,1643009455,336309,69534186265,336309,79615209048,1500000000,1500000000
38629025159,1649004930,60862,40129025159,56062,48810534465,1500000000,1500000000
36181146252,1648882448,63200,37681146252,63200,65823311870,1500000000,1500000000
37621260405,1650314534,56492,39121260405,51692,45939977064,1500000000,1500000000
20999601268,1650280824,66790,22499601268,61990,27783811843,1500000000,1500000000
107768015784,1646094567,310357,109268015784,310357,113556582712,1500000000,1500000000
64562176740,1646157416,299155,81298652918,299155,,,
37550135473,1649621487,66850,39050135473,66850,49687359039,1500000000,1500000000
142975709273,1646093722,60850,144475709273,56050,167402439134,1500000000,1500000000
55428844649,1648987183,67634,57428844649,67634,71501745004,2000000000,2000000000
49185187098,1648937574,55717,50685187098,50917,71650264100,1500000000,1500000000
31896037456,1650314069,324166,33396037456,324166,35686197862,1500000000,1500000000
69057613431,1646178797,60862,70557613431,56062,90123440375,1500000000,1500000000
150782535467,1643039943,322971,152282535467,322971,154829031022,1500000000,1500000000
54095289960,1646008996,307801,55595289960,307801,67125728463,1500000000,1500000000
20945285315,1649566520,67634,21945285315,62834,22000000000,1000000000,1000000000
34314494183,1649634525,329224,35814494183,329224,40470785652,1500000000,1500000000
22018790082,1650322797,66778,23518790082,66778,28327057277,1500000000,1500000000
66300774319,1643005425,334338,67800774319,334338,79059676588,1500000000,1500000000
33660047965,1646032126,303812,35660047965,303812,55727639456,2000000000,2000000000
30250964123,1648958243,55717,31750964123,50917,42970355385,1500000000,1500000000
38440888825,1648961152,60315,39940888825,60315,45075705815,1500000000,1500000000
54629727151,1648921764,340061,56039727151,340061,56611810492,1410000000,1410000000
38564081544,1648890178,63200,40064081544,63200,73525263140,1500000000,1500000000
16511974380,1650265239,55672,18011974380,50872,25969773677,1500000000,1500000000
63446835298,1646105843,66778,64946835298,61978,88626467168,1500000000,1500000000
39009314546,1648877565,55592,40509314546,50792,44534709373,1500000000,1500000000
39768166425,1648906935,67634,40837958617,62834,43088423551,1069792192,1069792192
42741044141,1650316358,54332,44241044141,49532,57031902793,1500000000,1500000000
50254721055,1648999828,55705,51754721055,50905,59750290283,1500000000,1500000000
31878170686,1649630131,54760,34878170686,54760,37000000000,3000000000,3000000000
51180130334,1650297899,307690,52680130334,307690,60203696200,1500000000,1500000000
32808670041,1648882275,55612,34308670041,50812,40737604557,1500000000,1500000000
25431322765,1650288379,59946,26931322765,55146,37812630447,1500000000,1500000000
136165297006,1643038213,317204,137665297006,317204,166215536710,1500000000,1500000000
66681902257,1649019832,331169,68181902257,331169,83184700647,1500000000,1500000000
39749297100,1649629542,67722,41249297100,67722,50494866422,1500000000,1500000000
27353523040,1649619663,67722,28853523040,62922,37436242103,1500000000,1500000000
50876602057,1648921779,64044,53140886717,59244,,,
44840201737,1646119420,327357,46340201737,327357,67276964878,1500000000,1500000000
36482004868,1648994088,67622,36583020403,62822,36583020403,1500000000,101015535
48072715295,1648913891,67622,49572715295,67622,66453319740,1500000000,1500000000
133487334486,1643042425,56480,134987334486,56480,160296034560,1500000000,1500000000
117082649426,1646092027,67646,118582649426,62846,136336293249,1500000000,1500000000
94356428440,1646075658,67734,98146535977,58134,,,
26944743094,1649619761,60938,28444743094,56138,38533682470,1500000000,1500000000
32764279382,1649559662,340007,34264279382,340007,40232890453,1500000000,1500000000
41415225193,1648910739,55693,42915225193,50893,50321629200,1500000000,1500000000
42902901873,1650301494,346390,44402901873,346390,45725785332,1500000000,1500000000
87650028473,1646154225,319321,89150028473,319321,89577734615,1500000000,1500000000
38151635689,1646125518,333686,39651635689,333686,44662774937,1500000000,1500000000
38151635689,1646125518,60850,40151635689,60850,52019919068,2000000000,2000000000
41607343515,1648974929,56729,43107343515,47129,51311299930,1500000000,1500000000
59549078535,1649015022,60862,61049078535,56062,63862377725,1500000000,1500000000
53571396824,1650255714,333720,55571396824,333720,69299582149,2000000000,2000000000
40929121519,1648941060,60850,42429121519,56050,60780948052,1500000000,1500000000
39965249743,1648874077,63200,41465249743,63200,76134872700,1500000000,1500000000
81383622973,1650303414,316644,82883622973,316644,91930448414,1500000000,1500000000
27418736420,1650275105,67658,29418736420,62858,37400617953,2000000000,2000000000
31959882958,1648981713,60862,33459882958,56062,47791764839,1500000000,1500000000
39712823412,1648879720,67634,41212823412,62834,54399554230,1500000000,1500000000
29578603598,1646129246,55668,31078603598,55668,41400653833,1500000000,1500000000
27345489717,1649627845,67622,28845489717,67622,37591197607,1500000000,1500000000
22399445545,1649560628,60862,23899445545,56062,25190192217,1500000000,1500000000
59480513918,1648916688,56729,60980513918,47129,66059627753,1500000000,1500000000
226741170686,1643044541,67634,228241170686,67634,241498566755,1500000000,1500000000
39233943802,1649611318,66814,40733943802,62014,41741326539,1500000000,1500000000
29491553243,1650316935,56516,30991553243,51716,200000000000,1500000000,1500000000
70576467360,1646151785,67634,72076467360,62834,111000000000,1500000000,1500000000
42718400997,1649627196,66778,44218400997,61978,55377858574,1500000000,1500000000
70830272802,1649613788,60938,72330272802,56138,96386060770,1500000000,1500000000
75019377119,1643010532,316568,76519377119,316568,89094782654,1500000000,1500000000
37249134941,1646123066,55592,38749134941,50792,58345360430,1500000000,1500000000
72915635457,1646150262,55592,74415635457,50792,133000000000,1500000000,1500000000
39215679219,1649014733,333720,40715679219,333720,50498783357,1500000000,1500000000
37914089419,1648956158,54861,39414089419,50061,60612516944,1500000000,1500000000
45103861980,1646151257,55648,47603861980,55648,82703407166,2500000000,2500000000
127455813308,1642999134,67634,128955813308,62834,142570373018,1500000000,1500000000
32922072038,1648983013,67646,34422072038,62846,43771702684,1500000000,1500000000
16408367576,1649592690,67722,17908367576,62922,22338783633,1500000000,1500000000
21666481019,1649586160,317264,23166481019,317264,27553294154,1500000000,1500000000
112272017372,1643030433,67622,113772017372,67622,156623572758,1500000000,1500000000
55939068459,1646058517,339486,57439068459,339486,64969926699,1500000000,1500000000
55939068459,1646058517,343819,57439068459,343819,64969926699,1500000000,1500000000
31067524963,1646048151,313314,32567524963,313314,41209407193,1500000000,1500000000
51777026773,1648956899,54921,53277026773,50121,71111574298,1500000000,1500000000
22332857277,1649557847,55592,23832857277,50792,28123829265,1500000000,1500000000
143484719757,1643062441,319733,144984719757,319733,192483631387,1500000000,1500000000
44724333917,1646057102,58600,46224333917,58600,64461388219,1500000000,1500000000
42937966102,1648974289,56492,44437966102,51692,58326847198,1500000000,1500000000
32879083225,1649629558,53276,34379083225,43676,37010000000,1500000000,1500000000
23257851158,1649580409,67634,24757851158,62834,29873451652,1500000000,1500000000
42284205656,1649549804,300238,43784205656,300238,53382188945,1500000000,1500000000
85358041182,1648919455,329213,86858041182,329213,102310540873,1500000000,1500000000
20736089657,1650246633,55680,22236089657,50880,25224020338,1500000000,1500000000
18089174151,1650279876,66790,19589174151,61990,22904709584,1500000000,1500000000
74961115494,1646159116,335635,76461115494,335635,80849885870,1500000000,1500000000
115650515464,1643053125,331953,117150515464,331953,131000000000,1500000000,1500000000
78764213150,1646157812,321012,80264213150,321012,101521847057,1500000000,1500000000
33087001261,1646133816,54664,34587001261,49864,37321700224,1500000000,1500000000
130028634112,1643035622,67646,131528634112,62846,168123899955,1500000000,1500000000
40577159953,1648882528,319713,42077159953,319713,49126331119,1500000000,1500000000
46724109528,1650310019,331123,48201531629,331123,48201531629,1500000000,1477422101
38956201233,1649004037,330555,40000000000,330555,40000000000,1500000000,1043798767
46330171415,1649614165,500000,50000000000,67722,,,
134151966471,1643028513,64729,135651966471,59929,142896085114,1500000000,1500000000
20874615133,1649575336,333664,22374615133,333664,24696121485,1500000000,1500000000
40605156931,1646139446,324818,43194824645,324818,,,
95204342390,1646092159,60862,96704342390,56062,113399296808,1500000000,1500000000
56578338144,1649633970,67622,58078338144,67622,60669971197,1500000000,1500000000
26293600980,1650243746,60850,27793600980,56050,34512787480,1500000000,1500000000
123162950396,1646093176,63200,125662950396,63200,284543321648,2500000000,2500000000
38794449676,1646125436,55648,41294449676,55648,76552005360,2500000000,2500000000
150759948013,1643037574,60862,152259948013,56062,204734219208,1500000000,1500000000
39533602510,1648874440,319632,41033602510,319632,59910279542,1500000000,1500000000
41121846867,1648972516,54676,42621846867,49876,58251463483,1500000000,1500000000
53268136854,1649633153,66790,54768136854,61990,69978876560,1500000000,1500000000
25369064696,1650289665,319791,26869064696,319791,40669578779,1500000000,1500000000
38501159750,1646122135,54676,40001159750,49876,47845034318,1500000000,1500000000
150855639187,1643041198,310834,152355639187,310834,182794388485,1500000000,1500000000
49534002164,1646058452,339986,51034002164,339986,54865942305,1500000000,1500000000
53462880772,1648987135,66754,54962880772,61954,61705814835,1500000000,1500000000
53462880772,1648987135,67622,54962880772,67622,69424319263,1500000000,1500000000
78355472829,1649012554,67634,79605831748,62834,79605831748,1500000000,1250358919
44329800003,1648968658,67646,45829800003,62846,49955204837,1500000000,1500000000
57988603780,1649025527,307110,59488603780,307110,70249861447,1500000000,1500000000
52140886717,1648921457,67634,71000000000,62834,,,
19050464382,1649589866,324832,20550464382,324832,25200022090,1500000000,1500000000
36259821307,1648883979,55592,37669821307,50792,40478707488,1410000000,1410000000
36259821307,1648883979,55656,37759821307,50856,47988846303,1500000000,1500000000
29114910993,1650252583,60006,30614910993,60006,37975553923,1500000000,1500000000
27553143246,1650323974,66778,29053143246,66778,36489750108,1500000000,1500000000
57822853148,1646151652,55592,59322853148,50792,91403581457,1500000000,1500000000
169250837800,1643050661,337506,170750837800,337506,197988627040,1500000000,1500000000
44473090746,1648956102,310983,45973090746,310983,56333192723,1500000000,1500000000
44918468988,1648883243,333688,46234468988,333688,47358547766,1316000000,1316000000
84410162095,1646157836,321680,85910162095,321680,89019116175,1500000000,1500000000
34611059858,1648964285,318666,36611059858,318666,52732488043,2000000000,2000000000
42015308421,1648952307,67634,43515308421,62834,56762962267,1500000000,1500000000
47185777420,1649622716,66778,48685777420,66778,57672949005,1500000000,1500000000
28738058231,1649597873,55592,30238058231,50792,30620571942,1500000000,1500000000
56946493244,1646132184,313534,58346154675,313534,58346154675,1500000000,1399661431
56344652175,1646151884,64741,57844652175,59941,76926609097,1500000000,1500000000
62746607074,1648953831,67646,64246607074,67646,73445080720,1500000000,1500000000
25938250134,1650252484,319781,27438250134,319781,31685046913,1500000000,1500000000
35560541391,1650317579,59970,37060541391,55170,41864777250,1500000000,1500000000
110035928630,1643027279,299303,111535928630,299303,144279145000,1500000000,1500000000
53388174410,1646151551,54933,54888174410,50133,200000000000,1500000000,1500000000
54366371213,1646106167,55592,55866371213,50792,80907263122,1500000000,1500000000
39927976210,1646059402,333726,41427976210,333726,52289545620,1500000000,1500000000
62763018049,1648996303,67634,64763018049,67634,75375227267,2000000000,2000000000
48078662448,1648963214,55717,50078662448,50917,69977789931,2000000000,2000000000
38926761213,1648976940,59958,40426761213,59958,45000000000,1500000000,1500000000
61816993970,1649001270,55592,63316993970,50792,80187906578,1500000000,1500000000
20086882534,1649559336,330553,21586882534,330553,27391229002,1500000000,1500000000
25210427379,1649619386,318710,26710427379,318710,30615389174,1500000000,1500000000
60906444202,1646116370,59994,62406444202,59994,70221502833,1500000000,1500000000
62288929945,1648995685,67634,63788929945,67634,86592251409,1500000000,1500000000
27995003558,1649563962,54772,29495003558,49972,34610036215,1500000000,1500000000
19564998449,1650263860,122053,21064998449,117253,25716569737,1500000000,1500000000
68717603925,1649607505,63945,70217603925,59145,200000000000,1500000000,1500000000
45746811276,1646014666,310999,47246811276,310999,55134129823,1500000000,1500000000
57950964504,1649002479,60926,61000000000,60926,,,
35453940806,1649612749,59982,36953940806,55182,44316872294,1500000000,1500000000
52805893051,1648917636,64729,54305893051,59929,69923473872,1500000000,1500000000
30193551157,1648971418,67634,31693551157,67634,45722174487,1500000000,1500000000
26023000780,1650283556,60030,27523000780,60030,27550453669,1500000000,1500000000
149074475785,1643037057,60862,150574475785,56062,189907009435,1500000000,1500000000
50641118106,1648940330,67634,52141118106,67634,122000000000,1500000000,1500000000
26069843654,1650290648,330539,27569843654,330539,48439729812,1500000000,1500000000
26069843654,1650290648,318502,28069843654,318502,46222665123,2000000000,2000000000
19776564809,1650254572,329410,21276564809,329410,23358710179,1500000000,1500000000
48950911821,1650259461,55693,50450911821,50893,69772092810,1500000000,1500000000
52624469530,1649028204,60850,54124469530,56050,63981167844,1500000000,1500000000
18973522280,1649577251,60850,20473522280,60850,28064008398,1500000000,1500000000
41027288747,1650315720,317272,42527288747,317272,45854313704,1500000000,1500000000
128062202541,1646089564,67634,129562202541,67634,193732756224,1500000000,1500000000
59601117376,1649001253,330511,61101117376,330511,76437958392,1500000000,1500000000
50568508627,1649620920,67722,52068508627,67722,72104200238,1500000000,1500000000
20346768548,1650325218,319735,21846768548,319735,31937028180,1500000000,1500000000
54158748936,1650256739,66754,55658748936,61954,55822158723,1500000000,1500000000
44787859857,1646151358,63200,47287859857,63200,88319775644,2500000000,2500000000
49590228848,1646114062,313014,51090228848,313014,63316662434,1500000000,1500000000
153084640810,1643040195,308110,154584640810,308110,168369942447,1500000000,1500000000
74310925742,1646075720,54688,80875453634,49888,,,
74310925742,1646075720,309838,80875453634,309838,,,
33536778704,1650320232,320451,35036778704,320451,36864645948,1500000000,1500000000
41097606527,1648936992,55717,42597606527,50917,56312152905,1500000000,1500000000
103180774068,1643032133,60850,104680774068,56050,124420815578,1500000000,1500000000
20103423849,1649557677,67634,21603423849,67634,31226309112,1500000000,1500000000
42227050355,1649550399,55680,43591023612,50880,43591023612,1500000000,1363973257
33016428629,1650260482,60938,34516428629,60938,38842160513,1500000000,1500000000
27471876262,1649557525,48675,28971876262,48675,34245394852,1500000000,1500000000
58818650566,1649622892,60950,60318650566,56150,76193085908,1500000000,1500000000
21436117647,1649573935,67734,22936117647,62934,33585817012,1500000000,1500000000
20142650083,1650270834,55705,21642650083,50905,25693499063,1500000000,1500000000
55832325714,1646153929,59994,57332325714,55194,70989444664,1500000000,1500000000
94588635852,1646093359,55648,97088635852,55648,209429829518,2500000000,2500000000
37826268385,1648974986,65506,39326268385,60706,51713030259,1500000000,1500000000
16136191434,1649575724,67646,17636191434,62846,19933380322,1500000000,1500000000
58786883811,1649609223,59946,60286883811,55146,73234624357,1500000000,1500000000
41378140026,1649605979,60950,42878140026,56150,53000000000,1500000000,1500000000
32171659970,1649555648,59970,33671659970,55170,44414587367,1500000000,1500000000
34220526413,1646134552,310247,35720526413,310247,44219206680,1500000000,1500000000
38685092431,1648963560,54921,40185092431,50121,300000000000,1500000000,1500000000
42987821934,1646123263,60850,44987821934,56050,56015035191,2000000000,2000000000
69518145971,1648867368,67634,71018145971,62834,87296291990,1500000000,1500000000
41527773240,1648878424,67634,43027773240,67634,58246352322,1500000000,1500000000
48368270284,1648934943,55693,49868270284,50893,53820082940,1500000000,1500000000
43957287274,1648934699,67634,45457287274,67634,61049079545,1500000000,1500000000
43828071110,1648874437,55693,45328071110,50893,59910279542,1500000000,1500000000
109814367411,1643036362,340625,111314367411,340625,117547627964,1500000000,1500000000
44527985539,1648925893,67634,46027985539,62834,47098356925,1500000000,1500000000
43055249820,1646111063,327970,44555249820,327970,45000000000,1500000000,1500000000
43055249820,1646111063,333736,44465249820,333736,45000000000,1410000000,1410000000
49217528643,1646124325,55592,50717528643,50792,71556710163,1500000000,1500000000
35998496871,1648962768,55720,37648496871,55720,300000000000,1650000000,1650000000
26723559753,1649631274,340053,28723559753,340053,42636017528,2000000000,2000000000
19533629114,1649575478,56705,21033629114,47105,26502457852,1500000000,1500000000
48904595057,1649629746,49571,50404595057,44771,51015441958,1500000000,1500000000
28002817568,1649553763,330348,29502817568,330348,40458709092,1500000000,1500000000
45828506415,1648878618,321883,47390206415,321883,52552166133,1561700000,1561700000
14368837936,1650268024,336871,15600000000,336871,15600000000,15600000000,1231162064
26598149799,1649599169,332314,28098149799,315214,34526234920,1500000000,1500000000
26598149799,1649599169,335554,28098149799,335554,34526234920,1500000000,1500000000
39086521753,1646167092,310309,40086521753,310309,41447718690,1000000000,1000000000
61715412321,1648959147,56492,63215412321,51692,79355295903,1500000000,1500000000
63928973154,1648959128,55720,65428973154,50920,79355295903,1500000000,1500000000
66024399046,1646099191,321614,67524399046,321614,76813839625,1500000000,1500000000
115623130362,1643020482,60850,117123130362,56050,167990953435,1500000000,1500000000
55140257934,1649027915,55717,56640257934,50917,62311507554,1500000000,1500000000
49572868466,1646160868,59958,51072868466,59958,68070055752,1500000000,1500000000
105477544644,1646095068,55720,106977544644,50920,200000000000,1500000000,1500000000
121215419426,1642983554,55705,122715419426,50905,196129199510,1500000000,1500000000
47740175428,1648987202,60862,49740175428,56062,77961944138,2000000000,2000000000
23409122051,1650279768,67634,24909122051,67634,30294884068,1500000000,1500000000
74259142539,1649023889,334306,75759142539,334306,96174655157,1500000000,1500000000
76798273793,1650256474,52916,78298273793,52916,99029780769,1500000000,1500000000
60329304844,1650296731,340653,61829304844,340653,65713298962,1500000000,1500000000
37221207404,1646133827,310975,38721207404,310975,43500754969,1500000000,1500000000
75622269948,1643017305,333656,77122269948,333656,99568116418,1500000000,1500000000
39404908197,1648968617,55648,41904908197,55648,86164975816,2500000000,2500000000
21964668870,1649601751,322884,23464668870,322884,27562304517,1500000000,1500000000
147953972893,1642984052,59958,149953972893,59958,197027666767,2000000000,2000000000
112867591056,1646089384,303998,114367591056,303998,167066014985,1500000000,1500000000
44333323176,1648897982,67634,45833323176,67634,49149621972,1500000000,1500000000
41147376717,1646148213,312916,42647376717,312916,45000000000,1500000000,1500000000
41147376717,1646148213,327954,42647376717,327954,45000000000,1500000000,1500000000
149723285168,1643059941,60850,150700409664,56050,150700409664,1500000000,977124496
26435785366,1650322539,343233,27935785366,343233,34421160959,1500000000,1500000000
115848975495,1643030602,340021,117348975495,340021,174556665804,1500000000,1500000000
93579580657,1642997833,346410,95079580657,346410,104562354494,1500000000,1500000000
25658217611,1648962274,64741,27158217611,59941,41108232534,1500000000,1500000000
37639523176,1649633321,55668,39139523176,50868,53248267427,1500000000,1500000000
51288567550,1648935429,64717,52788567550,64717,63987009767,1500000000,1500000000
51288567550,1648935429,333740,53288567550,333740,75101446357,2000000000,2000000000
46189031912,1646153416,55592,47599031912,50792,54131003800,1410000000,1410000000
48187944605,1649606032,49583,49687944605,44783,53000000000,1500000000,1500000000
37211730001,1649616136,329187,38711730001,329187,56311309620,1500000000,1500000000
43168236409,1648886135,55648,45668236409,55648,79250112062,2500000000,2500000000
131190546731,1642984208,322452,132690546731,305352,167955336403,1500000000,1500000000
53159739376,1649007526,59982,54659739376,55182,57994020768,1500000000,1500000000
59422897526,1649604353,64705,61422897526,59905,84994165036,2000000000,2000000000
58052930202,1648942884,67634,59552930202,67634,69201103313,1500000000,1500000000
164539047421,1643040036,323062,166039047421,323062,170857042323,1500000000,1500000000
41204678932,1648963086,55696,42704678932,50896,49572686095,1500000000,1500000000
46169829808,1648930549,66730,47669829808,66730,57428733015,1500000000,1500000000
24376920819,1650288525,67634,25876920819,62834,32219083238,1500000000,1500000000
35120440696,1650317562,67646,36620440696,62846,42584974589,1500000000,1500000000
33410484747,1649552863,336891,34501218733,336891,34501218733,1500000000,1090733986
38203316577,1649612163,59934,39703316577,55134,46445821102,1500000000,1500000000
38203316577,1649612163,63200,39703316577,63200,77727009122,1500000000,1500000000
16742524422,1650269797,60838,18242524422,56038,21985369037,1500000000,1500000000
114535747566,1646093407,55636,116035747566,50836,119735794815,1500000000,1500000000
39823283125,1646167405,55592,41323283125,50792,50262597792,1500000000,1500000000
36951262289,1648962600,67634,38451262289,62834,50263110570,1500000000,1500000000
63385935590,1646151915,60862,64885935590,56062,71930815219,1500000000,1500000000
55786922965,1649015211,54759,57286922965,49959,59336077172,1500000000,1500000000
23764912125,1649592485,55592,25764912125,50792,30774307629,2000000000,2000000000
23963883634,1649590987,60862,25463883634,60862,27280714719,1500000000,1500000000
34258895443,1648964632,67646,35758895443,62846,40007069689,1500000000,1500000000
54859437515,1648883160,65530,56359437515,60730,64643705169,1500000000,1500000000
32452745806,1648886461,60850,33952745806,56050,42629560668,1500000000,1500000000
32965078803,1646122947,60862,34465078803,56062,48116159183,1500000000,1500000000
42008215410,1648882893,56516,43508215410,51716,43987230983,1500000000,1500000000
49415713168,1648926984,67634,51415713168,62834,67373994503,2000000000,2000000000
87288133468,1648921263,60838,88788133468,56038,110971162642,1500000000,1500000000
50877102305,1648915092,64717,52377102305,64717,70750050482,1500000000,1500000000
17799785059,1650270121,333730,19299785059,333730,22395473047,1500000000,1500000000
75355996580,1643017395,54884,81000000000,50084,,,
25014443385,1650286407,66778,26514443385,66778,35460011655,1500000000,1500000000
40314919944,1649627136,60938,41814919944,56138,54838786505,1500000000,1500000000
48016854031,1649628652,67710,49516854031,67710,58094517343,1500000000,1500000000
16320205368,1649587387,67634,16822684833,62834,16822684833,1000000000,502479465
67022243343,1648930200,313379,68522243343,313379,85463717280,1500000000,1500000000
72049619693,1646100764,313546,73549619693,313546,92998254877,1500000000,1500000000
78751895952,1643011517,331129,80251895952,331129,108344312037,1500000000,1500000000
35803420424,1648979077,63200,37303420424,63200,73965797170,1500000000,1500000000
49046204382,1649003896,60303,50546204382,60303,61253749160,1500000000,1500000000
20160635542,1649558671,66742,21660635542,61942,29538281359,1500000000,1500000000
36107028350,1648876312,55580,37607028350,55580,47151816348,1500000000,1500000000
27064786296,1650291732,55580,27833889030,50780,27833889030,1500000000,769102734
24581754186,1650284770,59994,26081754186,59994,26235011745,1500000000,1500000000
61332740454,1646143565,60862,62832740454,56062,72248486924,1500000000,1500000000
61432965395,1646099209,327343,62932965395,327343,74867192335,1500000000,1500000000
100626950515,1646092040,55648,103126950515,55648,231724618702,2500000000,2500000000
46879215510,1648880792,56492,48379215510,51692,62841180485,1500000000,1500000000
46879215510,1648880792,56492,48379215510,51692,65849058358,1500000000,1500000000
118974144122,1642987654,340067,120474144122,340067,185565034580,1500000000,1500000000
89524734661,1646067955,346398,91024734661,346398,92042548788,1500000000,1500000000
37031743316,1646173720,63200,39531743316,63200,86123002810,2500000000,2500000000
74056040336,1643008818,323559,76056040336,323559,100982547055,2000000000,2000000000
74056040336,1643008818,340071,76056040336,340071,90317213113,2000000000,2000000000
39884095372,1648892266,56492,41384095372,51692,47518024572,1500000000,1500000000
57228424767,1648915131,48639,58728424767,43839,70750050482,1500000000,1500000000
140717833147,1643025934,324794,142217833147,324794,186762407588,1500000000,1500000000
47303214098,1649028779,63200,48803214098,63200,93998120088,1500000000,1500000000
42924578060,1648957828,56492,44424578060,51692,50280097052,1500000000,1500000000
31677053917,1648968253,63200,33177053917,63200,73701939988,1500000000,1500000000
35325347505,1649621455,59958,36825347505,59958,38254707600,1500000000,1500000000
47388027248,1646150873,307239,48888027248,307239,60532531620,1500000000,1500000000
47388027248,1646150873,60862,48888027248,56062,111000000000,1500000000,1500000000
67585048932,1643017567,331143,69085048932,331143,111844045099,1500000000,1500000000
38653729842,1648974743,316590,40153729842,316590,64801506038,1500000000,1500000000
35715043168,1648962801,54724,37215043168,49924,47419778247,1500000000,1500000000
54455478193,1650300280,60850,55955478193,56050,58171068745,1500000000,1500000000
37402912164,1646145932,330517,39398040494,330517,,,
59375753738,1643009520,343787,60875753738,343787,73838421150,1500000000,1500000000
36728102548,1646053482,67634,38228102548,67634,48856255138,1500000000,1500000000
32788388257,1648875513,56492,34288388257,51692,42310074629,1500000000,1500000000
31300048421,1648888939,66730,32800048421,61930,44742126880,1500000000,1500000000
157828880330,1643056007,340651,159328880330,340651,192852257823,1500000000,1500000000
28969823800,1648968258,55717,31969823800,50917,53824387092,3000000000,3000000000
41403897412,1649026519,67634,42903897412,67634,54505249632,1500000000,1500000000
27716753881,1648972053,52568,29216753881,47768,32496900155,1500000000,1500000000
39879471199,1648938673,55717,42879471199,50917,61718890438,3000000000,3000000000
79258820868,1646098282,60862,80758820868,56062,97792846635,1500000000,1500000000
63025762590,1646178711,60850,64525762590,56050,93568542262,1500000000,1500000000
39101611162,1646056729,322860,41101611162,322860,50000000000,2000000000,2000000000
26229251369,1648973425,322504,27729251369,322504,35000000000,1500000000,1500000000
23398434005,1649635173,67722,24898434005,62922,26246107638,1500000000,1500000000
41131604212,1649026853,55717,42631604212,50917,52227611752,1500000000,1500000000
60830346019,1649011174,55592,62330346019,50792,64254480579,1500000000,1500000000
54215449542,1649633207,67710,55715449542,67710,68085171068,1500000000,1500000000
20566596627,1649558241,365666,22066596627,332424,28000000000,1500000000,1500000000
21069934191,1649574112,60950,22569934191,56150,26028107444,1500000000,1500000000
64880838700,1648935874,60850,66380838700,60850,88732854632,1500000000,1500000000
33525700870,1650289841,327998,35025700870,327998,40056247724,1500000000,1500000000
45165664697,1650313236,319753,46665664697,319753,54282537669,1500000000,1500000000
99878032273,1646071544,55720,101378032273,50920,300000000000,1500000000,1500000000
37848427572,1649004899,67634,39348427572,67634,57625084622,1500000000,1500000000
32189940525,1648895199,63200,33689940525,63200,79003206914,1500000000,1500000000
33676296836,1648895068,60850,35176296836,56050,42993064714,1500000000,1500000000
23804496487,1649594321,67646,25304496487,62846,31782585138,1500000000,1500000000
18064306311,1649563745,67634,19564306311,62834,20000000000,1500000000,1500000000
71240759512,1643015085,60850,72650759512,56050,80000000000,1410000000,1410000000
46231917189,1648924518,60850,47731917189,56050,59767897657,1500000000,1500000000
34487577319,1648960390,55717,35987577319,50917,50509185563,1500000000,1500000000
55061218179,1649001608,67646,56561218179,62846,56761835767,1500000000,1500000000
50494023339,1648915175,66778,51994023339,61978,72641528107,1500000000,1500000000
43172283890,1646121627,60850,44672283890,56050,55263211222,1500000000,1500000000
170535663683,1643019932,67646,172535663683,62846,227805997966,2000000000,2000000000
131225488987,1643036251,319723,132725488987,319723,177425336794,1500000000,1500000000
32417151755,1646034988,60862,34417151755,56062,56625634063,2000000000,2000000000
15319765904,1649588094,67634,16819765904,62834,21745802117,1500000000,1500000000
69295786895,1648908271,67634,70795786895,62834,71427162557,1500000000,1500000000
42725237421,1650321206,330483,44225237421,330483,55465668139,1500000000,1500000000
95803305367,1646094547,335142,97303305367,335142,101114439548,1500000000,1500000000
87211729248,1643065933,329255,88621729248,329255,89000000000,1410000000,1410000000
20521807582,1649562742,54712,22521807582,49912,28708075268,2000000000,2000000000
228724025713,1643058126,326111,230724025713,326111,281385682905,2000000000,2000000000
51158094888,1646166801,67646,52658094888,62846,58360380877,1500000000,1500000000
146282114674,1643035655,333678,147782114674,333678,150000000000,1500000000,1500000000
45131972097,1648958640,67634,46631972097,67634,62038311985,1500000000,1500000000
107393608046,1648953144,67646,109629656896,62846,178033674058,2236048850,2236048850
43200568253,1649004809,66766,44700568253,61966,54211598723,1500000000,1500000000
32279031758,1648885794,56492,33779031758,51692,36154873394,1500000000,1500000000
48063158601,1650307187,55660,52063158601,50860,100000000000,4000000000,4000000000
38526231839,1646122263,55720,40026231839,50920,200000000000,1500000000,1500000000
127187254856,1643063910,306478,128687254856,306478,167039042937,1500000000,1500000000
43263557108,1648961459,60850,44763557108,56050,47780766762,1500000000,1500000000
27865005728,1650268953,67634,29365005728,62834,34453316635,1500000000,1500000000
70641072623,1646160654,52940,72141072623,48140,96576291090,1500000000,1500000000
135592775559,1643023809,499633,137092775559,333089,140449419164,1500000000,1500000000
36663372560,1648881113,67634,37663372560,67634,38332317973,1000000000,1000000000
45391700926,1646167948,54921,46891700926,50121,300000000000,1500000000,1500000000
63448684551,1648993047,317584,64948684551,317584,65009472377,1500000000,1500000000
41497098803,1646148328,313034,42997098803,313034,45000000000,1500000000,1500000000
41497098803,1646148328,321678,42997098803,321678,45000000000,1500000000,1500000000
41497098803,1646148328,324234,42997098803,324234,45000000000,1500000000,1500000000
71987085513,1646102166,327385,73487085513,327385,87183102857,1500000000,1500000000
58070991512,1649025499,55636,59570991512,50836,70249861447,1500000000,1500000000
39099206545,1650295672,59946,40599206545,55146,51398428555,1500000000,1500000000
50974398287,1646060148,55720,52474398287,50920,300000000000,1500000000,1500000000
17056008191,1649587031,339876,18556008191,308978,21000000000,1500000000,1500000000
39326489368,1648862637,313463,40000000000,313463,40000000000,1500000000,673510632
39326489368,1648862637,316073,40826489368,316073,41000000000,1500000000,1500000000
119228583111,1646103393,304074,120728583111,304074,133312916562,1500000000,1500000000
93047147530,1643027110,59934,94547147530,59934,104666430787,1500000000,1500000000
42035447454,1649629532,59970,43535447454,55170,51369495503,1500000000,1500000000
19367406494,1649561001,59958,21367406494,59958,26569646198,2000000000,2000000000
36230489673,1648893902,55705,37730489673,50905,56026130365,1500000000,1500000000
36834485696,1648890588,63200,38334485696,63200,79783532954,1500000000,1500000000
43054183436,1646034923,67646,45054183436,62846,58357817211,2000000000,2000000000
42718842672,1649618022,60926,44218842672,56126,64837779457,1500000000,1500000000
47538852194,1649005089,60850,49038852194,56050,58297379773,1500000000,1500000000
121211312976,1646158346,67646,122711312976,62846,178215823425,1500000000,1500000000
33348936993,1646125563,64741,34848936993,59941,49141338562,1500000000,1500000000
20952093162,1649573480,67722,22452093162,67722,28760568818,1500000000,1500000000
80896051012,1648915520,59994,82396051012,55194,93132339744,1500000000,1500000000
43839406115,1648978293,310279,45339406115,310279,54705563835,1500000000,1500000000
39161432051,1646177209,60862,40661432051,56062,54018865427,1500000000,1500000000
82017913024,1646097549,54688,83517913024,49888,117255238339,1500000000,1500000000
35724447625,1649628198,67622,37224447625,67622,54612631434,1500000000,1500000000
61349070168,1648930168,318516,62849070168,318516,82254817603,1500000000,1500000000
43924061834,1646059509,319875,45424061834,319875,55535337297,1500000000,1500000000
26315513870,1649570355,67622,27704615938,67622,27704615938,1500000000,1389102068
22869214853,1650282593,60926,24369214853,56126,33090885488,1500000000,1500000000
29083598888,1650248360,313554,30583598888,313554,36875999409,1500000000,1500000000
45012209303,1646151381,55720,46512209303,50920,200000000000,1500000000,1500000000
34550985637,1648958362,67646,36050985637,62846,46624599102,1500000000,1500000000
43859317716,1649610556,67646,45359317716,62846,64818330012,1500000000,1500000000
47125116797,1648907480,54346,49125116797,49546,56458032613,2000000000,2000000000
42397943348,1648923899,67646,43397943348,62846,46270827188,1000000000,1000000000
41038028344,1648871748,66742,42538028344,66742,50605939612,1500000000,1500000000
42230337375,1648910651,67646,43730337375,62846,54463582445,1500000000,1500000000
117104309972,1643038112,312129,118604309972,312129,163308092963,1500000000,1500000000
33666531902,1646030439,340631,35384231520,340631,36000000000,1717699618,1717699618
41103487622,1648895906,60950,42603487622,56150,57910547483,1500000000,1500000000
46489070995,1650299847,310916,47989070995,310916,56168482320,1500000000,1500000000
23034587802,1650283086,322897,24534587802,322897,32551869759,1500000000,1500000000
75959362087,1646147136,67634,77459362087,67634,104095362648,1500000000,1500000000
48013802430,1649013947,64741,50000000000,59941,50000000000,50000000000,1986197570
43675318840,1649625629,64741,45175318840,59941,56928331774,1500000000,1500000000
46708091117,1648937147,55705,48208091117,50905,56478549075,1500000000,1500000000
38523154191,1648902427,330135,40023154191,330135,40215587283,1500000000,1500000000
25961934229,1650274850,310233,27461934229,310233,34995612717,1500000000,1500000000
63352380542,1646150591,55648,65852380542,55648,130714690708,2500000000,2500000000
32232829718,1648968222,55717,33732829718,50917,47546899597,1500000000,1500000000
32232829718,1648968222,54095,33732829718,49295,47546899597,1500000000,1500000000
58229589737,1649007096,60862,59729589737,56062,62000000000,1500000000,1500000000
46734483120,1648946840,67634,48234483120,67634,56236883814,1500000000,1500000000
18822598916,1650268297,311232,20322598916,311232,23258021828,1500000000,1500000000
53214861406,1646120502,343125,54688683838,343125,54688683838,1500000000,1473822432
117561289817,1643000415,302486,119061289817,302486,121471394602,1500000000,1500000000
55361437695,1648995950,60850,56861437695,56050,84789872832,1500000000,1500000000
17038661861,1649576282,64729,18538661861,59929,23408481503,1500000000,1500000000
61646406655,1648906015,67646,63146406655,62846,70044474480,1500000000,1500000000
49414219291,1646147987,55580,50914219291,55580,70343257759,1500000000,1500000000
26653782090,1649550039,332402,28153782090,248262,61669491997,1500000000,1500000000
34656317773,1649551090,60862,36656317773,60862,48521431062,2000000000,2000000000
14208186204,1649588203,60926,15708186204,56126,19899482483,1500000000,1500000000
14208186204,1649588203,66948,15708186204,56062,20000000000,1500000000,1500000000
43166995327,1649025310,55684,44666995327,50884,57120277635,1500000000,1500000000
45661704640,1649549299,332402,47161704640,332402,61669491997,1500000000,1500000000
72750545842,1650308377,317294,74250545842,317294,76794764954,1500000000,1500000000
47861571924,1648949734,55705,49361571924,50905,57767153083,1500000000,1500000000
31426607103,1648954805,55717,32926607103,50917,36976317030,1500000000,1500000000
18270264052,1649570097,67646,19770264052,62846,27708403534,1500000000,1500000000
41649531251,1649625312,66862,43149531251,62062,48914927497,1500000000,1500000000
47422748561,1646121411,55580,49422748561,50780,68415018134,2000000000,2000000000
110893132897,1642998949,343797,112393132897,343797,140716216612,1500000000,1500000000
207544650105,1643033161,54884,209044650105,50084,265050885944,1500000000,1500000000
17990777277,1649571729,64741,18971934072,59941,18971934072,1000000000,981156795
35030048074,1648972995,67646,46000000000,62846,,,
19796924517,1649569663,51476,21296924517,41876,24406417919,1500000000,1500000000
22269263487,1649635141,60006,23769263487,60006,27897253539,1500000000,1500000000
39162993979,1649626109,66802,40662993979,62002,52130013388,1500000000,1500000000
70405109591,1648869141,66754,71905109591,66754,77158178050,1500000000,1500000000
38948523316,1646131357,65530,39972965079,60730,39972965079,1500000000,1024441763
92450983786,1642995706,331989,104807702167,331989,,,
108854978054,1643061105,60838,110414978054,60838,112120000000,1560000000,1560000000
123829088994,1642989326,320394,125329088994,320394,153707973044,1500000000,1500000000
113626300983,1643017781,55717,115126300983,50917,115640118320,1500000000,1500000000
64095502443,1648921433,67622,65595502443,62822,92877848318,1500000000,1500000000
21747390803,1650274714,59994,23247390803,55194,26101965514,1500000000,1500000000
47265081333,1648960822,60862,48765081333,56062,58927671785,1500000000,1500000000
29755187853,1648976175,315582,31255187853,315582,34563957739,1500000000,1500000000
51940888910,1649616471,320457,53440888910,320457,64742368053,1500000000,1500000000
73808204989,1650296471,48663,75308204989,48663,90348524330,1500000000,1500000000
31958007888,1646125969,60850,33958007888,56050,44886731625,2000000000,2000000000
38256415596,1646053508,328006,39756415596,328006,51269713084,1500000000,1500000000
30939143517,1648963461,54861,32439143517,50061,42571105308,1500000000,1500000000
62051111859,1649608866,60850,63551111859,56050,74079572177,1500000000,1500000000
45284116539,1649551734,55693,46784116539,50893,59993507627,1500000000,1500000000
18363546134,1649562622,55398,19863546134,55398,23000000000,1500000000,1500000000
36739014445,1649618681,54724,38239014445,49924,46602874547,1500000000,1500000000
42128594281,1648884571,66778,43628594281,61978,52685040924,1500000000,1500000000
108052598720,1646154312,55693,109552598720,50893,121565357898,1500000000,1500000000
74773860530,1646096957,60850,76273860530,60850,77583019868,1500000000,1500000000
103514991595,1643040725,66790,105014991595,61990,106251200685,1500000000,1500000000
56419641156,1648921924,59946,58419641156,59946,100000000000,2000000000,2000000000
33388180305,1650259718,67634,34888180305,67634,38968578872,1500000000,1500000000
52983780705,1649023686,67634,54017780397,62834,54140111035,1033999692,1033999692
26208335208,1649557737,66718,27708335208,61918,33490845198,1500000000,1500000000
45325162109,1649549756,63200,46825162109,63200,85724244724,1500000000,1500000000
26663644219,1650315406,340003,28163644219,340003,37641141843,1500000000,1500000000
46756047101,1648951747,327397,48256047101,327397,55930165729,1500000000,1500000000
33202572470,1648900170,59958,35000000000,55158,35000000000,2000000000,1797427530
60802986271,1646144563,55580,62302986271,50780,91364458840,1500000000,1500000000
76154443132,1646150432,55580,77654443132,55580,93148592865,1500000000,1500000000
35180148825,1648988092,60838,36680148825,60838,50156500470,1500000000,1500000000
28766198265,1650317258,55668,30266198265,50868,46841006920,1500000000,1500000000
47605467777,1649028553,66778,49105467777,66778,49496045945,1500000000,1500000000
27841825553,1646126365,55720,29341825553,50920,43513515255,1500000000,1500000000
75312016838,1649604319,303401,77312016838,303401,113382719564,2000000000,2000000000
38368155803,1649611800,55705,39868155803,50905,52000000000,1500000000,1500000000
24924459718,1650324992,343803,26424459718,343803,34007970824,1500000000,1500000000
68754621406,1646151977,65530,70254621406,60730,84453541053,1500000000,1500000000
34809824336,1646113029,67646,36309824336,62846,58815785959,1500000000,1500000000
48635942708,1646107826,317274,50135942708,317274,67906472318,1500000000,1500000000
42125101170,1648976844,56516,44125101170,51716,56217132166,2000000000,2000000000
38604978091,1649028643,67622,40104978091,67622,56837765968,1500000000,1500000000
48348297574,1648992906,60862,49848297574,60862,57973509568,1500000000,1500000000
22258285688,1650289285,48675,23758285688,43875,33221110200,1500000000,1500000000
45056285003,1650294259,59994,46556285003,55194,57136998354,1500000000,1500000000
39164170375,1648966208,67646,40188480322,67646,40188480322,1500000000,1024309947
34449378295,1646126868,63188,36949378295,63188,79043256388,2500000000,2500000000
37581062389,1646178026,327389,39081062389,327389,62599190060,1500000000,1500000000
29199047707,1648979472,63200,30699047707,63200,58699090896,1500000000,1500000000
48474798089,1649616359,66742,49974798089,61942,51540461468,1500000000,1500000000
101326154809,1643025143,66948,102826154809,56062,105000000000,1500000000,1500000000
19651047682,1649588769,311011,20913215103,311011,20913215103,1500000000,1262167421
42002787277,1650316404,63200,43502787277,63200,86982088282,1500000000,1500000000
42632869391,1648961981,55592,44132869391,50792,63736793704,1500000000,1500000000
54207055022,1649024376,66814,55707055022,66814,74971220482,1500000000,1500000000
28047421826,1646042662,326035,30047421826,326035,39545531234,2000000000,2000000000
18594278494,1650270348,67634,20094278494,67634,22958589372,1500000000,1500000000
76222934936,1643013649,333704,77336880485,333704,77368416218,1113945549,1113945549
76222934936,1643013649,334320,77336880485,334320,77368416218,1113945549,1113945549
34353659754,1648946042,67634,35853659754,67634,44914357140,1500000000,1500000000
42801804714,1648967243,55720,44301804714,50920,300000000000,1500000000,1500000000
46195569838,1646178139,324860,47695569838,324860,54098992402,1500000000,1500000000
31417583957,1648970083,55656,32917583957,50856,43877293925,1500000000,1500000000
34983727468,1648965896,60850,36483727468,56050,45299315313,1500000000,1500000000
29505947779,1648966656,60862,31005947779,56062,34384794979,1500000000,1500000000
33749521751,1648886192,67634,35249521751,67634,49041317293,1500000000,1500000000
42195310674,1646135317,67634,43695310674,62834,53461861085,1500000000,1500000000
20347249039,1649554507,55668,21847249039,50868,31764388513,1500000000,1500000000
38187228238,1649610010,67722,39687228238,62922,59152111749,1500000000,1500000000
60747802246,1650309787,66754,62247802246,66754,82070516099,1500000000,1500000000
64752487076,1649007655,60066,66252487076,55266,67949674220,1500000000,1500000000
27564686371,1648971632,60862,29064686371,56062,45838169020,1500000000,1500000000
27564686371,1648971632,52580,29064686371,47780,45838169020,1500000000,1500000000
27564686371,1648971632,60850,29064686371,56050,45337017184,1500000000,1500000000
43481429662,1649616491,54727,44981429662,49927,62177593129,1500000000,1500000000
71047120280,1646160037,54308,73047120280,49508,84107818572,2000000000,2000000000
50138235270,1646061125,343807,51638235270,343807,70333746669,1500000000,1500000000
52965229406,1648997475,67646,54465229406,62846,74744326063,1500000000,1500000000
54531131736,1649028314,340023,57648966795,340023,,,
22949127057,1649580365,338682,24449127057,338682,30785538632,1500000000,1500000000
38363593800,1648977062,67646,39863593800,62846,56720314379,1500000000,1500000000
43693433871,1649632769,55580,45193433871,55580,57543935294,1500000000,1500000000
20216937385,1649571773,67646,21716937385,62846,24679524989,1500000000,1500000000
67750779325,1650304889,52360,69250779325,47560,79794802804,1500000000,1500000000
26227756396,1650291010,337478,27727756396,337478,39854198373,1500000000,1500000000
32454150919,1650317337,55693,33954150919,50893,35799233877,1500000000,1500000000
118845523087,1643021745,60862,120345523087,56062,139742846317,1500000000,1500000000
90449845844,1642995983,319269,91949845844,319269,141098998529,1500000000,1500000000
80585695360,1646070162,60850,82085695360,56050,103021436268,1500000000,1500000000
33495071190,1648970287,63200,34995071190,63200,76021970720,1500000000,1500000000
32321934105,1648950665,55717,33821934105,50917,44786386532,1500000000,1500000000
33361799686,1649613233,60926,34861799686,56126,35000000000,1500000000,1500000000
18701772516,1650251612,67634,20201772516,62834,28638874057,1500000000,1500000000
93221836074,1646068139,67634,94721836074,67634,117237132522,1500000000,1500000000
17530160629,1649594385,66730,19030160629,61930,24635409832,1500000000,1500000000
33729589528,1648934837,314162,35229589528,314162,44187476753,1500000000,1500000000
25466002497,1646128494,55656,26966002497,55656,37488963384,1500000000,1500000000
48456304586,1649621842,66730,49956304586,61930,50000000000,1500000000,1500000000
37498453558,1649631610,60938,38542553714,56138,38542553714,1500000000,1044100156
18826121966,1650272061,320410,20326121966,320410,25439639792,1500000000,1500000000
43510044259,1648968734,63200,45010044259,63200,80635497556,1500000000,1500000000
47141414538,1648969014,56516,48641414538,51716,55803279998,1500000000,1500000000
19684955222,1649560462,60850,20945637958,56050,20945637958,1500000000,1260682736
41122680402,1648874649,54712,42000000000,49912,,,
41373177869,1646173337,313635,42873177869,313635,48177247694,1500000000,1500000000
171610836307,1643049061,64741,173610836307,59941,210226771171,2000000000,2000000000
40895248392,1649633413,308972,42395248392,308972,45772605248,1500000000,1500000000
19232593899,1649591877,326222,21232593899,326222,25135050309,2000000000,2000000000
175504800260,1643023000,67634,177004800260,67634,285743585153,1500000000,1500000000
41462562672,1648969315,64717,42962562672,64717,56690336735,1500000000,1500000000
69701814955,1649608579,67722,71201814955,62922,90735342222,1500000000,1500000000
75811422574,1649607502,326075,77311422574,326075,88695800262,1500000000,1500000000
67120143612,1648908455,331165,68620143612,331165,69297914392,1500000000,1500000000
44495683669,1648909299,67734,45995683669,62934,58026637865,1500000000,1500000000
20484123348,1650251478,326262,21984123348,326262,23718008004,1500000000,1500000000
75406884418,1643012382,52916,76906884418,48116,92940680755,1500000000,1500000000
36594957539,1648956533,60862,38094957539,56062,46909752112,1500000000,1500000000
47451173266,1648914292,67634,48951173266,67634,58744514174,1500000000,1500000000
42551833027,1648956682,55717,44551833027,50917,51105865079,2000000000,2000000000
47698317894,1649000505,67634,49198317894,62834,70199803718,1500000000,1500000000
41000980703,1649609966,48759,42500980703,48759,62160969858,1500000000,1500000000
40916912252,1648887698,67622,42416912252,67622,47024561945,1500000000,1500000000
58781107166,1649012427,60850,60281107166,56050,66855046340,1500000000,1500000000
34700664128,1648880349,55717,36200664128,50917,49328453640,1500000000,1500000000
29168723336,1648970407,67646,30668723336,62846,37578823808,1500000000,1500000000
31706344827,1648885053,55580,33206344827,55580,37000000000,1500000000,1500000000
121201247994,1643037993,326806,122701247994,326806,128568025369,1500000000,1500000000
38775355363,1648927608,67646,40775355363,62846,63230493331,2000000000,2000000000
50238208953,1648941741,325164,51738208953,325164,59563782099,1500000000,1500000000
164759770877,1643045727,122053,166759770877,117253,226140118500,2000000000,2000000000
33967091145,1648984620,55580,35967091145,55580,41117718585,2000000000,2000000000
53694076529,1649605814,67734,55194076529,67734,66000000000,1500000000,1500000000
57632377047,1646146643,55584,59132377047,50784,59440619185,1500000000,1500000000
40930718148,1649029436,316143,42430718148,316143,51692619569,1500000000,1500000000
32173425288,1649610855,60938,33673425288,60938,43503443073,1500000000,1500000000
23506256063,1649601302,333716,25006256063,333716,26094143292,1500000000,1500000000
48412891431,1648882936,60862,49912891431,60862,55293106742,1500000000,1500000000
45119728944,1648920455,60862,46619728944,56062,52250641058,1500000000,1500000000
29453624188,1648973653,60850,30953624188,60850,39481367087,1500000000,1500000000
53115494456,1648944198,60862,54615494456,56062,68040243860,1500000000,1500000000
23539429902,1650285289,60018,25039429902,55218,33424023530,1500000000,1500000000
117996807745,1643024252,365642,119496807745,332402,125000000000,1500000000,1500000000
75220378175,1648923043,55592,76720378175,55592,104755680579,1500000000,1500000000
31032755062,1648971750,67646,32532755062,62846,40629809702,1500000000,1500000000
77134622229,1643016984,60838,78634622229,56038,101405150768,1500000000,1500000000
18109083508,1649585129,60018,19609083508,55218,22354573078,1500000000,1500000000
33946452063,1649611199,60950,35446452063,56150,47750585465,1500000000,1500000000
26327946228,1649567093,55680,28327946228,50880,34207658662,2000000000,2000000000
59168294490,1648914728,67634,60668294490,62834,72855562123,1500000000,1500000000
40227031594,1650259611,336837,41727031594,336837,54565794989,1500000000,1500000000
53126348637,1648878094,67622,54626348637,67622,59877238782,1500000000,1500000000
56194314118,1646107515,327337,57694314118,327337,67485721328,1500000000,1500000000
82226488298,1643015441,55693,83726488298,50893,88068730470,1500000000,1500000000
33868029970,1646034529,60838,35368029970,60838,64655599218,1500000000,1500000000
29710771242,1649599980,55592,31210771242,50792,39233752615,1500000000,1500000000
36543972362,1648941423,55592,38043972362,50792,46664592055,1500000000,1500000000
85370921876,1646087221,54676,86370921876,54676,91000000000,1000000000,1000000000
27753443761,1646055870,284901,29253443761,284901,37449970025,1500000000,1500000000
47684294402,1649623867,67722,49190204852,62922,54494084392,1505910450,1505910450
36949182400,1649620498,320400,40949182400,320400,45000000000,4000000000,4000000000
44194033860,1650296056,340591,45694033860,340591,61335722668,1500000000,1500000000
34868445006,1648966267,55592,36368445006,50792,50455212969,1500000000,1500000000
34868445006,1648966267,67622,36368445006,67622,50455212969,1500000000,1500000000
41180076413,1648994648,55693,42680076413,50893,52869916469,1500000000,1500000000
17148726398,1649589533,338702,18648726398,338702,24358986742,1500000000,1500000000
25736929366,1650285248,66802,27236929366,62002,29779297032,1500000000,1500000000
64639753194,1649013929,60862,66139753194,56062,67694338907,1500000000,1500000000
36118550861,1648971533,49519,37618550861,44719,49310849404,1500000000,1500000000
38661785571,1649630342,323668,40161785571,323668,44459775835,1500000000,1500000000
80376236103,1646065027,67622,81876236103,67622,112219074282,1500000000,1500000000
19100222159,1650270437,325649,20600222159,325649,22839425748,1500000000,1500000000
115339254171,1642984239,67646,118639254171,62846,151896112990,3300000000,3300000000
42918848009,1646031130,310169,44418848009,310169,47015694480,1500000000,1500000000
33076811525,1649627229,59994,34576811525,59994,65626460588,1500000000,1500000000
33076811525,1649627229,59994,34576811525,59994,61670195974,1500000000,1500000000
33076811525,1649627229,59994,34576811525,59994,43499880374,1500000000,1500000000
43713175678,1648929359,67634,45213175678,67634,55396781315,1500000000,1500000000
34718948922,1646124101,55580,36218948922,55580,44831278635,1500000000,1500000000
45222074870,1648960804,60862,46722074870,56062,58927671785,1500000000,1500000000
15135640486,1650270177,60850,16635640486,60850,20192405408,1500000000,1500000000
120316890392,1642984185,325567,121816890392,325567,134096152864,1500000000,1500000000
70645003236,1649006972,60850,72145003236,56050,98882319754,1500000000,1500000000
69756640209,1649607378,49607,70000000000,44807,70000000000,1500000000,243359791
23870588126,1649590380,67634,25370588126,62834,30133577599,1500000000,1500000000
23714426632,1650283070,333606,25214426632,333606,28279119803,1500000000,1500000000
139832448879,1646161394,67646,141714248879,62846,167482097200,1881800000,1881800000
120293727143,1643060238,60850,121793727143,56050,156587620599,1500000000,1500000000
43052817442,1648964936,67646,44552817442,62846,62224675602,1500000000,1500000000
24236478459,1649570365,60938,25736478459,56138,30740837933,1500000000,1500000000
96210481663,1643068641,331195,97710481663,331195,132857708002,1500000000,1500000000
33606883145,1649610618,48579,35106883145,48579,57675703935,1500000000,1500000000
35765731109,1650288092,66790,37265731109,66790,40763510717,1500000000,1500000000
39567748778,1648968731,56516,41067748778,51716,300000000000,1500000000,1500000000
45938238500,1649553077,48603,47438238500,43803,57101960945,1500000000,1500000000
37879967659,1649598103,320404,39379967659,320404,49160961342,1500000000,1500000000
40447718690,1646166572,60850,41947718690,56050,52168274607,1500000000,1500000000
49015760206,1646019889,350175,50515760206,350175,66335142457,1500000000,1500000000
49015760206,1646019889,349534,50515760206,349534,72281208088,1500000000,1500000000
38196490891,1648965765,63188,39696490891,63188,75766950902,1500000000,1500000000
46268861737,1649014841,317196,47768861737,317196,59146644110,1500000000,1500000000
31966406615,1646122857,64741,33466406615,59941,43358948428,1500000000,1500000000
38971327657,1646122708,48603,40471327657,48603,50638256997,1500000000,1500000000
38971327657,1646122708,55580,40971327657,50780,48787602847,2000000000,2000000000
45671599280,1648951369,321678,47171599280,321678,61171104594,1500000000,1500000000
22953698841,1649554274,322914,24453698841,322914,26429383335,1500000000,1500000000
85426043418,1643003289,330525,86926043418,330525,161166373322,1500000000,1500000000
85426043418,1643003289,325046,87426043418,325046,110587882632,2000000000,2000000000
58278929237,1646151559,55580,59778929237,55580,69134213640,1500000000,1500000000
22069688564,1649565837,328232,23569688564,328232,29779622274,1500000000,1500000000
21303931090,1649590946,60862,22803931090,56062,26305622225,1500000000,1500000000
59672956604,1648929808,346358,61172956604,346358,64759535828,1500000000,1500000000
23636751474,1650323711,55693,25136751474,50893,32705918048,1500000000,1500000000
91574200271,1646144473,310371,93074200271,310371,118839427534,1500000000,1500000000
31866012977,1648968462,55717,33366012977,50917,43386500567,1500000000,1500000000
44086655730,1649627055,59970,45586655730,55170,56132025082,1500000000,1500000000
28681912070,1648976074,67634,30681912070,62834,41235237487,2000000000,2000000000
29822725399,1649619443,317336,31322725399,317336,33013034224,1500000000,1500000000
16925494313,1649573138,60850,18425494313,56050,23432949095,1500000000,1500000000
55704479402,1649027489,54921,57204479402,50121,200000000000,1500000000,1500000000
24158627306,1649571480,307972,25658627306,307972,32892412254,1500000000,1500000000
52835297470,1648935049,55717,55835297470,50917,56275135618,3000000000,3000000000
62438302763,1646010406,321038,63938302763,321038,64344403568,1500000000,1500000000
62438302763,1646010406,307664,63938302763,307664,64344403568,1500000000,1500000000
78959427069,1649613805,66802,80459427069,62002,94857472425,1500000000,1500000000
44493260582,1649617546,48639,45993260582,43839,51729552222,1500000000,1500000000
65573267639,1649548982,56516,67073267639,51716,200000000000,1500000000,1500000000
17276310958,1649589084,317328,18776310958,317328,21545849499,1500000000,1500000000
34646320801,1648875570,60862,36146320801,56062,44683402174,1500000000,1500000000
69746442250,1646165141,63200,72246442250,63200,163078410726,2500000000,2500000000
44920070790,1646129924,324204,46420070790,324204,55421993853,1500000000,1500000000
44920070790,1646129924,310397,46420070790,310397,54033963724,1500000000,1500000000
138233104021,1643041097,60862,139733104021,56062,153569508730,1500000000,1500000000
38764163869,1648968582,53498,40264163869,48698,41266116389,1500000000,1500000000
42256819335,1649619053,67710,43756819335,67710,46176772743,1500000000,1500000000
39475538935,1649610045,63200,40975538935,63200,81671563418,1500000000,1500000000
34100202584,1649610603,60926,35100202584,56126,39450000808,1000000000,1000000000
32629741598,1648937811,67634,34129741598,62834,43754065838,1500000000,1500000000
16349123858,1650247509,336891,17849123858,336891,27326687234,1500000000,1500000000
132051864300,1643067907,67734,133551864300,62934,164004629927,1500000000,1500000000
20800373993,1649589824,59946,22300373993,55146,22456499148,1500000000,1500000000
100435018892,1642992940,320362,101935018892,320362,113008835248,1500000000,1500000000
100435018892,1642992940,322945,101935018892,322945,113008835248,1500000000,1500000000
133589672699,1643031514,320352,135089672699,320352,138247713222,1500000000,1500000000
57503079410,1649008575,331177,58302064940,331177,58302064940,1500000000,798985530
55602368029,1648918505,334334,56752513509,334334,56752513509,1500000000,1150145480
36313624542,1648884412,67622,37813624542,67622,54841364330,1500000000,1500000000
29114372679,1646125333,67634,30614372679,62834,44056269510,1500000000,1500000000
134377276001,1646072288,67722,135897738117,62922,181213328659,1520462116,1520462116
28865203805,1648962279,55717,30365203805,50917,33572772014,1500000000,1500000000
31444261619,1648987718,60862,32944261619,56062,35000000000,1500000000,1500000000
22369632947,1649577423,319771,23869632947,319771,25441531592,1500000000,1500000000
142523822577,1643568648,317198,144023822577,317198,161285755230,1500000000,1500000000
93154882178,1643562885,60838,94654882178,56038,115523722642,1500000000,1500000000
84561487141,1643563902,67634,86061487141,67634,178668529684,1500000000,1500000000
93024791950,1643548665,52928,94524791950,48128,119235667212,1500000000,1500000000
87804722429,1643551608,60838,89304722429,60838,124764829894,1500000000,1500000000
65909325133,1643541229,67634,67409325133,62834,80579720928,1500000000,1500000000
90907318081,1643520495,60850,92407318081,56050,132879201979,1500000000,1500000000
73034815389,1643533187,49471,74534815389,49471,111390785744,1500000000,1500000000
60706956249,1644039839,55648,63206956249,55648,128367884962,2500000000,2500000000
99757627730,1643513575,336875,101257627730,336875,118705685737,1500000000,1500000000
99757627730,1643513575,331153,101257627730,331153,118705685737,1500000000,1500000000
89719709360,1643502650,317260,91219709360,317260,101694771089,1500000000,1500000000
81814599409,1644029195,317256,83314599409,317256,105217848142,1500000000,1500000000
94694411364,1643583428,319755,96194411364,319755,129985085477,1500000000,1500000000
70808706242,1643545050,319779,72308706242,319779,97437822742,1500000000,1500000000
65840475485,1643535442,55705,67340475485,50905,94654938947,1500000000,1500000000
110776259940,1643553272,340037,112276259940,340037,125119157855,1500000000,1500000000
113719563871,1643586521,314029,115219563871,314029,141248172473,1500000000,1500000000
74479061313,1643525650,67646,75979061313,62846,93810928253,1500000000,1500000000
84559280322,1643522361,67646,86059280322,62846,108892508495,1500000000,1500000000
86119563210,1643534961,67646,87619563210,67646,99490479458,1500000000,1500000000
137328948441,1643507365,66754,138828948441,66754,194390824212,1500000000,1500000000
95724059582,1644024872,67634,97224059582,62834,97601278753,1500000000,1500000000
71863759084,1643549209,333085,73363759084,257722,79738493020,1500000000,1500000000
177814822118,1643557328,67634,179314822118,67634,264756296789,1500000000,1500000000
78329420111,1644087615,339959,79829420111,339959,83108708260,1500000000,1500000000
51598151462,1644078004,60862,54598151462,56062,61000000000,3000000000,3000000000
66298795868,1644048444,337472,66645836884,337472,66645836884,1500000000,347041016
81115496278,1644024803,336825,82615496278,336825,110853469275,1500000000,1500000000
75332458627,1644040235,55717,76832458627,50917,107577404859,1500000000,1500000000
103271910722,1643550940,336865,104771910722,336865,111334668257,1500000000,1500000000
50707190420,1644075230,60850,53016701837,60850,53016701837,53016701837,2309511417
116858899790,1643517173,313359,118358899790,313359,141347766833,1500000000,1500000000
87718830769,1643561440,334308,89218830769,334308,111342041149,1500000000,1500000000
69972709867,1643564134,314049,71000000000,314049,,,
83894656135,1643537757,336321,85394656135,336321,106930116987,1500000000,1500000000
85092697648,1643516021,313502,86592697648,313502,119904384884,1500000000,1500000000
56794161691,1644073742,56741,76155421815,47141,76155421815,76155421815,19361260124
50909088706,1643544195,67646,52409088706,62846,72825760299,1500000000,1500000000
91099159460,1643552758,189117,93404465828,52473,143770791680,2305306368,2305306368
93041518613,1644024888,60850,94541518613,56050,107758634928,1500000000,1500000000
67671896289,1643549759,44061,69171896289,44061,75051314944,1500000000,1500000000
105990327380,1644083501,327938,107490327380,327938,126592576497,1500000000,1500000000
56407063095,1643534502,55816,57907063095,51016,68859591492,1500000000,1500000000
117340696561,1643579624,334298,118840696561,334298,130259219414,1500000000,1500000000
45445486655,1644060391,316622,46534783042,316622,,,
83546019585,1643532338,297008,85046019585,297008,98178570272,1500000000,1500000000
76002430075,1643550677,336901,77502430075,336901,94746462277,1500000000,1500000000
79901446519,1643552986,326671,81401446519,326671,85341892435,1500000000,1500000000
52016701837,1644062811,52940,53516701837,48140,65778164282,1500000000,1500000000
67368313541,1643528027,55693,68868313541,50893,88531232210,1500000000,1500000000
50727829705,1643544127,52916,52227829705,48116,76259943070,1500000000,1500000000
126481773480,1643558964,322963,127981773480,322963,159529009310,1500000000,1500000000
75313990245,1644022116,330023,76813990245,330023,80000000000,1500000000,1500000000
59972562880,1643554294,55729,61500000000,50929,61500000000,3000000000,1527437120
90817795535,1643507699,333706,92317795535,333706,118659863842,1500000000,1500000000
67885154016,1643535899,317328,69385154016,317328,73557837500,1500000000,1500000000
72138793864,1644067879,66802,73638793864,62002,101091260113,1500000000,1500000000
57525943001,1643529991,320477,59025943001,320477,80424750480,1500000000,1500000000
44803370273,1644052277,329241,45193964458,329241,45193964458,1940000000,390594185
114164475133,1643503076,54812,115664475133,54812,117500488959,1500000000,1500000000
103196503491,1643560775,337514,104696503491,337514,116907232770,1500000000,1500000000
125258917468,1643565155,56504,126758917468,51704,182505931659,1500000000,1500000000
46770624561,1644056944,346388,48270624561,346388,58443106914,1500000000,1500000000
90410562480,1643506008,60078,91910562480,55278,108595025319,1500000000,1500000000
67381302381,1643510073,343223,68881302381,343223,95979332204,1500000000,1500000000
97153538249,1643548800,67634,98653538249,62834,104865226982,1500000000,1500000000
79208799124,1643549178,333085,80708799124,333085,86705117123,1500000000,1500000000
51190525642,1644065695,60850,52690525642,56050,59684276448,1500000000,1500000000
152249945302,1643570380,54825,153749945302,50025,164905782780,1500000000,1500000000
78534259782,1643536814,67634,80034259782,62834,110753366519,1500000000,1500000000
98559000060,1643530923,60838,100059000060,56038,121069287522,1500000000,1500000000
90274673668,1643502646,319775,91774673668,319775,101694771089,1500000000,1500000000
157108265186,1643564970,60850,158608265186,60850,176067281313,1500000000,1500000000
73951205080,1643536724,340669,75451205080,340669,83335128320,1500000000,1500000000
60439960788,1644041193,55592,61939960788,50792,65529243920,1500000000,1500000000
68081827632,1643536365,60862,69581827632,60862,101056798952,1500000000,1500000000
159203722961,1643580751,60862,160703722961,56062,205618000185,1500000000,1500000000
151058077736,1643565090,49519,152558077736,49519,200259085723,1500000000,1500000000
105251768568,1644102246,63188,107751768568,63188,189615895882,2500000000,2500000000
81522019618,1644019843,54332,83022019618,49532,150000000000,1500000000,1500000000
67261013637,1643536485,60862,68761013637,56062,79243923373,1500000000,1500000000
109190394841,1643573253,67646,111190394841,62846,130179219326,2000000000,2000000000
59701813268,1645061144,332464,61201813268,332464,75141485490,1500000000,1500000000
57279783865,1645130761,66730,58779783865,66730,71907088292,1500000000,1500000000
148245340965,1642629872,322955,149745340965,322955,171073678889,1500000000,1500000000
79608639129,1642572422,55636,82108639129,55636,164852151648,2500000000,2500000000
150384934786,1642628950,54795,151884934786,49995,204525683577,1500000000,1500000000
104844018286,1650477129,326800,106494018286,326800,120000000000,1650000000,1650000000
38393700384,1646800460,55592,39893700384,50792,47722476475,1500000000,1500000000
30856221753,1648125099,60862,32356221753,56062,44454491313,1500000000,1500000000
30856221753,1648125099,67634,32356221753,62834,44474489289,1500000000,1500000000
57555187326,1645084314,67646,59055187326,67646,72441854329,1500000000,1500000000
136699543444,1642503741,332374,138699543444,332374,159980844839,2000000000,2000000000
36834590706,1650419189,60850,38334590706,56050,46057507989,1500000000,1500000000
31695852314,1646790156,317310,32808737874,317310,32808737874,1500000000,1112885560
121568707893,1642536491,334328,123068707893,334328,200097809673,1500000000,1500000000
139772895895,1650477068,337510,141906895895,337510,152588319865,2134000000,2134000000
35803690333,1650455706,67646,37803690333,62846,120000000000,2000000000,2000000000
35588701015,1650417684,66778,37088701015,61978,47170097653,1500000000,1500000000
78204109618,1650413043,56504,80871609618,51704,113235919596,2667500000,2667500000
83262931709,1644612814,55644,84762931709,55644,124136500093,1500000000,1500000000
97310217982,1642559532,336897,100310217982,336897,112000000000,3000000000,3000000000
127435222936,1642518662,67622,128935222936,67622,159087149853,1500000000,1500000000
57067335245,1649173718,55648,59567335245,55648,106297670792,2500000000,2500000000
60911704601,1648087283,67722,62911704601,67722,73685487469,2000000000,2000000000
82709748326,1645072559,325996,84709748326,325996,105472389526,2000000000,2000000000
74177668197,1645134478,67634,75677668197,67634,105617242683,1500000000,1500000000
66976730075,1649124237,60850,68476730075,60850,84582461705,1500000000,1500000000
19505910079,1648110980,67634,21005910079,62834,27388110719,1500000000,1500000000
20052284458,1648120222,67634,21552284458,62834,27481088577,1500000000,1500000000
60801573374,1648132203,67634,65000000000,62834,65000000000,65000000000,4198426626
52838762266,1646797166,56516,54338762266,51716,78477281597,1500000000,1500000000
42332887555,1645075454,67646,44332887555,62846,67088465076,2000000000,2000000000
68208271459,1645131035,55705,69708271459,50905,300000000000,1500000000,1500000000
87882905704,1642606252,340055,89382905704,340055,105390475410,1500000000,1500000000
73586194267,1649124836,55592,75086194267,50792,80802214701,1500000000,1500000000
62498924941,1649133771,60862,63998924941,56062,76268030662,1500000000,1500000000
31961497463,1648131268,67634,33461497463,67634,38396130729,1500000000,1500000000
26619741179,1648106758,313324,28119741179,313324,32313872763,1500000000,1500000000
37639870590,1644581937,67634,39139870590,62834,43000000000,1500000000,1500000000
49668477671,1644557873,333643,51168477671,333643,56106763714,1500000000,1500000000
27414048631,1646789718,55580,29414048631,50780,42583459179,2000000000,2000000000
39716512308,1648129308,60850,41216512308,56050,48791328923,1500000000,1500000000
53855856537,1650428945,66790,55355856537,66790,78436937909,1500000000,1500000000
39670407651,1646856039,327353,41170407651,327353,47209673790,1500000000,1500000000
75342806202,1642570438,55717,76842806202,50917,100901016447,1500000000,1500000000
124933868785,1642635217,343187,126433868785,343187,134320523593,1500000000,1500000000
68570175863,1642565928,60850,70070175863,56050,91631280687,1500000000,1500000000
67455565228,1642588958,66766,68955565228,61966,86338807945,1500000000,1500000000
49132957172,1648132526,314053,50632957172,314053,68956937883,1500000000,1500000000
49132957172,1648132526,67622,50632957172,67622,68956937883,1500000000,1500000000
49132957172,1648132526,55592,54132957172,50792,56000000000,5000000000,5000000000
26056330144,1648116278,60862,27556330144,56062,30454689570,1500000000,1500000000
51313710398,1650460028,55580,52813710398,50780,66667234274,1500000000,1500000000
32024870431,1646808642,55592,34727017858,50792,40000000000,2702147427,2702147427
124092099941,1642519082,327299,125592099941,327299,138755105578,1500000000,1500000000
105466804029,1642487219,331175,106966804029,331175,116744820775,1500000000,1500000000
142442864270,1642488822,60850,143942864270,60850,165718443945,1500000000,1500000000
53720921282,1645441470,60938,55220921282,60938,71855034800,1500000000,1500000000
70335818664,1648086114,67634,71835818664,62834,79657206490,1500000000,1500000000
15856940084,1646828818,67646,17356940084,67646,22934444172,1500000000,1500000000
34917619392,1645082316,56729,36417619392,47129,40228630522,1500000000,1500000000
106531460749,1642521005,343225,108031460749,343225,133721052833,1500000000,1500000000
106531460749,1642521005,337490,108031460749,337490,133576449592,1500000000,1500000000
118917450314,1642483665,60850,120417450314,60850,165172276280,1500000000,1500000000
86884042747,1642524900,56516,88384042747,51716,124211958727,1500000000,1500000000
107459439460,1642545697,56516,108959439460,51716,152902921710,1500000000,1500000000
62245529846,1649124768,313467,63745529846,313467,74030226730,1500000000,1500000000
52614043075,1649174007,63200,54114043075,63200,114239237980,1500000000,1500000000
145229738743,1648139094,67634,146729738743,62834,149585042043,1500000000,1500000000
16985728942,1646833816,60862,18485728942,56062,19000000000,1500000000,1500000000
61774174213,1645138780,54783,73000000000,49983,,,
43536411264,1649144231,328841,44536411264,328841,47172293780,1000000000,1000000000
30025424296,1646840085,54095,31000000000,49295,31000000000,1070000000,974575704
430721981117,1645063792,346995,432221981117,346995,460261875604,1500000000,1500000000
91777359669,1642590849,343205,93277359669,343205,96855279280,1500000000,1500000000
66577010336,1649124136,337504,68077010336,337504,91301137353,1500000000,1500000000
26756226886,1648096105,305694,28256226886,305694,36346790962,1500000000,1500000000
16097723124,1648120687,60850,18871262328,56050,,,
20281009431,1648105942,55580,21781009431,50780,25820264200,1500000000,1500000000
27436846011,1648113696,329218,28936846011,329218,34363961904,1500000000,1500000000
51060454095,1646842011,67646,52560454095,62846,66290220370,1500000000,1500000000
37615540975,1646837382,66730,38659392439,61930,38659392439,1500000000,1043851464
106237176699,1642568811,55636,108737176699,55636,235270210108,2500000000,2500000000
75154084740,1642571368,56516,76654084740,51716,95664609354,1500000000,1500000000
117485147380,1642543130,60838,118985147380,60838,151524247482,1500000000,1500000000
94545799585,1642472261,326274,97545799585,319805,124743908080,3000000000,3000000000
22563537887,1648116164,60850,24063537887,56050,31995500818,1500000000,1500000000
42349299653,1646841402,67622,43849299653,67622,61233585129,1500000000,1500000000
43320520793,1645091717,59946,44820520793,55146,59338204457,1500000000,1500000000
72789049626,1648141281,330473,74289049626,330473,88305179125,1500000000,1500000000
34990534397,1648131120,67634,41046617865,62834,,,
17203896078,1648109793,64044,18203896078,59244,18393277343,1000000000,1000000000
156993411078,1650477019,60838,158493411078,60838,164121515680,1500000000,1500000000
94911270486,1642584126,326089,96411270486,326089,111800339129,1500000000,1500000000
78905585232,1642510618,55592,80105585232,50792,82000000000,1200000000,1200000000
49021815791,1649156984,66742,52021815791,61942,70000000000,3000000000,3000000000
51051065375,1649143579,67646,52551065375,62846,59493830258,1500000000,1500000000
47552477868,1648089188,55592,49052477868,50792,51778056337,1500000000,1500000000
32420761159,1648094760,67634,33920761159,62834,44822712734,1500000000,1500000000
24201578133,1648117639,55693,25701578133,50893,32966346479,1500000000,1500000000
33939236508,1650415038,67734,35439236508,67734,50671776114,1500000000,1500000000
68060601867,1650460369,340049,69560601867,340049,89455469614,1500000000,1500000000
31390023725,1650443994,64717,32890023725,59917,39487792127,1500000000,1500000000
17767759797,1646828158,56516,19267759797,51716,24523071224,1500000000,1500000000
27610553768,1646811224,60850,29110553768,56050,30986074642,1500000000,1500000000
32838362806,1646860798,67646,34338362806,62846,43524809522,1500000000,1500000000
149478394057,1642611165,54860,150978394057,50060,170280564458,1500000000,1500000000
76494692649,1642575335,54322,77994692649,54322,96059356683,1500000000,1500000000
79197065773,1642571463,331476,80697065773,331476,93940413813,1500000000,1500000000
36231554531,1650437298,67622,37731554531,67622,49854206730,1500000000,1500000000
195912648290,1650476323,67646,197412648290,62846,280198381115,1500000000,1500000000
46534326415,1650457680,324744,48034326415,324744,57361321028,1500000000,1500000000
55479452174,1646797490,55720,56979452174,50920,300000000000,1500000000,1500000000
74429154707,1642540377,322949,76429154707,322949,80000000000,2000000000,2000000000
74429154707,1642540377,334316,76429154707,334316,90000000000,2000000000,2000000000
74429154707,1642540377,316612,76429154707,316612,90000000000,2000000000,2000000000
195194408250,1642489458,67646,196694408250,62846,211173547000,1500000000,1500000000
49828380704,1649199106,55720,51328380704,50920,200000000000,1500000000,1500000000
41063488330,1648133042,55592,43063488330,50792,57786447091,2000000000,2000000000
41063488330,1648133042,67658,44063488330,62858,100000000000,3000000000,3000000000
31532015385,1645089124,55592,32532015385,50792,49018302641,1000000000,1000000000
121084270762,1642485308,66766,122584270762,61966,124448031652,1500000000,1500000000
69857341460,1649120585,60850,71357341460,56050,71430864988,1500000000,1500000000
104384909280,1642602293,310969,105884909280,310969,132942162185,1500000000,1500000000
56224650547,1649151063,53340,57724650547,48540,70895507508,1500000000,1500000000
74698737477,1645122860,67646,76198737477,62846,126759763769,1500000000,1500000000
85318055042,1642579401,334280,86818055042,334280,100902087642,1500000000,1500000000
82911983629,1642524926,64056,84411983629,54456,103352798779,1500000000,1500000000
63746612228,1649133134,60862,65246612228,56062,73474607062,1500000000,1500000000
25885419304,1648104819,55592,27385419304,50792,40632874292,1500000000,1500000000
35776253868,1648128281,60862,37276253868,56062,38548349773,1500000000,1500000000
69592527151,1650464318,67710,71092527151,62910,83245243480,1500000000,1500000000
24368672507,1646870100,60850,25868672507,60850,31268001947,1500000000,1500000000
77563954744,1642586200,60862,79063954744,56062,96977568722,1500000000,1500000000
88749270946,1642556482,66826,90249270946,66826,144985030243,1500000000,1500000000
54621306935,1645431342,56516,56121306935,51716,73279518487,1500000000,1500000000
54621306935,1645431342,303413,56121306935,303413,77816344895,1500000000,1500000000
66935780307,1645413248,55648,69435780307,55648,133495967020,2500000000,2500000000
51706842813,1648084263,322866,53206842813,322866,67041586099,1500000000,1500000000
29343001962,1648098707,55580,30843001962,50780,44600150793,1500000000,1500000000
88159183640,1650481105,343189,89659183640,343189,109558061014,1500000000,1500000000
100810858183,1644606569,331378,102810858183,331378,138090862275,2000000000,2000000000
67518995166,1645129720,67646,69018995166,62846,71893017908,1500000000,1500000000
57062839410,1649125153,67634,58562839410,62834,80098198413,1500000000,1500000000
54094313446,1645437472,320467,54933908639,320467,54933908639,1500000000,839595193
34530973618,1648130554,67634,36030973618,62834,45949482033,1500000000,1500000000
84676710659,1648133551,55592,86176710659,50792,101000000000,1500000000,1500000000
130109360929,1642493628,329217,131609360929,329217,136732200712,1500000000,1500000000
69453639435,1649127198,324419,70953639435,324419,77581887547,1500000000,1500000000
38764566845,1645432902,341883,40264566845,341883,45819509360,1500000000,1500000000
119845600672,1644541607,326832,121345600672,326832,127993169419,1500000000,1500000000
108843228704,1642609806,346392,110343228704,346392,115000000000,1500000000,1500000000
75667182162,1642592875,60850,77167182162,56050,80470028227,1500000000,1500000000
83619884271,1642604743,326723,85119884271,326723,101645645488,1500000000,1500000000
32236877879,1646790014,55584,33736877879,50784,40684425985,1500000000,1500000000
57482314466,1645108207,67646,58982314466,62846,88436865079,1500000000,1500000000
97647695427,1642568961,60862,99147695427,56062,145396651984,1500000000,1500000000
57674020564,1649129405,59982,59174020564,55182,80840422900,1500000000,1500000000
38896312495,1648091089,67634,40896312495,62834,43088933521,2000000000,2000000000
42165952684,1645077390,334274,43665952684,334274,47653791783,1500000000,1500000000
193262709628,1642631940,317244,195262709628,317244,293392935758,2000000000,2000000000
74798362631,1642569998,56504,76298362631,51704,102682634373,1500000000,1500000000
55933410248,1649142132,55717,57433410248,50917,71605269073,1500000000,1500000000
37840452928,1648097375,67634,39340452928,67634,55557789897,1500000000,1500000000
46403038869,1648131863,67622,47903038869,67622,78652251315,1500000000,1500000000
68007773639,1648131987,55580,69507773639,50780,81873845407,1500000000,1500000000
77268319071,1650469284,64705,79268319071,59905,100253963652,2000000000,2000000000
34549626003,1646803525,55668,36049626003,50868,40995508750,1500000000,1500000000
135848055417,1645111598,54921,137348055417,54921,158705998493,1500000000,1500000000
135848055417,1645111598,52928,137348055417,48128,179204842270,1500000000,1500000000
80206861128,1645107461,54921,81706861128,50121,300000000000,1500000000,1500000000
70554730217,1642586119,67646,72054730217,62846,105391155273,1500000000,1500000000
137708198827,1642605599,56516,139208198827,51716,197845491639,1500000000,1500000000
126370775818,1642516134,60850,127870775818,56050,167192819507,1500000000,1500000000
86400271982,1649134288,49583,87900271982,49583,93199592708,1500000000,1500000000
79366881856,1649177841,64705,80866881856,64705,102373401587,1500000000,1500000000
51744879076,1649165176,60874,53244879076,56074,54746186537,1500000000,1500000000
42188250979,1648089601,60850,43688250979,60850,53246916997,1500000000,1500000000
42733243597,1646799233,310914,46733243597,310914,64274590973,4000000000,4000000000
83577416406,1645140133,54873,85077416406,50073,92635634207,1500000000,1500000000
53837526504,1645115669,322854,55837526504,322854,58084399221,2000000000,2000000000
72975707066,1642590384,56504,74475707066,51704,87520712573,1500000000,1500000000
79715396713,1642509207,56492,81215396713,51692,99847921694,1500000000,1500000000
106764877758,1642467045,55624,109264877758,55624,217567080854,2500000000,2500000000
47159085450,1648090005,331133,48659085450,331133,48837631605,1500000000,1500000000
47775651466,1650445651,64741,49775651466,59941,62427549552,2000000000,2000000000
69054058863,1650483595,60006,70554058863,55206,103704525977,1500000000,1500000000
48871950145,1644584510,64729,50371950145,59929,56927535347,1500000000,1500000000
100979312380,1644610476,332550,102479312380,332550,129097380555,1500000000,1500000000
46952754756,1646815661,60862,48452754756,56062,62744587504,1500000000,1500000000
40294072224,1645115878,67710,41794072224,62910,69542192713,1500000000,1500000000
100786993785,1642619999,67646,102286993785,62846,122803586927,1500000000,1500000000
89454268767,1642575631,336887,90954268767,336887,114248701778,1500000000,1500000000
96903871719,1642583752,55648,98403871719,50848,122632581154,1500000000,1500000000
51679225874,1649142341,320467,53179225874,320467,64009429868,1500000000,1500000000
71482880724,1649141597,55717,72982880724,50917,74025424879,1500000000,1500000000
32465767476,1648087896,307684,33965767476,307684,45531835427,1500000000,1500000000
52496835922,1648131426,67646,53996835922,67646,58059797798,1500000000,1500000000
52496835922,1648131426,60850,53996835922,56050,58059797798,1500000000,1500000000
164812418970,1650470727,316596,168297596149,316596,213354709798,3485177179,3485177179
39354107713,1646815027,67646,40854107713,62846,53160481827,1500000000,1500000000
72121054442,1645109129,54909,74121054442,50109,300000000000,2000000000,2000000000
20842596275,1648120834,317304,22093635204,317304,22093635204,1500000000,1251038929
60407416322,1648080272,63200,61907416322,63200,96975907004,1500000000,1500000000
36040990394,1648132792,67634,37540990394,67634,39328793603,1500000000,1500000000
36040990394,1648132792,67610,37540990394,67610,39328793603,1500000000,1500000000
84654023047,1644541996,334547,86154023047,334547,100000000000,1500000000,1500000000
77389178300,1642571266,337460,78889178300,337460,85850142228,1500000000,1500000000
177702525923,1642489112,55592,179202525923,50792,218227026602,1500000000,1500000000
95549179543,1642512806,52916,96988398820,48116,96988398820,96988398820,1439219277
43224047323,1649162693,322923,44724047323,322923,80000000000,1500000000,1500000000
46052931952,1649163526,324730,47552931952,324730,66787907975,1500000000,1500000000
24656708119,1648126577,67634,26156708119,62834,41254306607,1500000000,1500000000
40706718873,1648090407,319655,42206718873,319655,45725641054,1500000000,1500000000
19972588944,1646823709,313401,21472588944,313401,25569808373,1500000000,1500000000
17147555337,1646828785,60862,18647555337,56062,26602814655,1500000000,1500000000
64322006420,1649141166,55717,65822006420,50917,74994608089,1500000000,1500000000
54701946284,1645421696,334300,56201946284,334300,70078997979,1500000000,1500000000
21511213136,1648107246,60850,23011213136,60850,26687163665,1500000000,1500000000
21511213136,1648107246,55580,23011213136,50780,26687163665,1500000000,1500000000
39722812882,1650421253,67622,41222812882,62822,54030853907,1500000000,1500000000
50343089071,1644571523,67646,51843089071,62846,57525369223,1500000000,1500000000
76568975055,1642580539,343199,78068975055,343199,101693702575,1500000000,1500000000
85055284694,1642496872,55636,87555284694,55636,182226878486,2500000000,2500000000
52469325439,1645402021,326824,53969325439,326824,62136146323,1500000000,1500000000
29760978349,1648128205,67622,31760978349,67622,39785951317,2000000000,2000000000
69503116058,1648134401,63200,71003116058,63200,142723759510,1500000000,1500000000
179948221968,1642612406,67634,181448221968,67634,205903137882,1500000000,1500000000
81009564815,1642500917,333692,82509564815,333692,84046647592,1500000000,1500000000
21072764547,1648110795,67622,22572764547,62822,24307988720,1500000000,1500000000
57006178264,1650418682,60862,58506178264,56062,64840421154,1500000000,1500000000
61437625124,1650462038,55717,62937625124,50917,65998205355,1500000000,1500000000
75365777847,1644590847,319323,76865777847,319323,91962968178,1500000000,1500000000
27729977988,1646817029,314735,29229977988,314735,40199122482,1500000000,1500000000
36853200148,1648097064,60850,38353200148,56050,44013442077,1500000000,1500000000
21064584749,1648120663,60862,22564584749,56062,28548206157,1500000000,1500000000
43114943353,1645090742,54908,44614943353,50108,59604755808,1500000000,1500000000
170596652327,1642489298,60862,172096652327,60862,244587132485,1500000000,1500000000
18966978453,1648105764,67646,20966978453,62846,31701895890,2000000000,2000000000
20317587112,1648127769,60862,21817587112,56062,23736052027,1500000000,1500000000
26534693363,1648119448,340065,28034693363,340065,43526343610,1500000000,1500000000
47483639961,1650493509,60862,48983639961,56062,62381289902,1500000000,1500000000
35273725344,1650417554,55717,37273725344,50917,46286331589,2000000000,2000000000
31793849125,1646788110,60850,33293849125,56050,36000000000,1500000000,1500000000
44628145109,1646856050,55717,46128145109,50917,52259350043,1500000000,1500000000
59142543381,1649137083,322047,60642543381,298478,200000000000,1500000000,1500000000
42375564324,1645432465,323650,43875564324,323650,56154771762,1500000000,1500000000
30396461086,1648120540,67634,31896461086,67634,40739597975,1500000000,1500000000
50159968185,1648084193,60862,64165274003,56062,,,
39819051426,1648130639,67634,41319051426,62834,54926021762,1500000000,1500000000
39819051426,1648130639,67634,41319051426,67634,48993754935,1500000000,1500000000
39819051426,1648130639,67634,45000000000,62834,45000000000,45000000000,5180948574
39311242664,1648093740,67634,40811242664,67634,50952666409,1500000000,1500000000
80476403914,1645478341,55705,81976403914,50905,115115411453,1500000000,1500000000
24021875551,1648106438,64741,25521875551,59941,35597576208,1500000000,1500000000
24021875551,1648106438,325964,25521875551,325964,37569617518,1500000000,1500000000
49438634938,1650462306,60950,53016934347,56150,,,
29074725634,1650454194,60850,30574725634,56050,38983789518,1500000000,1500000000
67517024670,1644587168,313631,68523615587,313631,68523615587,1500000000,1006590917
46913214373,1649166243,321865,48413214373,321865,70282635298,1500000000,1500000000
27046179262,1648103181,60850,28546179262,56050,35992382700,1500000000,1500000000
31274886691,1648132733,67646,32774886691,62846,47533034807,1500000000,1500000000
57175046100,1650423207,64729,58675046100,59929,66083693939,1500000000,1500000000
44740845740,1646842257,60862,46240845740,56062,66906967479,1500000000,1500000000
171072725014,1642623100,67634,172572725014,62834,211262017720,1500000000,1500000000
45120045382,1649118539,67634,46620045382,62834,55510703449,1500000000,1500000000
39883803586,1648131331,307762,41383803586,307762,46443051918,1500000000,1500000000
39883803586,1648131331,67646,41383803586,67646,46443051918,1500000000,1500000000
31309713345,1648113431,67646,32809713345,62846,42554344809,1500000000,1500000000
39919863229,1646795779,67646,41419863229,62846,59454540413,1500000000,1500000000
22252087235,1646859705,328012,23752087235,328012,28440229572,1500000000,1500000000
22252087235,1646859705,333736,23752087235,333736,28440229572,1500000000,1500000000
86994057118,1642517322,67634,88494057118,67634,91828998752,1500000000,1500000000
126873225719,1642537175,54691,128373225719,54691,132167830354,1500000000,1500000000
52955974179,1649133140,49583,54455974179,49583,81904229724,1500000000,1500000000
57631835786,1645419000,337135,59131835786,337135,76386368468,1500000000,1500000000
38398205215,1648130970,55592,39898205215,50792,42178819519,1500000000,1500000000
47064807354,1650428509,335578,48564807354,335578,52306547022,1500000000,1500000000
72710939036,1649198050,64729,74210939036,59929,107062048630,1500000000,1500000000
47718843614,1645411637,54736,51705654649,49936,,,
18097049737,1648109773,60850,19597049737,60850,25741596679,1500000000,1500000000
18097049737,1648109773,325994,19597049737,325994,20808292950,1500000000,1500000000
58098735606,1649151900,48591,59598735606,43791,61402990630,1500000000,1500000000
37973175988,1648128908,67646,39473175988,62846,45000000000,1500000000,1500000000
54019133517,1645115832,54921,55519133517,54921,77476444244,1500000000,1500000000
33992071349,1648129248,67634,35492071349,67634,36336668363,1500000000,1500000000
41134208388,1650431588,67710,42634208388,67710,50836706940,1500000000,1500000000
84420287653,1644614794,49495,85920287653,44695,94865484702,1500000000,1500000000
81123254423,1645125522,66754,82623254423,61954,106886918692,1500000000,1500000000
111276084032,1642466956,48687,112776084032,43887,142592624663,1500000000,1500000000
39813436211,1650436757,67634,41605161207,67634,44595027425,1791724996,1791724996
48549552880,1645102651,67646,60000000000,62846,,,
119695364133,1642518419,334322,121195364133,334322,156701798332,1500000000,1500000000
70878887443,1649151193,60850,72378887443,56050,76358424120,1500000000,1500000000
18691510013,1648108235,67634,20191510013,62834,25245717768,1500000000,1500000000
34702913562,1648095641,67634,36202913562,67634,49809340312,1500000000,1500000000
34097300093,1646837830,313467,35597300093,313467,42740614893,1500000000,1500000000
71183798107,1642590339,312323,72683798107,312323,95393788220,1500000000,1500000000
47989944042,1649155843,323646,49489944042,323646,68096434030,1500000000,1500000000
47989944042,1649155843,48603,49489944042,43803,68096434030,1500000000,1500000000
30660254960,1645434719,336891,41702152117,336891,,,
75726972531,1645460469,55584,77226972531,50784,92413318832,1500000000,1500000000
30099096808,1648102587,322816,31599096808,322816,37924575635,1500000000,1500000000
41805046760,1650424622,60850,43305046760,60850,56693865648,1500000000,1500000000
65422298025,1642591066,55636,67922298025,55636,118809248362,2500000000,2500000000
78088343016,1642569278,314073,80000000000,314073,80000000000,2000000000,1911656984
78088343016,1642569278,319783,80000000000,319783,80000000000,2000000000,1911656984
119044899254,1642552131,319787,120544899254,319787,128127052569,1500000000,1500000000
112248429895,1642636772,326097,113748429895,326097,132744682364,1500000000,1500000000
81472107133,1649198365,60838,82972107133,56038,97389752515,1500000000,1500000000
27951462226,1648124803,67634,29451462226,62834,44050024258,1500000000,1500000000
35907199606,1648106372,319685,37407199606,319685,51987574474,1500000000,1500000000
31647782320,1650493741,315253,33147782320,315253,35000000000,1500000000,1500000000
20148763363,1646832856,67634,21648763363,62834,30341347310,1500000000,1500000000
64801859713,1649200516,56516,66301859713,51716,75219077787,1500000000,1500000000
34426108685,1648100439,67634,35926108685,62834,52112935392,1500000000,1500000000
37421792486,1648086827,322490,38921792486,322490,43000000000,1500000000,1500000000
52671208002,1648132324,55580,54171208002,55580,56439160554,1500000000,1500000000
32396303936,1650441936,67622,33896303936,67622,43577894933,1500000000,1500000000
72561010658,1645056953,55584,74061010658,50784,77805715929,1500000000,1500000000
57418094349,1649132953,333710,58918094349,333710,63325432574,1500000000,1500000000
51233909743,1649140952,67634,52733909743,67634,72978897419,1500000000,1500000000
139701708645,1645480674,329970,141201708645,329970,142040220553,1500000000,1500000000
48102945816,1644558960,307807,49602945816,307807,65310901519,1500000000,1500000000
40307382971,1646799055,67646,41807382971,62846,54775333118,1500000000,1500000000
37073330180,1646843193,66730,38573330180,61930,43581441033,1500000000,1500000000
90843551532,1642465211,67634,92343551532,62834,131496025279,1500000000,1500000000
24015567931,1648103447,310159,25515567931,310159,31153558559,1500000000,1500000000
45985426894,1650457700,64729,47485426894,59929,58168413335,1500000000,1500000000
45985426894,1650457700,60850,47485426894,60850,58168413335,1500000000,1500000000
59628661336,1650468073,60850,61128661336,56050,79666050883,1500000000,1500000000
33993668210,1646838448,318480,35493668210,318480,39275676463,1500000000,1500000000
81755227414,1642500416,66742,83255227414,66742,118011221987,1500000000,1500000000
71166155513,1649170745,322953,72666155513,322953,111445274682,1500000000,1500000000
55489888405,1645441489,60926,56989888405,60926,68651151603,1500000000,1500000000
33511009243,1648098347,60862,35011009243,56062,47856098367,1500000000,1500000000
28927649424,1648101182,55705,30427649424,50905,39984866233,1500000000,1500000000
29372730209,1648130351,54521,30872730209,54521,37256484870,1500000000,1500000000
53834903282,1648081022,67646,55334903282,62846,82092282124,1500000000,1500000000
87572391442,1650485013,67622,89072391442,67622,111292207397,1500000000,1500000000
37523301309,1646813922,67634,39023301309,67634,52332323915,1500000000,1500000000
37222156627,1650419928,64729,38722156627,59929,46977773703,1500000000,1500000000
86583873483,1650469382,67734,88083873483,67734,113545131092,1500000000,1500000000
82537257342,1645123766,60938,84037257342,60938,85000000000,1500000000,1500000000
87086841087,1645113713,340015,88586841087,340015,101598106897,1500000000,1500000000
79496149670,1645107302,55717,80996149670,50917,94580947522,1500000000,1500000000
79086442089,1642586810,60850,80586442089,56050,100020306735,1500000000,1500000000
93678137915,1642519896,334316,95178137915,334316,113993628678,1500000000,1500000000
63821236158,1649148745,60862,65321236158,56062,82616751684,1500000000,1500000000
39121666674,1645438496,60926,40621666674,60926,53473594990,1500000000,1500000000
90030452602,1645476586,343179,91530452602,343179,139400600345,1500000000,1500000000
23370492418,1648114435,55705,24870492418,50905,32739296053,1500000000,1500000000
103718208017,1644609863,52928,105218208017,48128,138277242917,1500000000,1500000000
24691983075,1646803988,60938,25191983075,56138,28000000000,500000000,500000000
35888354078,1646815049,67646,37388354078,62846,53243512377,1500000000,1500000000
100567050980,1642603205,60862,102067050980,56062,104369467225,1500000000,1500000000
96056680004,1642573789,67646,97556680004,62846,129802600903,1500000000,1500000000
37777966671,1645447585,56729,39277966671,47129,55151676320,1500000000,1500000000
59497983713,1648131712,306010,60997983713,306010,88014041435,1500000000,1500000000
59497983713,1648131712,60862,60997983713,56062,88014041435,1500000000,1500000000
28403442540,1650451932,54712,29403442540,49912,30000000000,1000000000,1000000000
48622107966,1650468709,63200,50122107966,63200,92322049320,1500000000,1500000000
28615568673,1645088823,325663,30115568673,325663,31000000000,1500000000,1500000000
22856286428,1648108559,317839,24356286428,317839,37444886858,1500000000,1500000000
38045979255,1646812664,63200,40545979255,63200,63303034280,2500000000,2500000000
124161438665,1642518409,67634,125661438665,67634,151366138193,1500000000,1500000000
68693649929,1649127507,55592,70193649929,50792,82858205257,1500000000,1500000000
41228033162,1649143470,54739,50000000000,49939,,,
36742026242,1648114288,67622,38242026242,67622,47398640458,1500000000,1500000000
34105089601,1648161727,319731,35605089601,319731,51211497593,1500000000,1500000000
113808653191,1642519349,319723,115308653191,319723,128449995489,1500000000,1500000000
190160273561,1642544695,326808,191660273561,326808,192337665737,1500000000,1500000000
137284531509,1642537266,56516,139284531509,51716,187548185953,2000000000,2000000000
28614033591,1648127566,67646,30614033591,67646,40735832441,2000000000,2000000000
56593870101,1650428816,67634,58093870101,62834,67456375843,1500000000,1500000000
40392845961,1646856158,67646,41892845961,62846,51514610134,1500000000,1500000000
26217572853,1646794279,60938,27217572853,56138,30000000000,1000000000,1000000000
77199755701,1645109809,67646,78699755701,62846,105152651694,1500000000,1500000000
91537837776,1645136856,54921,93037837776,50121,400000000000,1500000000,1500000000
28171849227,1648107691,55592,29671849227,50792,33477461658,1500000000,1500000000
26843017337,1648115813,60862,28343017337,56062,39215718582,1500000000,1500000000
74212493538,1648133374,67634,76212493538,67634,100671971301,2000000000,2000000000
186200541302,1650476743,60862,187700541302,56062,207863112530,1500000000,1500000000
146925625906,1642545081,55717,148925625906,50917,217452031473,2000000000,2000000000
29823592379,1646851037,67634,31323592379,62834,32285314232,1500000000,1500000000
23720528310,1646817312,60938,24720528310,56138,25000000000,1000000000,1000000000
23720528310,1646817312,60926,24720528310,56126,25000000000,1000000000,1000000000
69617640073,1645059832,329298,71617640073,329298,84286084242,2000000000,2000000000
131497965421,1642535628,55636,133997965421,55636,261313090726,2500000000,2500000000
40366083251,1649151633,67622,41866083251,67622,58976730005,1500000000,1500000000
34234202281,1645433623,60950,35734202281,56150,56901461684,1500000000,1500000000
59898929455,1648131543,67634,61398929455,67634,77995603352,1500000000,1500000000
40528245714,1646802112,67646,42028245714,62846,63782456830,1500000000,1500000000
42116676925,1645083452,55717,43616676925,50917,54985970689,1500000000,1500000000
42116676925,1645083452,55717,43616676925,50917,60130468513,1500000000,1500000000
93318605374,1642555030,48651,94818605374,43851,109136087933,1500000000,1500000000
48205598054,1649142642,60838,49705598054,60838,58489630292,1500000000,1500000000
37607293880,1650413619,63200,39107293880,63200,85945174896,1500000000,1500000000
27483539309,1646854204,60862,28983539309,56062,33411173365,1500000000,1500000000
21784971852,1646832096,55644,24284971852,55644,51628575036,2500000000,2500000000
39265776322,1646784309,67710,40765776322,67710,56926047530,1500000000,1500000000
39844060194,1646862184,67634,41344060194,62834,56418989183,1500000000,1500000000
81444260371,1642594078,326822,82944260371,326822,85000000000,1500000000,1500000000
54647277109,1649142418,55693,56147277109,50893,60752547694,1500000000,1500000000
60906749693,1645426665,332446,62406749693,332446,69202022458,1500000000,1500000000
47611212128,1648161996,334310,49111212128,334310,51830362114,1500000000,1500000000
45436944901,1650440889,66778,46936944901,66778,52605933082,1500000000,1500000000
57184373880,1644560628,317889,58684373880,317889,59677517042,1500000000,1500000000
48665890957,1644584726,350197,50165890957,350197,51000000000,1500000000,1500000000
60484596989,1649197416,54908,61984596989,50108,85522569943,1500000000,1500000000
28571943194,1648130487,67646,30071943194,62846,40456740278,1500000000,1500000000
24133922003,1648104948,319665,25633922003,319665,34261983839,1500000000,1500000000
24133922003,1648104948,313352,26133922003,313352,35651045096,2000000000,2000000000
19974459400,1648113927,67634,22000000000,67634,,,
97719350208,1650478631,67634,99219350208,62834,114790628012,1500000000,1500000000
82436273024,1642496685,52916,83936273024,48116,114814331635,1500000000,1500000000
69274441272,1649117314,67634,70774441272,67634,78480482164,1500000000,1500000000
28913443337,1648130240,67634,30413443337,67634,36642075037,1500000000,1500000000
66457065501,1650487796,54789,67957065501,49989,94613149855,1500000000,1500000000
52334129252,1649161073,60850,53834129252,56050,60612357697,1500000000,1500000000
56324629824,1648132615,55592,57824629824,50792,71238769822,1500000000,1500000000
56324629824,1648132615,67646,57824629824,62846,72592960983,1500000000,1500000000
37870243741,1646789145,55580,39870243741,55580,51215675175,2000000000,2000000000
115572582328,1645406589,54772,117478249594,49972,117478249594,3300000000,1905667266
98110934425,1644610489,346342,99610934425,346342,121589539259,1500000000,1500000000
98110934425,1644610489,417527,99610934425,417527,115464536158,1500000000,1500000000
27964403800,1646822160,67634,29464403800,67634,38350245043,1500000000,1500000000
57266496976,1646799147,55592,58766496976,50792,63353809477,1500000000,1500000000
56834893020,1649133247,67646,58334893020,62846,65005099752,1500000000,1500000000
23590192937,1648124637,67634,25090192937,67634,27454937104,1500000000,1500000000
23590192937,1648124637,60850,25090192937,56050,27454937104,1500000000,1500000000
25376748145,1646817654,60862,26876748145,56062,28089398238,1500000000,1500000000
117000377931,1642548019,331991,118500377931,331991,135108469389,1500000000,1500000000
32445711221,1648122110,67646,33945711221,62846,42734955399,1500000000,1500000000
31507298317,1648119729,67646,33007298317,62846,46880983773,1500000000,1500000000
18267195086,1646828848,67646,19767195086,62846,26245807772,1500000000,1500000000
45104438923,1646847730,67646,46604438923,62846,75061232120,1500000000,1500000000
64982650839,1642570147,60850,66482650839,56050,104104320228,1500000000,1500000000
21633844704,1648124374,55592,23133844704,50792,28296238282,1500000000,1500000000
62218825715,1644588166,314112,63718825715,314112,95766607104,1500000000,1500000000
18675713250,1646827348,310862,20175713250,310862,25625831173,1500000000,1500000000
27735661941,1648126598,67646,44000000000,67646,,,
32417869044,1648099424,67646,33917869044,62846,38597694695,1500000000,1500000000
30301784067,1648119944,67622,31432651955,67622,31432651955,1500000000,1130867888
21367069420,1648113886,336905,22867069420,336905,22972501362,1500000000,1500000000
50070705014,1648086540,55580,51570705014,50780,53802799410,1500000000,1500000000
70245820452,1648080858,60850,71745820452,56050,89553589577,1500000000,1500000000
54900407266,1650465078,326834,56400407266,326834,75559735355,1500000000,1500000000
47612484130,1646814292,67622,49112484130,67622,60026084175,1500000000,1500000000
34924915242,1646845313,316640,36424915242,316640,51765912729,1500000000,1500000000
55484307924,1648131433,64056,56984307924,59256,59832285364,1500000000,1500000000
47066196509,1644571729,55705,48566196509,50905,64196663693,1500000000,1500000000
35960284093,1646811649,54308,37960284093,49508,52364786621,2000000000,2000000000
24696177658,1646817345,60926,25000000000,56126,25000000000,500000000,303822342
21761963545,1646830043,60850,23261963545,56050,27372134707,1500000000,1500000000
32499971312,1646861545,66033,33999971312,55230,40000000000,1500000000,1500000000
113107351233,1642516710,319281,114607351233,319281,159786954419,1500000000,1500000000
72157424704,1645117553,60950,73657424704,60950,98642830858,1500000000,1500000000
69807373149,1645462637,54739,71307373149,49939,75100000000,1500000000,1500000000
40988236769,1650488218,67634,42488236769,62834,51289755382,1500000000,1500000000
40988236769,1650488218,60850,42488236769,56050,69506768450,1500000000,1500000000
36483033794,1646845725,325645,37983033794,325645,55171661248,1500000000,1500000000
95787362608,1642481617,326205,97287362608,326205,107626469410,1500000000,1500000000
35150155532,1650438567,60838,36650155532,60838,53234733735,1500000000,1500000000
83763867488,1642574725,67646,85263867488,62846,126810646763,1500000000,1500000000
151708341675,1642543071,67634,153208341675,62834,178562848568,1500000000,1500000000
96712164912,1642537995,306510,98212164912,306510,99803566523,1500000000,1500000000
99820622529,1642487956,67646,101320622529,62846,132628416373,1500000000,1500000000
16341507489,1648110408,60850,17841507489,56050,20280011393,1500000000,1500000000
72780604514,1642498364,56604,74280604514,51804,78968048692,1500000000,1500000000
89664628567,1649167314,320515,91164628567,320515,112351450628,1500000000,1500000000
30051628897,1648104958,306957,31551628897,306957,35436096850,1500000000,1500000000
45334730668,1650457660,330559,46834730668,330559,53536043913,1500000000,1500000000
42380078244,1650446299,67646,43880078244,62846,50807247679,1500000000,1500000000
31971009215,1646855497,349552,33471009215,349552,41923513278,1500000000,1500000000
65548739508,1645403487,333698,66823193429,333698,66823193429,1500000000,1274453921
37664131390,1648100408,67634,38705857614,67634,38705857614,1500000000,1041726224
22844301976,1648105629,315506,24344301976,315506,33763415628,1500000000,1500000000
58245915593,1650486859,317294,59745915593,317294,65447000153,1500000000,1500000000
52516820943,1646858324,60850,54016820943,56050,54037285574,1500000000,1500000000
91287046121,1642537599,55636,93787046121,55636,205227169648,2500000000,2500000000
45544623500,1649162650,59982,46954623500,55182,50471087815,1410000000,1410000000
97000793167,1649194768,56516,98500793167,51716,138048267413,1500000000,1500000000
30858806038,1648120447,60862,31398454365,56062,31398454365,1500000000,539648327
242091393046,1650472491,63200,243591393046,63200,433219717978,1500000000,1500000000
63006010338,1645106862,55776,64506010338,55776,71564317608,1500000000,1500000000
69516868279,1645069294,64717,71016868279,59917,89775802053,1500000000,1500000000
37649646952,1648127237,55693,38701418218,50893,38701418218,1500000000,1051771266
37649646952,1648127237,60862,38701418218,56062,38701418218,1500000000,1051771266
46820612001,1648132311,67646,48820612001,62846,59136726976,2000000000,2000000000
32122361773,1648097437,319647,33542459710,319647,33542459710,1500000000,1420097937
46904374810,1645083365,323648,48404374810,323648,53621565990,1500000000,1500000000
56456256337,1645085946,67622,57956256337,67622,62096672220,1500000000,1500000000
71839066493,1645120381,60938,73339066493,60938,110480278709,1500000000,1500000000
118595901020,1642531133,303393,120095901020,303393,161212027514,1500000000,1500000000
102526518662,1642521729,317210,104026518662,317210,128963561065,1500000000,1500000000
23314192756,1648125400,55592,24814192756,50792,33153666532,1500000000,1500000000
50501917574,1649149373,54748,52001917574,49948,60000000000,1500000000,1500000000
57586700510,1645444041,52916,59086700510,52916,75813586304,1500000000,1500000000
78521287384,1650467217,63200,80021287384,63200,156380703860,1500000000,1500000000
47250891098,1644573228,322960,48750891098,322960,60528445725,1500000000,1500000000
27171935066,1646825802,55592,28671935066,50792,37806447880,1500000000,1500000000
59085951910,1645118321,66778,60585951910,61978,81669803572,1500000000,1500000000
59085951910,1645118321,54783,60585951910,49983,82671926116,1500000000,1500000000
60554161821,1648137121,67634,62054161821,62834,85231034815,1500000000,1500000000
53006978140,1648131855,60850,55000000000,56050,,,
36053583694,1648095518,67646,37553583694,62846,53881574902,1500000000,1500000000
43171051055,1650434692,67646,44671051055,62846,47326329593,1500000000,1500000000
52499353829,1644550018,60850,53122975228,60850,53122975228,1520000000,623621399
88836124181,1644607188,328040,90000000000,328040,90000000000,1500000000,1163875819
89359156993,1645060434,332311,90859156993,332311,110000000000,1500000000,1500000000
69053595320,1642510359,323559,70553595320,323559,71672377984,1500000000,1500000000
127662046095,1642516153,317342,129162046095,317342,154563127995,1500000000,1500000000
70057444395,1649180795,60850,71557444395,56050,89516996172,1500000000,1500000000
34430075441,1648098903,60850,35930075441,56050,39946430602,1500000000,1500000000
51358506593,1648160106,54921,52858506593,50121,69657216467,1500000000,1500000000
22109034741,1648102297,55592,23609034741,50792,29425378085,1500000000,1500000000
42289059606,1648160923,67622,43789059606,67622,59543014337,1500000000,1500000000
32949370559,1646868881,64056,34449370559,59256,44493052333,1500000000,1500000000
119048170704,1642605789,319745,120548170704,319745,139161993977,1500000000,1500000000
118212809309,1642517559,67646,119712809309,62846,149222397980,1500000000,1500000000
103555679820,1642490916,66754,105055679820,61954,117867016507,1500000000,1500000000
56531716286,1649155059,67646,58031716286,62846,59190496469,1500000000,1500000000
56531716286,1649155059,66754,58031716286,66754,59190496469,1500000000,1500000000
76335626199,1648133349,49483,77835626199,49483,96380601109,1500000000,1500000000
25621839120,1648114565,53486,27121839120,48686,36324527723,1500000000,1500000000
52153755168,1650425094,67634,53653755168,67634,56219035594,1500000000,1500000000
47124790253,1644559165,336337,48624790253,336337,67482797675,1500000000,1500000000
28832081661,1646868246,55580,30332081661,50780,30438313794,1500000000,1500000000
73458274890,1642594249,66730,74958274890,66730,110638472617,1500000000,1500000000
92745121759,1642474626,55636,95245121759,55636,205578804874,2500000000,2500000000
66799482823,1649133996,67634,68299482823,62834,81038487147,1500000000,1500000000
30140936799,1648131233,67634,31421880165,67634,32918237658,1280943366,1280943366
362816281874,1650474319,67646,364316281874,62846,466192840373,1500000000,1500000000
87794369464,1644617844,64741,89294369464,59941,112813320009,1500000000,1500000000
33731427401,1646803481,66766,35731427401,61966,52422473273,2000000000,2000000000
42395842534,1645083243,55717,43895842534,46117,48757941150,1500000000,1500000000
109720250497,1642607062,317288,111220250497,317288,125309881300,1500000000,1500000000
146687758208,1642631073,323038,148187758208,323038,214656628207,1500000000,1500000000
109423787095,1642522747,52928,110923787095,48128,145099154080,1500000000,1500000000
43870260188,1649151514,328330,45370260188,328330,200000000000,1500000000,1500000000
49857665785,1649155915,66742,51357665785,61942,61487430053,1500000000,1500000000
33682178751,1648096206,321895,35182178751,321895,35418586988,1500000000,1500000000
121840309783,1642607112,60850,123340309783,60850,136882307883,1500000000,1500000000
105859470569,1642522174,60862,107359470569,56062,128138820553,1500000000,1500000000
46293010894,1649151825,67634,47793010894,67634,48839325753,1500000000,1500000000
43801099461,1649129964,67634,45301099461,67634,57376971332,1500000000,1500000000
35759901144,1648116060,60838,37259901144,60838,43254402569,1500000000,1500000000
46864661304,1650488787,312143,48364661304,312143,53603183107,1500000000,1500000000
39524499272,1644582201,60006,41024499272,55206,54663830160,1500000000,1500000000
52767535986,1646814439,55580,54267535986,55580,56992904410,1500000000,1500000000
50961318462,1645108467,346362,52461318462,346362,87314903215,1500000000,1500000000
111425311008,1642521332,331157,112925311008,331157,150242589543,1500000000,1500000000
53954598058,1649176320,60874,55454598058,56074,64817585399,1500000000,1500000000
37073018520,1649159180,66742,38573018520,61942,60833581175,1500000000,1500000000
48148928643,1650413713,323537,48634140404,323537,48634140404,1500000000,485211761
43527844290,1650495972,67634,45027844290,67634,67189779298,1500000000,1500000000
43527844290,1650495972,60850,45027844290,56050,60609575403,1500000000,1500000000
71168491296,1650478856,322955,72578491296,322955,81974427531,1410000000,1410000000
58958424411,1644562629,55693,60458424411,50893,84610424619,1500000000,1500000000
41825732897,1646844621,60850,43613465421,60850,48508534729,1787732524,1787732524
23601012370,1646829643,60862,25101012370,56062,26307084999,1500000000,1500000000
77254922733,1642497176,60862,78754922733,56062,105137860713,1500000000,1500000000
51990407626,1649129282,54676,53490407626,49876,70486311652,1500000000,1500000000
54189394908,1645415603,55680,55689394908,50880,80896167888,1500000000,1500000000
20921662003,1648121195,55580,22421662003,55580,24724208193,1500000000,1500000000
42609840391,1650457974,60862,44109840391,56062,63469139725,1500000000,1500000000
100077142565,1642606334,328316,101577142565,328316,111353632130,1500000000,1500000000
72864181123,1642598640,64705,74006554877,59905,74006554877,1500000000,1142373754
39917584830,1649144542,60838,41417584830,60838,54058360638,1500000000,1500000000
39917584830,1649144542,336885,41417584830,336885,54058360638,1500000000,1500000000
81194021102,1645459699,54736,82694021102,49936,96300837722,1500000000,1500000000
81194021102,1645459699,60862,82694021102,56062,114340808990,1500000000,1500000000
19115209647,1648118553,67634,20615209647,67634,24889782479,1500000000,1500000000
84147828510,1642584512,66935,85647828510,56050,98000000000,1500000000,1500000000
214630147549,1650474785,67734,216130147549,62934,305907509017,1500000000,1500000000
38657050721,1650434304,67646,40157050721,62846,58472497677,1500000000,1500000000
40950129642,1650445886,60850,42450129642,56050,55349582214,1500000000,1500000000
58276840487,1645104202,60030,59776840487,55230,79313084424,1500000000,1500000000
128562407080,1642545963,60030,130062407080,55230,144407770095,1500000000,1500000000
26665206107,1648097971,67646,28165206107,62846,39497926945,1500000000,1500000000
32040877721,1648132767,67634,33540877721,62834,40257703315,1500000000,1500000000
32040877721,1648132767,67634,33540877721,67634,40257703315,1500000000,1500000000
40897552257,1648096309,67658,42397552257,62858,43602723439,1500000000,1500000000
36309870178,1650430713,55705,37809870178,50905,50472387879,1500000000,1500000000
46463168419,1650428280,64729,47963168419,59929,64223606183,1500000000,1500000000
61757301055,1642572994,56516,63257301055,51716,87497729605,1500000000,1500000000
34057408965,1648127455,323664,35557408965,323664,39147630680,1500000000,1500000000
24822226454,1648116763,60838,26322226454,60838,34225293945,1500000000,1500000000
44908855659,1650413730,51428,46408855659,51428,96735480066,1500000000,1500000000
100747103821,1642486187,60850,102247103821,60850,111137037635,1500000000,1500000000
25304959853,1648113549,54322,26940265848,54322,27000000000,1635305995,1635305995
129045590903,1642563158,54860,130545590903,50060,142224449748,1500000000,1500000000
101960796022,1642490258,64044,103460796022,59244,144243102953,1500000000,1500000000
41897704824,1649130358,320487,43397704824,320487,58920471934,1500000000,1500000000
89897761368,1645404165,332605,91397761368,332605,123199310133,1500000000,1500000000
89897761368,1645404165,346352,91397761368,346352,123199310133,1500000000,1500000000
40466906052,1648091398,55592,41966906052,50792,52327026545,1500000000,1500000000
36523321120,1650415088,51428,38023321120,51428,75290055358,1500000000,1500000000
50601001441,1646842522,54346,52601001441,49546,67237023339,2000000000,2000000000
32744834463,1646840722,67646,34244834463,62846,42000000000,1500000000,1500000000
69501350677,1645130478,67634,71151350678,62834,92495477522,1650000001,1650000001
111268485298,1642464474,67634,112768485298,67634,147059758567,1500000000,1500000000
46772436252,1645414483,329294,48272436252,329294,57296337238,1500000000,1500000000
78691584800,1645479483,67646,80191584800,67646,115137681988,1500000000,1500000000
25590237308,1648105403,54354,27090237308,49554,39380613028,1500000000,1500000000
77060697043,1648143558,56717,78560697043,47117,82252972228,1500000000,1500000000
38091013037,1646793464,67634,39155438378,67634,39155438378,1500000000,1064425341
110404626639,1642566516,60850,111904626639,56050,153896142759,1500000000,1500000000
94501155968,1642496202,55636,97001155968,55636,202375823606,2500000000,2500000000
42443187010,1649145920,67646,43943187010,67646,53277140473,1500000000,1500000000
21894050314,1648116203,67634,23394050314,62834,28895999428,1500000000,1500000000
19943328988,1648124109,60850,21443328988,60850,21853867203,1500000000,1500000000
58062924161,1650425012,60838,59562924161,60838,80136335928,1500000000,1500000000
53230008719,1650424442,67710,54730008719,67710,68448049072,1500000000,1500000000
32687803537,1650452552,333163,34187803537,333163,50285753262,1500000000,1500000000
24444367848,1646810297,334296,25944367848,334296,31147002155,1500000000,1500000000
91589949608,1642602461,340067,93089949608,340067,122754817533,1500000000,1500000000
78004892356,1642478985,56604,79504892356,51804,96508658123,1500000000,1500000000
28391785935,1648097672,67634,29891785935,62834,41631029550,1500000000,1500000000
35082114437,1646794131,67622,36582114437,67622,44801410097,1500000000,1500000000
92142288046,1645132758,67622,93859756097,67622,135932955689,1717468051,1717468051
121158720996,1642609343,60850,122658720996,56050,195167491494,1500000000,1500000000
122446760008,1642535092,55636,124946760008,55636,261005811412,2500000000,2500000000
53448489449,1649155795,66766,54948489449,66766,76253934238,1500000000,1500000000
42375049624,1648128574,67634,43875049624,67634,48853426979,1500000000,1500000000
67661668869,1650485981,332384,72661668869,332384,220000000000,5000000000,5000000000
38535579596,1650416478,337474,40035579596,337474,59474332592,1500000000,1500000000
42833032581,1646840455,67646,43259728395,62846,43259728395,1500000000,426695814
29367046527,1646808186,67646,30867046527,62846,40544937467,1500000000,1500000000
63838522878,1645084298,56516,65838522878,51716,177000000000,2000000000,2000000000
117690318369,1642634438,60850,119190318369,56050,145048500223,1500000000,1500000000
35843401796,1650431110,323612,37343401796,323612,38011653045,1500000000,1500000000
16983310766,1646826645,67646,18483310766,62846,35173229007,1500000000,1500000000
26530289949,1646835271,317210,28030289949,317210,42334819024,1500000000,1500000000
183691783796,1642618354,60850,185191783796,60850,225583232423,1500000000,1500000000
72921457528,1642502346,330479,74421457528,330479,101124285578,1500000000,1500000000
29312140219,1648092194,55568,30812140219,55568,38358787248,1500000000,1500000000
17843071232,1646826681,67646,19343071232,62846,23592250273,1500000000,1500000000
109913080753,1642482982,315495,111413080753,315495,127924564074,1500000000,1500000000
37756891223,1646788543,55720,39256891223,50920,200000000000,1500000000,1500000000
87984637521,1645131383,54771,89484637521,49971,109795470744,1500000000,1500000000
62154940590,1648154545,343225,63654940590,343225,67630591869,1500000000,1500000000
53301646061,1650488627,332426,54801646061,332426,64101769145,1500000000,1500000000
29108686854,1648129007,67646,30608686854,67646,33000000000,1500000000,1500000000
29108686854,1648129007,67634,50000000000,67634,,,
44808761384,1648161097,330555,46308761384,330555,49827723729,1500000000,1500000000
22003020862,1648107846,60850,23503020862,56050,30578174880,1500000000,1500000000
25922180922,1648103410,67634,27422180922,67634,36829537874,1500000000,1500000000
52892634725,1650493270,60006,54392634725,55206,72607916907,1500000000,1500000000
31713848366,1650449607,323638,33213848366,323638,42575238099,1500000000,1500000000
20337933996,1646810829,56516,22337933996,51716,26557194132,2000000000,2000000000
88927103212,1642590550,329254,90427103212,329254,119861618450,1500000000,1500000000
79964270608,1642500727,333101,81464270608,333101,105863761757,1500000000,1500000000
59967401265,1649172333,328228,61467401265,328228,76818087094,1500000000,1500000000
50958340386,1648133101,67634,52458340386,67634,66454427449,1500000000,1500000000
50283122609,1648132899,60862,52283122609,56062,62030040949,2000000000,2000000000
56695908809,1648090077,67646,58195908809,62846,60448856813,1500000000,1500000000
36458543454,1650451379,329928,37958543454,329928,40607676877,1500000000,1500000000
38983333607,1650494604,48675,40483333607,43875,54158791592,1500000000,1500000000
47020477725,1649148307,67634,48520477725,67634,63543924157,1500000000,1500000000
48404756101,1650493191,67722,49404756101,62922,50407642769,1000000000,1000000000
36840077554,1650420048,67634,38780077554,62834,50662572915,1940000000,1940000000
174043632341,1642516517,327305,175543632341,327305,193634213554,1500000000,1500000000
110837216622,1645485794,66730,112337216622,66730,130063383553,1500000000,1500000000
19703204393,1648105785,67634,21203204393,67634,27592534805,1500000000,1500000000
26272896449,1648107300,319677,27772896449,319677,31225789728,1500000000,1500000000
53236386437,1650461612,67646,54736386437,67646,62087594173,1500000000,1500000000
28659478446,1646810586,67634,30159478446,67634,42822788205,1500000000,1500000000
84782470379,1642595650,340003,86282470379,340003,93370987687,1500000000,1500000000
84792982156,1649190779,48675,86292982156,43875,115043565510,1500000000,1500000000
16829480745,1648110646,67634,18329480745,62834,20162006988,1500000000,1500000000
26487438809,1648127514,55580,27987438809,50780,34348682165,1500000000,1500000000
47796859510,1650415578,67634,49296859510,67634,56763236255,1500000000,1500000000
30352741772,1650454690,67634,31852741772,62834,42918313459,1500000000,1500000000
61371676688,1644622526,320495,62871676688,320495,65693930488,1500000000,1500000000
43058572808,1646784643,67646,44558572808,62846,44667520435,1500000000,1500000000
29726502415,1648096056,319647,31226502415,319647,39541431574,1500000000,1500000000
33352316108,1648127001,60850,34852316108,60850,42690330300,1500000000,1500000000
55945221265,1646796602,55636,57445221265,50836,71047039758,1500000000,1500000000
19960869358,1646823809,60850,21460869358,60850,26503301255,1500000000,1500000000
85452935887,1642565979,323559,86952935887,323559,104129651698,1500000000,1500000000
156081032966,1642522564,56504,157581032966,51704,189223362177,1500000000,1500000000
56692132529,1649147390,60838,58192132529,60838,77149873297,1500000000,1500000000
39300088531,1646814540,55580,40300088531,55580,42620772838,1000000000,1000000000
95130968146,1642495183,60838,96630968146,60838,121521161228,1500000000,1500000000
57097624097,1649159527,60862,58597624097,56062,66744861277,1500000000,1500000000
75844874816,1645444615,49495,77344874816,49495,106601719024,1500000000,1500000000
27494136966,1648125725,53498,28994136966,48698,33432233303,1500000000,1500000000
20327509776,1648121390,67622,21827509776,67622,26506517690,1500000000,1500000000
52123348633,1648160704,319773,53623348633,319773,60090559938,1500000000,1500000000
56630235559,1650483294,55580,58130235559,55580,98793755160,1500000000,1500000000
70578018465,1644611039,326070,72078018465,326070,106292188648,1500000000,1500000000
75446673366,1642583188,55636,77946673366,55636,163271077416,2500000000,2500000000
153471496198,1642631334,60838,154971496198,60838,231083104140,1500000000,1500000000
91898902948,1642502055,320467,93398902948,320467,106521083783,1500000000,1500000000
81253385986,1645477575,54849,83753385986,54849,171987939850,2500000000,2500000000
23671540864,1648130290,66766,25171540864,66766,28785283430,1500000000,1500000000
212526078574,1650472824,48651,214026078574,43851,254493189395,1500000000,1500000000
77277574664,1644549574,54332,78777574664,49532,98018735802,1500000000,1500000000
69638613875,1642593509,67634,71138613875,62834,94728360878,1500000000,1500000000
74805744119,1642593561,55693,76305744119,50893,88548267344,1500000000,1500000000
41907454355,1645428268,302165,43407454355,302165,60690135540,1500000000,1500000000
25789640929,1648107775,67634,27289640929,67634,36012726877,1500000000,1500000000
79624670380,1645128837,315305,81124670380,315305,102210350348,1500000000,1500000000
39813873336,1648095186,60850,41313873336,60850,53886420669,1500000000,1500000000
28990252382,1648130096,67634,30990252382,67634,40458408226,2000000000,2000000000
53626273518,1650462291,60862,55126273518,56062,66825749568,1500000000,1500000000
24544144418,1646819170,310922,26044144418,310922,33049473453,1500000000,1500000000
70530375209,1645115423,48627,72030375209,43827,96402181277,1500000000,1500000000
47119068979,1645084043,52916,48619068979,48116,59702718259,1500000000,1500000000
46283758194,1649161147,67634,47783758194,67634,60166516397,1500000000,1500000000
48067403499,1649137138,317318,49567403499,317318,200000000000,1500000000,1500000000
55953834329,1649140831,67646,57453834329,62846,78970124690,1500000000,1500000000
49197095911,1645438755,67722,50697095911,67722,63477667068,1500000000,1500000000
59110420048,1648080735,67634,60610420048,62834,62047404892,1500000000,1500000000
26496158956,1648123352,60862,27996158956,56062,33694367678,1500000000,1500000000
21398189147,1648108355,55580,22898189147,50780,25089817810,1500000000,1500000000
40471914737,1650417984,55717,42471914737,50917,55914074352,2000000000,2000000000
121256916273,1644615077,60850,122756916273,56050,157666152234,1500000000,1500000000
29480196034,1646822147,55693,30980196034,50893,40384675142,1500000000,1500000000
125829951921,1642533493,322947,127329951921,322947,143561759317,1500000000,1500000000
58975262229,1649200454,56492,60475262229,51692,84994814135,1500000000,1500000000
42314234736,1645105227,55693,43814234736,50893,49241941724,1500000000,1500000000
35959522233,1650422504,55740,37459522233,50940,50902841523,1500000000,1500000000
35959522233,1650422504,55580,37459522233,50780,50902841523,1500000000,1500000000
62534155826,1650465927,60850,64034155826,60850,87130240783,1500000000,1500000000
43612270821,1644593997,310900,45112270821,310900,51000000000,1500000000,1500000000
34756822600,1646846240,67658,36256822600,62858,44822328297,1500000000,1500000000
18118601959,1646833320,60862,19618601959,56062,28855372215,1500000000,1500000000
18118601959,1646833320,60850,19618601959,56050,28855372215,1500000000,1500000000
62742658468,1645125770,55717,64242658468,50917,80245053529,1500000000,1500000000
50822099231,1649200730,55720,52322099231,50920,200000000000,1500000000,1500000000
43933133892,1649191848,321907,45433133892,321907,64808755199,1500000000,1500000000
59221424568,1645449823,327994,60721424568,327994,66196431552,1500000000,1500000000
70530513310,1648137675,322840,72030513310,322840,72725924955,1500000000,1500000000
88315497484,1642574483,67634,89815497484,62834,94271854203,1500000000,1500000000
84166248047,1642569588,60838,85666248047,60838,104296116842,1500000000,1500000000
39837452190,1645437316,49483,41337452190,49483,59538814940,1500000000,1500000000
47637788532,1648094230,67634,49137788532,62834,58580737422,1500000000,1500000000
21235729039,1648118014,334324,22735729039,334324,27902069752,1500000000,1500000000
36293592924,1644575345,299422,37793592924,299422,56628454104,1500000000,1500000000
50367742241,1649131173,67634,51867742241,67634,53495090685,1500000000,1500000000
43495091507,1645428706,49507,44995091507,44707,65745130687,1500000000,1500000000
81818498378,1645452500,58600,83318498378,58600,115834834578,1500000000,1500000000
23923465919,1646868609,55693,25423465919,50893,34809738559,1500000000,1500000000
91983318530,1645110075,60042,93483318530,55242,122430917715,1500000000,1500000000
103036724320,1642602485,319717,105036724320,319717,118102357404,2000000000,2000000000
83682805481,1645402319,330012,85182805481,330012,94974024105,1500000000,1500000000
40824462643,1646839669,67622,42324462643,62822,48582384308,1500000000,1500000000
50238169713,1650492703,54736,51738169713,49936,57921136083,1500000000,1500000000
27990464497,1646803663,60938,28990464497,56138,30000000000,1000000000,1000000000
27990464497,1646803663,60938,28990464497,56138,30000000000,1000000000,1000000000
98824670079,1642557867,56504,100324670079,51704,122339696894,1500000000,1500000000
118812290884,1642512262,67634,120312290884,67634,123093247862,1500000000,1500000000
40157458681,1648091824,67622,41657458681,62822,56862824912,1500000000,1500000000
38995820974,1648162290,330567,40495820974,330567,52138993868,1500000000,1500000000
25866022161,1648119518,60850,27866022161,56050,34640980268,2000000000,2000000000
73432633848,1645140212,326264,80000000000,326264,,,
73855865218,1645454748,67634,75355865218,62834,105182052289,1500000000,1500000000
22165235625,1648114590,67634,23000000000,62834,23000000000,1000000000,834764375
43157352303,1648161792,321861,44657352303,321861,46624525900,1500000000,1500000000
60614285746,1648133153,55580,62114285746,50780,73146007709,1500000000,1500000000
60614285746,1648133153,60838,62114285746,56038,65197925483,1500000000,1500000000
30590585618,1648115759,53498,32090585618,48698,52245672452,1500000000,1500000000
23591544727,1646870204,55720,25091544727,50920,300000000000,1500000000,1500000000
19107627671,1646833852,55668,20607627671,50868,24122015123,1500000000,1500000000
72856214215,1645065627,60862,74356214215,56062,92918792080,1500000000,1500000000
116761434274,1642636695,321642,118261434274,321642,154291094818,1500000000,1500000000
116761434274,1642636695,327389,118261434274,327389,154291094818,1500000000,1500000000
66952065327,1642591860,340061,68452065327,340061,98977618693,1500000000,1500000000
166516736066,1642612688,326105,168016736066,326105,186710751264,1500000000,1500000000
158887059479,1642546370,55636,161387059479,55636,321222030146,2500000000,2500000000
36227911557,1650497427,67634,37727911557,62834,38000000000,1500000000,1500000000
45126230669,1646795408,67646,46133616440,62846,46133616440,2000000000,1007385771
16560366072,1646833469,60838,17000000000,60838,17000000000,1500000000,439633928
98817158056,1645133866,67622,100317158056,67622,100713574642,1500000000,1500000000
94461746282,1642510702,326753,95961746282,326753,110236107473,1500000000,1500000000
56193897299,1644582692,62139,57693897299,57339,59099312085,1500000000,1500000000
20063143108,1646821233,54861,22563143108,54861,44425254866,2500000000,2500000000
75980541574,1645137001,66766,77480541574,61966,94056903238,1500000000,1500000000
88572877351,1649169055,66790,90072877351,61990,90973887640,1500000000,1500000000
19119192772,1648111692,60850,20619192772,60850,34429336618,1500000000,1500000000
38416674023,1648132805,67634,39328793603,67634,39328793603,1500000000,912119580
38416674023,1648132805,67634,39916674023,67634,41551097152,1500000000,1500000000
29472020426,1648106157,310343,30972020426,310343,34472854329,1500000000,1500000000
55862863154,1644588216,59934,57362863154,55134,85833618993,1500000000,1500000000
108846612596,1642560090,325182,110346612596,325182,130142596659,1500000000,1500000000
72876228190,1642577710,340669,77880279611,340669,,,
68682088381,1649144034,60862,70182088381,56062,77824591024,1500000000,1500000000
48139993996,1649165125,67658,49639993996,62858,75602260804,1500000000,1500000000
22474715968,1648113907,60838,23974715968,56038,30274717110,1500000000,1500000000
50436560439,1650462083,49495,51936560439,44695,74069674185,1500000000,1500000000
89298639099,1644596957,60018,90798639099,55218,114174331450,1500000000,1500000000
21922505829,1646825059,60850,23422505829,56050,30373650727,1500000000,1500000000
105794539069,1642550662,67634,107294539069,62834,136961062719,1500000000,1500000000
131830445315,1642472512,331149,133330445315,331149,137079898492,1500000000,1500000000
55207254499,1649202066,54320,56707254499,49520,62847641683,1500000000,1500000000
50410416532,1649152589,331119,51910416532,331119,64293429404,1500000000,1500000000
43386777720,1648128688,67634,44886777720,62834,49873806038,1500000000,1500000000
33435377020,1648100051,60850,34935377020,60850,49232097658,1500000000,1500000000
144901066142,1644606784,60938,146401066142,56138,153128048629,1500000000,1500000000
14939421698,1646827738,67634,16439421698,67634,21913934373,1500000000,1500000000
75133809833,1642501744,55693,76633809833,50893,101551463565,1500000000,1500000000
189751204948,1649187979,55580,191576550948,50780,216238615763,1825346000,1825346000
41502749315,1650414400,60850,43002749315,60850,55241191398,1500000000,1500000000
64447095273,1650487795,329380,65947095273,329380,68439171943,1500000000,1500000000
44290550279,1646791550,67658,45790550279,58058,55434957877,1500000000,1500000000
68237076986,1645129038,67646,69647076986,62846,106502437859,1410000000,1410000000
109129745809,1642568591,60838,110539745809,60838,114103905971,1410000000,1410000000
87099665598,1642487111,337412,88599665598,337412,107524922924,1500000000,1500000000
108415172068,1649169817,307112,109915172068,307112,145101014260,1500000000,1500000000
142260313261,1642609549,316149,143760313261,316149,209909344350,1500000000,1500000000
87593940848,1642467254,319279,89003940848,319279,91678714873,1410000000,1410000000
64386763344,1645449852,329343,66036763344,329343,72816074707,1650000000,1650000000
139476671018,1645482818,332547,140976671018,332547,151136987099,1500000000,1500000000
61721801052,1648131844,67634,63221801052,62834,70112759400,1500000000,1500000000
34779089192,1648114219,67634,36279089192,62834,41009299365,1500000000,1500000000
42809957520,1650440160,49507,44309957520,44707,49177488198,1500000000,1500000000
99231383615,1644602146,52916,100731383615,48116,111769423873,1500000000,1500000000
197092584404,1642617502,60874,198592584404,56074,245159805680,1500000000,1500000000
46537226130,1649145485,67622,48037226130,67622,68415742364,1500000000,1500000000
30087081017,1648130436,55592,31587081017,50792,38351656488,1500000000,1500000000
26201302699,1648130251,60850,27701302699,60850,36642075037,1500000000,1500000000
67033674048,1648083061,55592,68533674048,50792,83466761798,1500000000,1500000000
36021339483,1650492865,55720,37521339483,50920,200000000000,1500000000,1500000000
36021339483,1650492865,67722,37521339483,62922,51228165743,1500000000,1500000000
41697252792,1645083315,323668,43197252792,323668,53030768547,1500000000,1500000000
67091810680,1645061148,326727,68591810680,326727,76127266585,1500000000,1500000000
75648951874,1642587499,56516,77148951874,51716,85365472120,1500000000,1500000000
146432284406,1645464360,67634,147932284406,62834,226576134015,1500000000,1500000000
101344927412,1645456201,67646,103344927412,62846,199559083654,2000000000,2000000000
30696237936,1648126276,55592,32196237936,50792,33674876529,1500000000,1500000000
47673689385,1650462274,67646,49173689385,62846,66825749568,1500000000,1500000000
83310385690,1645108616,327956,84810385690,327956,90762884344,1500000000,1500000000
88867621857,1642585973,336847,90367621857,336847,106476659480,1500000000,1500000000
48353377673,1649139680,331173,49853377673,331173,65040724547,1500000000,1500000000
23421892346,1648114428,55592,24921892346,50792,33458116309,1500000000,1500000000
193474478796,1650474929,67734,194974478796,62934,264417731664,1500000000,1500000000
18739642758,1646829482,67658,20239642758,62858,23858000614,1500000000,1500000000
79227551201,1645112717,336855,80727551201,336855,121051089470,1500000000,1500000000
80588142592,1642593313,340037,82088142592,340037,100783983009,1500000000,1500000000
97639413515,1642487267,60862,99139413515,56062,133333505037,1500000000,1500000000
158564937380,1642546878,322424,160064937380,322424,207251263993,1500000000,1500000000
85000467956,1645419297,349508,86500467956,349508,98546671450,1500000000,1500000000
27801714044,1646822911,319779,29301714044,319779,30000000000,1500000000,1500000000
55884771363,1645116327,331121,57384771363,331121,60000000000,1500000000,1500000000
116655923580,1642628341,67634,118155923580,62834,143451488245,1500000000,1500000000
116655923580,1642628341,60850,118155923580,56050,189659850439,1500000000,1500000000
52617372866,1645414505,312286,54117372866,312286,57296337238,1500000000,1500000000
52617372866,1645414505,326725,54117372866,326725,57296337238,1500000000,1500000000
42799537500,1650413700,327986,44299537500,327986,45000000000,1500000000,1500000000
255033787705,1642630504,327377,256533787705,327377,304264687260,1500000000,1500000000
75167669931,1648133261,67634,76667669931,62834,83225983840,1500000000,1500000000
46570415800,1648160669,325034,48070415800,325034,56723429402,1500000000,1500000000
100978910356,1650463262,63200,102478910356,63200,114808718788,1500000000,1500000000
56125750105,1644555107,336825,57625750105,336825,79528585789,1500000000,1500000000
41620772838,1646814251,316642,43120772838,316642,48840394468,1500000000,1500000000
51118221867,1645106923,326802,52618221867,326802,66092410092,1500000000,1500000000
121844814431,1642465574,337468,123344814431,337468,154095427879,1500000000,1500000000
41049867308,1648132881,67622,42549867308,67622,46551237993,1500000000,1500000000
41049867308,1648132881,67634,43049867308,62834,51941676230,2000000000,2000000000
43611409275,1650496163,67710,45111409275,62910,52038228770,1500000000,1500000000
48139073986,1650445740,60862,50139073986,56062,78663183792,2000000000,2000000000
66964835192,1645106685,55717,68464835192,50917,89403702429,1500000000,1500000000
108401698194,1642569707,56516,111401698194,51716,135206268617,3000000000,3000000000
60302975139,1648080036,325643,61802975139,325643,67132790473,1500000000,1500000000
67716258213,1648133704,55592,69216258213,50792,90015660770,1500000000,1500000000
26616246707,1648096144,67634,28116246707,62834,38432428947,1500000000,1500000000
36915530911,1648095500,322842,41915530911,322842,111000000000,5000000000,5000000000
42065694720,1650430801,60838,43565694720,56038,44865586885,1500000000,1500000000
46482730424,1650445633,55592,47982730424,50792,53371078323,1500000000,1500000000
36023975786,1650438197,49483,37523975786,49483,56048791595,1500000000,1500000000
37057629173,1650448770,49495,38557629173,49495,42039962784,1500000000,1500000000
33237466069,1644577562,64741,34737466069,59941,35000000000,1500000000,1500000000
86700541981,1642575692,67646,88700541981,62846,108841012717,2000000000,2000000000
69639770629,1649181566,55580,71139770629,50780,77000000000,1500000000,1500000000
35954441534,1648131292,60862,37454441534,60862,38396130729,1500000000,1500000000
28861256248,1648119145,60862,30361256248,56062,35710129815,1500000000,1500000000
48803868885,1648128748,67634,50303868885,67634,55914055623,1500000000,1500000000
27623923120,1648116911,60850,29123923120,60850,39908675719,1500000000,1500000000
42408602815,1649142763,55717,44408602815,50917,65730052093,2000000000,2000000000
23977361455,1648112420,60862,25477361455,60862,35883690269,1500000000,1500000000
30230225316,1648123276,60850,31730225316,60850,38355397783,1500000000,1500000000
22411372207,1648109612,326020,23911372207,326020,37135850015,1500000000,1500000000
54464811011,1644587701,353438,55964811011,346969,83505974113,1500000000,1500000000
63424935726,1645125744,60950,64924935726,56150,93879465945,1500000000,1500000000
95704068377,1642576990,60862,97204068377,56062,134790224187,1500000000,1500000000
190202614655,1642542556,60838,191702614655,60838,202037123148,1500000000,1500000000
56516810991,1645449093,67734,58016810991,62934,69432512715,1500000000,1500000000
24412586205,1648125519,55592,25912586205,55592,31075275164,1500000000,1500000000
24412586205,1648125519,67634,25912586205,67634,30596552015,1500000000,1500000000
33199518598,1648126138,67634,34699518598,62834,41243602625,1500000000,1500000000
75424714039,1648133277,67622,76924714039,62822,95459587414,1500000000,1500000000
52627035401,1650490088,60862,54127035401,60862,60000000000,1500000000,1500000000
53639124606,1644551362,336831,55139124606,336831,59602635240,1500000000,1500000000
104663835633,1642632099,313485,106163835633,313485,119601283970,1500000000,1500000000
79752108191,1642575184,322937,81252108191,322937,109996742635,1500000000,1500000000
94791431465,1642560385,55592,96291431465,50792,133045607292,1500000000,1500000000
100321855337,1642515619,332374,101821855337,332374,104665676293,1500000000,1500000000
86301292272,1645458667,49507,87801292272,44707,110452074245,1500000000,1500000000
28869997977,1648117210,55592,30369997977,50792,33462650459,1500000000,1500000000
32395454968,1648097828,55592,33895454968,50792,40489357600,1500000000,1500000000
32497052117,1650458617,329203,34497052117,329203,36808751091,2000000000,2000000000
39450938168,1646796144,67622,40950938168,62822,48277520074,1500000000,1500000000
59646089356,1645106402,67634,70000000000,62834,,,
93746634993,1642549518,54836,95246634993,54836,117711043433,1500000000,1500000000
93746634993,1642549518,55729,95246634993,50929,117711043433,1500000000,1500000000
40511195094,1648162288,321895,42011195094,321895,55606267512,1500000000,1500000000
106740703028,1644603385,67634,108240703028,62834,113062271088,1500000000,1500000000
129057946424,1645136538,67646,130557946424,62846,164838963443,1500000000,1500000000
148333490500,1642623179,66802,149833490500,62002,206987720102,1500000000,1500000000
31249005459,1650455821,60850,32749005459,60850,40258539693,1500000000,1500000000
99808272316,1650463715,67646,101578857936,62846,107847830740,1770585620,1770585620
34377919918,1650436786,60862,35877919918,56062,47040677934,1500000000,1500000000
38926025292,1644583614,55656,40426025292,55656,52670791109,1500000000,1500000000
71235208383,1645071257,323517,72735208383,323517,75468711360,1500000000,1500000000
66447143843,1649146273,60006,67947143843,55206,75373405318,1500000000,1500000000
66447143843,1649146273,66814,67947143843,66814,78998250255,1500000000,1500000000
112814544377,1645461965,329266,114314544377,329266,119065023192,1500000000,1500000000
74718502858,1645448313,323511,76218502858,323511,87667024175,1500000000,1500000000
63309453735,1649141136,55717,65309453735,50917,81695426840,2000000000,2000000000
59688618107,1645414546,340653,61188618107,340653,67271716083,1500000000,1500000000
54731136463,1648131630,67634,56231136463,62834,66583117920,1500000000,1500000000
48917981280,1645105353,54921,50917981280,50121,300000000000,2000000000,2000000000
69357820579,1642514394,333129,70357820579,333129,75165479480,1000000000,1000000000
57801753984,1649157622,60850,59301753984,56050,79054967227,1500000000,1500000000
62607030165,1649176629,67646,64107030165,62846,76530555465,1500000000,1500000000
24651098210,1648106744,67634,26651098210,67634,32609428574,2000000000,2000000000
27327451273,1648127911,319669,28827451273,319669,29667710243,1500000000,1500000000
76485968723,1650463873,49519,77985968723,44719,96444247559,1500000000,1500000000
20866253930,1646818178,67646,22366253930,67646,30785429389,1500000000,1500000000
30080890558,1646835688,60850,31580890558,56050,39337816370,1500000000,1500000000
65482116263,1649117209,55717,66982116263,50917,94772568680,1500000000,1500000000
90874422551,1649179585,55720,92374422551,50920,100000000000,1500000000,1500000000
66855590546,1648131516,55580,68355590546,50780,77995603352,1500000000,1500000000
66855590546,1648131516,60862,68355590546,56062,77995603352,1500000000,1500000000
66855590546,1648131516,60862,68355590546,56062,70102495609,1500000000,1500000000
43768178150,1648132981,55580,45268178150,50780,51492343380,1500000000,1500000000
92172614214,1644614885,67634,93672614214,62834,107655912272,1500000000,1500000000
87525792331,1645138568,55705,89025792331,50905,110520994527,1500000000,1500000000
37870173224,1645088329,55717,39370173224,50917,48151073963,1500000000,1500000000
40612175025,1645082460,52928,42112175025,48128,50804287284,1500000000,1500000000
84298627607,1642505102,334304,85838627607,334304,88200000000,1540000000,1540000000
26616483000,1648101001,67610,28116483000,67610,33564246179,1500000000,1500000000
26616483000,1648101001,67634,28116483000,67634,33564246179,1500000000,1500000000
27641939159,1648123526,55580,29141939159,55580,31000000000,1500000000,1500000000
26009182645,1648119629,331149,27509182645,331149,32646138479,1500000000,1500000000
70397503350,1645108851,55705,71897503350,50905,200000000000,1500000000,1500000000
97581613111,1642512021,334282,99581613111,334282,125542845231,2000000000,2000000000
47798549730,1649145828,67634,49298549730,67634,54680912389,1500000000,1500000000
45925921342,1644623928,314106,47425921342,314106,58784005335,1500000000,1500000000
132873435147,1644610246,60938,134373435147,56138,138167583209,1500000000,1500000000
76898054048,1642591789,334252,78398054048,334252,90355197009,1500000000,1500000000
106926144641,1642538373,64705,108426144641,59905,130164823785,1500000000,1500000000
99875675808,1642486691,60850,101375675808,56050,134731651684,1500000000,1500000000
71293822487,1649172448,67622,72793822487,67622,85853192017,1500000000,1500000000
30606512200,1648130793,67646,30836322773,62846,,,
42001943372,1646858427,60862,43501943372,56062,60408637394,1500000000,1500000000
44469156140,1645099971,59994,45969156140,59994,52768106318,1500000000,1500000000
75613044600,1642581241,323049,77113044600,323049,92651543907,1500000000,1500000000
95844545440,1642472143,56516,97344545440,51716,113823511918,1500000000,1500000000
30643258650,1648114213,55592,32143258650,50792,32356476123,1500000000,1500000000
33403522055,1648116043,67634,34903522055,62834,44875501124,1500000000,1500000000
58075197440,1644557386,334314,59575197440,334314,63630801248,1500000000,1500000000
83236096785,1642585260,343819,84736096785,343819,96827284919,1500000000,1500000000
132123646231,1642532429,346426,133623646231,346426,144689251279,1500000000,1500000000
93648760743,1642493035,322911,95148760743,322911,110993597455,1500000000,1500000000
83548333984,1642537913,320433,85048333984,320433,114244873430,1500000000,1500000000
32201789966,1648113408,329162,33701789966,329162,39919923428,1500000000,1500000000
18316407204,1648124102,67646,19816407204,62846,23281433150,1500000000,1500000000
36905593479,1648163412,326806,38405593479,326806,41438923395,1500000000,1500000000
38608818148,1646811434,60850,40108818148,60850,44411537413,1500000000,1500000000
24830566677,1646860600,67634,26830566677,62834,32111584845,2000000000,2000000000
111138129638,1642511132,335172,120492247080,335172,,,
97329938610,1649188898,48591,100000000000,48591,100000000000,3000000000,2670061390
27603847430,1646859100,317284,29103847430,317284,30304774149,1500000000,1500000000
23385802287,1646818196,319647,24885802287,319647,30842231740,1500000000,1500000000
111389379036,1642549266,329986,112889379036,329986,124818880235,1500000000,1500000000
44295496152,1649118490,49495,46295496152,49495,77000000000,2000000000,2000000000
38890813965,1648098303,325952,40390813965,325952,52846862183,1500000000,1500000000
57750384265,1648131734,67658,59250384265,62858,75872479642,1500000000,1500000000
40711880465,1648090206,55592,42211880465,50792,58084538113,1500000000,1500000000
36086853609,1650419948,55592,37586853609,50792,42862500160,1500000000,1500000000
33406741302,1644576700,54703,34906741302,54703,47019860574,1500000000,1500000000
80909936791,1644612998,67622,82409936791,67622,119245652078,1500000000,1500000000
44482949475,1646863574,64056,45982949475,59256,58673965540,1500000000,1500000000
118890182504,1642477430,55636,121390182504,55636,270522081932,2500000000,2500000000
55063310421,1648134015,55705,56563310421,50905,67511578020,1500000000,1500000000
75107357513,1650481931,340623,76607357513,340623,108261957512,1500000000,1500000000
82221271363,1645123999,49595,83721271363,49595,103000000000,1500000000,1500000000
72118416318,1642505650,333704,73618416318,333704,85951540458,1500000000,1500000000
58527345545,1645414533,326123,59965545315,326123,59965545315,1500000000,1438199770
58527345545,1645414533,323565,60027345545,323565,62159776263,1500000000,1500000000
55403581356,1645448848,329863,56903581356,329863,87667024175,1500000000,1500000000
39547999632,1650447054,60862,41047999632,56062,60847067595,1500000000,1500000000
80263198722,1642588372,60850,81763198722,56050,110000000000,1500000000,1500000000
77259870535,1642506761,67622,78759870535,67622,98675900125,1500000000,1500000000
48941407691,1648141116,333642,50441407691,333642,63647331745,1500000000,1500000000
75271384438,1648133495,67646,77271384438,67646,94864338248,2000000000,2000000000
100278030271,1642488311,60850,101778030271,60850,108179906862,1500000000,1500000000
82034772326,1642502373,320350,83534772326,320350,100077899794,1500000000,1500000000
34842857652,1650422834,67634,36342857652,62834,45745012004,1500000000,1500000000
33508149571,1650454716,60862,35008149571,56062,42411245952,1500000000,1500000000
59619292040,1650482377,60054,61119292040,55254,65000000000,1500000000,1500000000
93258589811,1642564973,55612,94758589811,50812,103068117355,1500000000,1500000000
19639539381,1648110042,60862,21139539381,56062,24753745067,1500000000,1500000000
37146514753,1648098265,60850,38646514753,56050,54566449647,1500000000,1500000000
46176954576,1648132892,55592,47676954576,50792,49520842529,1500000000,1500000000
26180765114,1648129979,67622,27680765114,67622,48333752237,1500000000,1500000000
41472364886,1650417981,60850,42556986359,60850,42556986359,1500000000,1084621473
29257152204,1646810168,67634,30757152204,62834,36869052290,1500000000,1500000000
25698036961,1648105634,316450,27198036961,316450,33763415628,1500000000,1500000000
66247013465,1648133825,60862,67747013465,56062,84545816868,1500000000,1500000000
38306949484,1648122533,307078,39806949484,307078,54158698662,1500000000,1500000000
38306949484,1648122533,67646,39806949484,62846,58570503430,1500000000,1500000000
79137342721,1650482360,66778,80637342721,66778,99577919773,1500000000,1500000000
47814692803,1650439102,343179,49314692803,343179,51138883865,1500000000,1500000000
92846188437,1644613424,52928,94346188437,48128,110844620477,1500000000,1500000000
85634814397,1644538962,333153,87134814397,333153,97227645943,1500000000,1500000000
73140498050,1642586723,55636,75640498050,55636,156766053804,2500000000,2500000000
17569083462,1648101524,336889,20110000000,336889,20110000000,20110000000,2540916538
47230357132,1650459672,60862,48320349702,56062,48320349702,1500000000,1089992570
122346798547,1650463650,60006,124012742556,55206,176656752411,1665944009,1665944009
34895619067,1644572087,64044,36395619067,54444,56052003504,1500000000,1500000000
21698049656,1646833708,327391,23198049656,327391,27025519317,1500000000,1500000000
137890021147,1642546077,326135,139390021147,326135,169319468338,1500000000,1500000000
82422983304,1649170857,316654,83922983304,316654,95847462643,1500000000,1500000000
85993834272,1649179396,55660,87493834272,50860,125106287893,1500000000,1500000000
41527861125,1649151554,325157,43027861125,325157,56337825235,1500000000,1500000000
22825206119,1648111575,67622,24325206119,62822,25747159112,1500000000,1500000000
32264266565,1648120438,55592,33764266565,50792,35134704735,1500000000,1500000000
142386666712,1642517693,67634,143886666712,62834,168502403574,1500000000,1500000000
66083575628,1649119137,67646,67583575628,62846,92467468337,1500000000,1500000000
26300020857,1648128092,67722,27800020857,62922,35596586304,1500000000,1500000000
19252490161,1648124549,67634,20752490161,62834,27454937104,1500000000,1500000000
31793881278,1648119753,60838,33293881278,60838,41317178017,1500000000,1500000000
84537590999,1642579310,319761,86037590999,319761,101941834763,1500000000,1500000000
140228255021,1642522597,54824,141728255021,50024,143153224062,1500000000,1500000000
80409333019,1649190292,48603,82409333019,48603,130000000000,2000000000,2000000000
43798708841,1649151526,331451,45798708841,331451,47694030753,2000000000,2000000000
28520111325,1648127593,55592,30020111325,50792,38600002718,1500000000,1500000000
26862491041,1648100680,55681,28362491041,50881,38251906235,1500000000,1500000000
79788197985,1650477758,48627,80667169189,48627,,,
31853295904,1646850124,67634,33353295904,62834,39358223115,1500000000,1500000000
45920510015,1645081032,64717,47420510015,64717,51709388302,1500000000,1500000000
146074010997,1642476825,55636,148574010997,55636,262190552814,2500000000,2500000000
39543266973,1650452901,343199,41543266973,343199,57679352774,2000000000,2000000000
19971734995,1646860126,67634,21471734995,62834,30058774309,1500000000,1500000000
21336639258,1646823917,67646,22836639258,58046,27010079592,1500000000,1500000000
159449116665,1642631971,319805,161449116665,319805,233631564951,2000000000,2000000000
99110893563,1642635721,334298,100610893563,334298,154422188990,1500000000,1500000000
72921235125,1642581220,67646,74421235125,62846,91974550498,1500000000,1500000000
86439503715,1642498021,55624,88939503715,55624,182480811536,2500000000,2500000000
118017403889,1642524407,60838,120017403889,60838,146941150531,2000000000,2000000000
22961686798,1648105436,60862,24461686798,56062,32586646503,1500000000,1500000000
22961686798,1648105436,60850,24461686798,60850,33487796635,1500000000,1500000000
17749234276,1648127720,67634,19249234276,62834,28804514559,1500000000,1500000000
31366014389,1650439247,60862,32866014389,56062,47670253959,1500000000,1500000000
31366014389,1650439247,326808,32866014389,326808,43021584242,1500000000,1500000000
39936529694,1650413905,55680,41436529694,50880,46731790400,1500000000,1500000000
52578738941,1649137056,325227,54078738941,318758,200000000000,1500000000,1500000000
65618746787,1645423888,343199,67118746787,343199,74139231039,1500000000,1500000000
45165559809,1650459725,67646,46665559809,62846,48875284838,1500000000,1500000000
27414898400,1646817878,60838,28914898400,60838,36916873690,1500000000,1500000000
80215842131,1649135310,49583,81715842131,49583,98745881543,1500000000,1500000000
71895815478,1648149228,343886,73395815478,343886,73756047955,1500000000,1500000000
35065384538,1650488943,340023,36565384538,251348,39079294720,1500000000,1500000000
84434741853,1642575045,67646,88761922559,62846,,,
33391208878,1648166248,325062,34891208878,325062,42646282685,1500000000,1500000000
45681844008,1648093639,67622,47181844008,67622,74953984052,1500000000,1500000000
32411634573,1648103928,67634,33911634573,67634,43673867615,1500000000,1500000000
63753573432,1648084083,67646,95424195619,62846,,,
30145571971,1646812122,67646,31645571971,62846,43632794357,1500000000,1500000000
33059062642,1646839480,63200,35559062642,63200,65954824254,2500000000,2500000000
100759999303,1642606883,329268,102259999303,329268,105613380457,1500000000,1500000000
147143678098,1642544898,333173,149143678098,333173,207713318263,2000000000,2000000000
106285594699,1642523007,60850,107785594699,56050,117072241985,1500000000,1500000000
41188343492,1648097191,60862,42688343492,56062,55260081455,1500000000,1500000000
91027427033,1642573683,320433,92527427033,320433,119213772020,1500000000,1500000000
95864846302,1642619803,346386,97864846302,346386,101254001842,2000000000,2000000000
110682401577,1642515817,333169,112182401577,333169,141674454578,1500000000,1500000000
83279686458,1649185276,66778,84779686458,66778,91366948444,1500000000,1500000000
121547602600,1645479355,56516,123047602600,51716,153648638527,1500000000,1500000000
36814368492,1648097288,55693,37814368492,50893,38053910668,1000000000,1000000000
93323330413,1642573771,67646,103642080722,67646,,,
80805788757,1649126397,63200,82305788757,63200,160827157298,1500000000,1500000000
43172118962,1645436480,54712,44672118962,49912,55520961674,1500000000,1500000000
32028063599,1648166285,333642,33528063599,333642,43239011098,1500000000,1500000000
18623604093,1646826608,60850,20123604093,56050,20632366714,1500000000,1500000000
36000189935,1646849066,331193,37500189935,331193,48601278844,1500000000,1500000000
82886429410,1642578663,67634,84386429410,67634,92781351407,1500000000,1500000000
97233256689,1642503393,64741,98733256689,59941,117484747137,1500000000,1500000000
28372878839,1648116101,67634,29872878839,67634,48466825669,1500000000,1500000000
35396559290,1648114384,67634,36896559290,67634,46916739623,1500000000,1500000000
109918941114,1642547913,313437,111568941114,313437,155000000000,1650000000,1650000000
71432661873,1649117691,67634,72932661873,67634,91473173434,1500000000,1500000000
50619561711,1649185735,60850,52119561711,56050,82288925150,1500000000,1500000000
36584910812,1648105084,67646,38084910812,62846,38318165190,1500000000,1500000000
36584910812,1648105084,326004,38084910812,326004,38318165190,1500000000,1500000000
36584910812,1648105084,67634,38084910812,62834,38318165190,1500000000,1500000000
44147705705,1649146423,307952,45647705705,307952,58533412733,1500000000,1500000000
46959084380,1645412968,55572,48459084380,50772,69013218704,1500000000,1500000000
60549188217,1645074946,60874,62049188217,56074,69764720318,1500000000,1500000000
38328741269,1649151688,325149,39828741269,325149,57449503922,1500000000,1500000000
42542322816,1648165791,336819,44042322816,336819,50305226728,1500000000,1500000000
42542322816,1648165791,325070,44042322816,325070,50305226728,1500000000,1500000000
20624198876,1648111470,55580,22124198876,55580,25917582375,1500000000,1500000000
20624198876,1648111470,67634,42000000000,67634,,,
40615765567,1646789475,67658,42115765567,62858,50400720217,1500000000,1500000000
15462760182,1646834309,321622,16962760182,321622,20865958322,1500000000,1500000000
30847290989,1645097841,314477,32347290989,314477,41473832703,1500000000,1500000000
89510087644,1642577285,333063,91010087644,333063,112700885457,1500000000,1500000000
60654069487,1649129345,66742,62154069487,66742,70296159972,1500000000,1500000000
62979043242,1648133629,67658,64479043242,62858,87602140053,1500000000,1500000000
32727605044,1648098160,60838,34227605044,60838,36098967020,1500000000,1500000000
75256792745,1644602332,320467,76756792745,320467,100588254177,1500000000,1500000000
66943819651,1644566220,335150,68443819651,335150,80014076363,1500000000,1500000000
79711009913,1644597558,340655,81211009913,340655,103472775062,1500000000,1500000000
72963693147,1648152754,332428,74463693147,332428,88488091685,1500000000,1500000000
105488738873,1645125025,54897,106988738873,50097,300000000000,1500000000,1500000000
37920336761,1645083667,55705,39420336761,50905,51907406690,1500000000,1500000000
85235359499,1642485107,316129,86735359499,316129,89000000000,1500000000,1500000000
108507153646,1642524662,59970,110007153646,59970,125459385003,1500000000,1500000000
55036927977,1649129312,60862,56536927977,56062,66488009533,1500000000,1500000000
65359714376,1648136706,55680,66859714376,50880,88052132808,1500000000,1500000000
32881493095,1648104322,316600,34381493095,316600,39646514390,1500000000,1500000000
54056073300,1648151501,54095,55556073300,49295,76066847862,1500000000,1500000000
54881996487,1648131463,60850,56881996487,56050,74129600302,2000000000,2000000000
61723823817,1645137637,54969,63223823817,50169,88314707414,1500000000,1500000000
67467622909,1645120249,67646,68967622909,62846,81564754160,1500000000,1500000000
75991462457,1642575794,67646,77991462457,62846,103192275152,2000000000,2000000000
34501722869,1648129634,327375,36001722869,327375,47043817412,1500000000,1500000000
89309505695,1642602450,337498,90809505695,337498,137936061197,1500000000,1500000000
97698293443,1642535386,54747,99198293443,54747,117283666364,1500000000,1500000000
83516522244,1649171608,60838,85016522244,56038,107554339172,1500000000,1500000000
57619796717,1648136764,327968,59119796717,327968,87199749402,1500000000,1500000000
22498051020,1648107089,64056,23498051020,59256,24631779625,1000000000,1000000000
27369078771,1648128135,55592,29369078771,50792,33631033960,2000000000,2000000000
94557960493,1650477217,67634,96057960493,62834,129141605614,1500000000,1500000000
86862149934,1650489868,64729,88362149934,59929,118559301483,1500000000,1500000000
57145803003,1645118691,67746,58645803003,62946,79187410052,1500000000,1500000000
25352458897,1648117607,67622,26852458897,62822,32966346479,1500000000,1500000000
60403242434,1648132146,54932,61903242434,50132,76789667382,1500000000,1500000000
42496014606,1648082935,67622,51187262073,67622,,,
42572473198,1650414158,62535,44072473198,57735,54434704830,1500000000,1500000000
23592610990,1646805225,60938,24092610990,56138,25000000000,500000000,500000000
32471798880,1646855654,59946,33971798880,59946,39717517232,1500000000,1500000000
77228931908,1642575659,60850,78728931908,56050,100000000000,1500000000,1500000000
41053394302,1649159968,319795,42553394302,319795,59318526139,1500000000,1500000000
42644536686,1649130244,67646,44644536686,62846,62593305385,2000000000,2000000000
39665860791,1648090411,307027,41165860791,307027,45725641054,1500000000,1500000000
31688514864,1650443152,60838,33188514864,60838,41311421667,1500000000,1500000000
105824732488,1642554747,326780,107324732488,326780,115476425205,1500000000,1500000000
26354719811,1648105328,54442,28354719811,49642,40313058254,2000000000,2000000000
31778103406,1648117012,60862,33278103406,56062,33529663249,1500000000,1500000000
36718912366,1648114251,67634,38218912366,62834,44973861490,1500000000,1500000000
73826152145,1642499609,60850,75326152145,60850,98506161393,1500000000,1500000000
152557709716,1642473419,60850,154057709716,56050,167692152952,1500000000,1500000000
87659388280,1648143729,59994,89159388280,55194,101378809965,1500000000,1500000000
28113660029,1648130210,60850,29613660029,56050,35576408572,1500000000,1500000000
45227418408,1650420783,323662,46727418408,323662,47374048669,1500000000,1500000000
83711972084,1642585557,308507,85211972084,308507,118933846715,1500000000,1500000000
121891123573,1642567029,60838,123391123573,60838,138212282980,1500000000,1500000000
101277799660,1642487910,332424,102777799660,332424,148795604657,1500000000,1500000000
42558798673,1648161012,60838,44058798673,60838,50985711679,1500000000,1500000000
169285275484,1650476609,340033,170785275484,340033,183269081974,1500000000,1500000000
41562667784,1645099041,329964,43062667784,329964,45017423919,1500000000,1500000000
67336574617,1642573071,322929,68836574617,322929,89484404397,1500000000,1500000000
122839587826,1642608226,340679,124339587826,340679,149118456278,1500000000,1500000000
76704651090,1642574342,67622,78204651090,67622,100279918387,1500000000,1500000000
30781460831,1648123493,60850,32281460831,56050,39218500389,1500000000,1500000000
17403617884,1648109912,67658,18903617884,58058,23053655894,1500000000,1500000000
43533483897,1648147977,67646,64000000000,62846,64000000000,64000000000,20466516103
42912651608,1648133024,67622,44057286533,67622,44057286533,1500000000,1144634925
42912651608,1648133024,55592,44412651608,50792,44492343380,1500000000,1500000000
39371435423,1650440041,67634,40871435423,67634,54731292217,1500000000,1500000000
77360855139,1642597974,56516,79360855139,51716,119092673260,2000000000,2000000000
49524190707,1649126940,67722,51024190707,67722,80648244713,1500000000,1500000000
41262819611,1650452346,60838,42762819611,60838,47819778420,1500000000,1500000000
82581685900,1642494767,55636,85081685900,55636,191258139200,2500000000,2500000000
22340302468,1648102271,67634,23990302468,62834,30148185073,1650000000,1650000000
26346747921,1648106932,67646,27346747921,62846,28367371591,1000000000,1000000000
70652210895,1648131670,67646,72152210895,62846,78463688834,1500000000,1500000000
70652210895,1648131670,67634,72652210895,67634,82042236388,2000000000,2000000000
27730852395,1648090551,319691,29230852395,319691,43440051685,1500000000,1500000000
42749661131,1650422606,64729,44249661131,59929,47571689734,1500000000,1500000000
42536271096,1644578054,62127,44036271096,62127,51886602518,1500000000,1500000000
138037791674,1642626011,67634,139537791674,62834,214519044042,1500000000,1500000000
63691271513,1642498197,56516,65191271513,51716,101901291384,1500000000,1500000000
145388806018,1645463786,54712,146888806018,49912,185791909760,1500000000,1500000000
34041429473,1648120419,67634,35134704735,67634,35134704735,1110000000,1093275262
46303988312,1644593944,327355,47803988312,327355,56000000000,1500000000,1500000000
34199791220,1646812653,55668,35699791220,50868,36343092764,1500000000,1500000000
49187181378,1645062328,320376,50687181378,320376,55971246024,1500000000,1500000000
77825473918,1642494872,326123,79235473918,326123,87470123706,1410000000,1410000000
47852992746,1648162720,320443,49352992746,320443,69437348802,1500000000,1500000000
40221246348,1648098324,67646,41721246348,62846,52846862183,1500000000,1500000000
62986758783,1649128444,67634,63987078040,62834,63987078040,1500000000,1000319257
16610511371,1648110496,55568,18110511371,50768,22357897527,1500000000,1500000000
14392913393,1646830299,60862,15430588334,56062,15430588334,1500000000,1037674941
37423948928,1646802973,60862,41423948928,56062,45654326523,4000000000,4000000000
105810434796,1642536979,55636,108310434796,55636,207192356348,2500000000,2500000000
23598368738,1648105498,55592,25598368738,50792,31850192838,2000000000,2000000000
26530012671,1646810617,55636,28030012671,50836,37689897945,1500000000,1500000000
117483064311,1642573597,56516,118983064311,51716,158026346909,1500000000,1500000000
91857944041,1642475387,67634,93357944041,62834,114034683467,1500000000,1500000000
52604553090,1648135446,67634,53986717258,62834,53986717258,1500000000,1382164168
85446384168,1642587959,333099,86946384168,333099,91346830209,1500000000,1500000000
87780320805,1642540325,325661,89780320805,325661,90000000000,2000000000,2000000000
106772338669,1642466429,329964,108272338669,329964,111231953268,1500000000,1500000000
82487277596,1642539553,60850,83987277596,56050,94828542606,1500000000,1500000000
35929861353,1650448128,64741,37929861353,59941,47408395868,2000000000,2000000000
27874474211,1646812591,314055,29374474211,314055,39021250219,1500000000,1500000000
129668326602,1642537278,122017,131168326602,122017,132167830354,1500000000,1500000000
63710128137,1649131422,67646,65210128137,62846,88598875808,1500000000,1500000000
68470371984,1649127141,63200,69970371984,63200,109711465168,1500000000,1500000000
58501503199,1645445871,60938,62708842011,56138,,,
66314333191,1650460539,334338,67814333191,334338,81179202749,1500000000,1500000000
279842152202,1650473623,60850,281342152202,60850,296368807574,1500000000,1500000000
279842152202,1650473623,55592,300068943598,50792,,,
39851403026,1650433596,67634,41351403026,62834,44513214770,1500000000,1500000000
99639076840,1642606604,317318,101139076840,317318,105453204567,1500000000,1500000000
88870104307,1642487436,67634,90370104307,67634,111949121793,1500000000,1500000000
68106738301,1642497354,55636,70606738301,55636,147440530758,2500000000,2500000000
49785528006,1645411631,349512,51785528006,349512,79064709013,2000000000,2000000000
47999325230,1648086423,67722,49999325230,67722,69519836161,2000000000,2000000000
37129187667,1650421064,56729,38629187667,47129,52090034970,1500000000,1500000000
24839763540,1646859740,67634,26839763540,62834,30927713406,2000000000,2000000000
114607316962,1642601584,60850,116107316962,56050,134929761423,1500000000,1500000000
53990244747,1649176208,67658,55490244747,62858,64393512409,1500000000,1500000000
25509299897,1648103477,55592,27009299897,50792,31519459914,1500000000,1500000000
19369756386,1646813126,55592,20869756386,50792,29780104774,1500000000,1500000000
48593411137,1646844496,67634,50093411137,67634,54003426245,1500000000,1500000000
27410951932,1646821122,67634,28910951932,67634,36712322884,1500000000,1500000000
77699446321,1645117450,64144,79639446321,54544,108106660670,1940000000,1940000000
70736690523,1645142148,67622,72236690523,67622,98604274529,1500000000,1500000000
132029364218,1642525899,67646,133529364218,62846,170797245420,1500000000,1500000000
54653679179,1645422900,340023,56153679179,340023,71759348620,1500000000,1500000000
39832736157,1648161040,67622,41332736157,67622,55256166072,1500000000,1500000000
79635169741,1650484362,66778,81135169741,66778,90079511619,1500000000,1500000000
23263381430,1646804352,60938,23763381430,56138,25000000000,500000000,500000000
89292236524,1645133873,67622,90792236524,67622,100351459780,1500000000,1500000000
122072253890,1642536263,55624,124572253890,55624,266577707090,2500000000,2500000000
35837575586,1650414540,323624,37337575586,323624,41957818095,1500000000,1500000000
35837575586,1650414540,51428,37337575586,51428,66232508952,1500000000,1500000000
41231827439,1650493940,54872,42731827439,50072,48066945614,1500000000,1500000000
101778438772,1642468348,333736,103278438772,333736,139111811898,1500000000,1500000000
27742835232,1648129528,60862,31895621407,56062,,,
55648174636,1648131894,67658,58648174636,62858,100000000000,3000000000,3000000000
36185432320,1650413866,55720,37685432320,50920,200000000000,1500000000,1500000000
36185432320,1650413866,60862,37685432320,56062,56886368395,1500000000,1500000000
114563158261,1650479388,60862,116063158261,56062,136481783890,1500000000,1500000000
34372198485,1650422300,55717,35872198485,50917,54160221859,1500000000,1500000000
52840992871,1650425340,60862,54340992871,56062,66641036692,1500000000,1500000000
97435778142,1642596786,485335,98935778142,323557,116656398004,1500000000,1500000000
92433610553,1642480796,312890,93000000000,312890,93000000000,1500000000,566389447
33531112336,1650446712,48639,35031112336,43839,39349057619,1500000000,1500000000
110138632271,1642521923,319759,111638632271,319759,142187313830,1500000000,1500000000
49462100961,1650496686,67722,50962100961,62922,54579324554,1500000000,1500000000
29099058115,1650439495,67646,30599058115,62846,46023181508,1500000000,1500000000
69793292079,1645106629,55717,71293292079,50917,84728700574,1500000000,1500000000
103473364932,1645110081,311116,104973364932,311116,107314553002,1500000000,1500000000
99459544049,1642550121,335562,100959544049,335562,141828727287,1500000000,1500000000
44032888293,1650414096,63200,45532888293,63200,87528358176,1500000000,1500000000
33964647166,1650439598,64729,35464647166,59929,48239145585,1500000000,1500000000
31295396073,1646818411,60850,32795396073,60850,35913273747,1500000000,1500000000
16837053312,1646828648,60862,18337053312,56062,21284146187,1500000000,1500000000
114842548775,1642611377,54249,116342548775,49449,159039216592,1500000000,1500000000
94806805829,1645486992,67634,96306805829,62834,119593472737,1500000000,1500000000
55157061548,1650432289,67634,56657061548,62834,80295802212,1500000000,1500000000
27639863486,1646860399,333742,29139863486,333742,31710446533,1500000000,1500000000
101250951358,1642467338,56516,103250951358,51716,150047885750,2000000000,2000000000
57749254457,1649147222,67634,59749254457,67634,67498727080,2000000000,2000000000
55558811350,1649133183,56646,57058811350,56588,71841732507,1500000000,1500000000
25511434707,1646829819,55592,27511434707,50792,29908764991,2000000000,2000000000
78660851326,1642619955,56504,80160851326,51704,92224015498,1500000000,1500000000
76006209408,1642512916,67622,77506209408,67622,91598204037,1500000000,1500000000
119950540453,1642478617,55636,122450540453,55636,237857782164,2500000000,2500000000
126513860056,1642521485,60838,128013860056,60838,170950442174,1500000000,1500000000
39748721785,1649145573,333692,41248721785,333692,50699244588,1500000000,1500000000
64412293845,1649130823,66754,65912293845,61954,76687608645,1500000000,1500000000
25890072046,1648112343,67634,27890072046,62834,28596187947,2000000000,2000000000
30276050285,1648127401,67622,31776050285,62822,34968163019,1500000000,1500000000
40896075221,1650435797,67646,42396075221,62846,45564867220,1500000000,1500000000
65163741891,1644591336,67634,66280877430,62834,69000000000,1117135539,1117135539
63431315588,1649166391,328222,64931315588,328222,77764051463,1500000000,1500000000
24239273859,1648124427,55705,25739273859,50905,28542305880,1500000000,1500000000
32591275715,1648113348,67634,34091275715,67634,45887093000,1500000000,1500000000
55706770617,1650498061,67646,57206770617,67646,70619930413,1500000000,1500000000
55706770617,1650498061,67722,57206770617,62922,70619930413,1500000000,1500000000
27232195929,1646790239,305386,28732195929,305386,40763927408,1500000000,1500000000
64960688210,1649179965,60850,66460688210,60850,89057808270,1500000000,1500000000
14527359631,1648110367,67634,18000000000,62834,,,
53525279373,1650487939,323632,54617224637,323632,54617224637,1128000000,1091945264
42852066021,1650413824,67722,44352066021,67722,46355993700,1500000000,1500000000
35245955528,1650422499,319791,36745955528,319791,59887119370,1500000000,1500000000
35068305379,1650440986,122029,36568305379,122029,65394791294,1500000000,1500000000
33834400392,1650433054,340015,35000000000,340015,35000000000,1500000000,1165599608
86089686037,1642576764,60862,88089686037,56062,129746594338,2000000000,2000000000
105797931352,1642620083,60850,107297931352,56050,129484124123,1500000000,1500000000
76416382352,1642593792,55648,77916382352,50848,86416661297,1500000000,1500000000
33162533943,1648130423,67646,34662533943,62846,37810329557,1500000000,1500000000
33162533943,1648130423,55592,34662533943,55592,34667851893,1500000000,1500000000
36145879845,1646855729,60938,37645879845,56138,41662666168,1500000000,1500000000
55409853787,1646852836,54688,56909853787,49888,69143003702,1500000000,1500000000
30462562359,1646812687,63200,32962562359,63200,65123418064,2500000000,2500000000
75060673892,1642575010,67646,77060673892,62846,103090499327,2000000000,2000000000
59940139136,1649166931,60838,61440139136,60838,75653611362,1500000000,1500000000
57866799393,1645402123,345061,59366799393,345061,65662828633,1500000000,1500000000
61731703261,1648141171,55705,63231703261,50905,63785496115,1500000000,1500000000
30846179918,1648115953,67634,32346179918,67634,33824318250,1500000000,1500000000
45823606380,1648131024,55592,47323606380,50792,55493302678,1500000000,1500000000
45823606380,1648131024,55681,47323606380,55681,55493302678,1500000000,1500000000
49323217264,1650492934,323638,50823217264,323638,56311583320,1500000000,1500000000
43504110147,1650491624,332372,45004110147,332372,55107673317,1500000000,1500000000
25819231490,1646825759,67622,27319231490,67622,27648497243,1500000000,1500000000
38292013873,1646786365,324812,40292013873,324812,56206794260,2000000000,2000000000
134572262206,1642518526,331143,136072262206,331143,170715174172,1500000000,1500000000
101399598912,1642478098,55636,103899598912,55636,193384787046,2500000000,2500000000
83395759178,1642495403,55636,85895759178,55636,175334621654,2500000000,2500000000
80169299901,1650413006,67710,81685062900,67710,102628313187,1515762999,1515762999
30213638893,1646803186,67646,31713638893,62846,42800138968,1500000000,1500000000
100684005926,1645124091,54921,102684005926,50121,300000000000,2000000000,2000000000
82457181875,1649182300,67646,83957181875,62846,96622608454,1500000000,1500000000
29718991303,1648115864,67634,31218991303,67634,35053771672,1500000000,1500000000
42367567051,1645091941,66730,43867567051,61930,55065149382,1500000000,1500000000
83290704365,1642606764,59970,84790704365,55170,92072539663,1500000000,1500000000
124656616301,1642634560,56504,126156616301,51704,155961845673,1500000000,1500000000
103764475922,1642565323,55705,105264475922,50905,121167707200,1500000000,1500000000
52078768987,1649151889,60850,53578768987,60850,54751327265,1500000000,1500000000
118032891400,1645483952,60850,119532891400,56050,153643427689,1500000000,1500000000
40056993182,1648122641,67646,41556993182,62846,47045318860,1500000000,1500000000
24225870598,1648129144,67646,25725870598,62846,36924322584,1500000000,1500000000
93833574388,1645127927,59934,94181859467,55134,94181859467,1500000000,348285079
267616618714,1642622623,60862,269116618714,56062,338106919174,1500000000,1500000000
88949433516,1642520654,323646,90949433516,323646,111891716417,2000000000,2000000000
39711350617,1649145925,60850,41211350617,60850,53277140473,1500000000,1500000000
68670266405,1645431321,320509,70170266405,320509,75611359638,1500000000,1500000000
29578020461,1648100111,55693,30946860761,50893,31937269855,1368840300,1368840300
53639917902,1648087201,60862,55139917902,56062,61103099975,1500000000,1500000000
29273466557,1648126937,67634,30773466557,67634,50445099499,1500000000,1500000000
76793418092,1650484414,52372,78293418092,47572,113471453475,1500000000,1500000000
40588777221,1650439118,343179,42088777221,254504,43546474750,1500000000,1500000000
41145129687,1644574573,67646,42645129687,62846,43211337104,1500000000,1500000000
40546703098,1646861650,63200,43046703098,63200,74588647054,2500000000,2500000000
111448691937,1642618872,330581,112948691937,330581,151020581715,1500000000,1500000000
67318119262,1642530480,64729,79178333355,59929,79178333355,79178333355,11860214093
41037915000,1649151620,334705,42537915000,334705,56080536879,1500000000,1500000000
45247838238,1648131380,333746,46443051918,333746,46443051918,1500000000,1195213680
45247838238,1648131380,67634,46747838238,67634,49189247293,1500000000,1500000000
298531621881,1650473578,60850,300031621881,60850,302241077860,1500000000,1500000000
31069782871,1646851430,67634,32569782871,62834,37233605618,1500000000,1500000000
132960968171,1642610029,331999,139960968171,331999,149892396997,7000000000,7000000000
96430711239,1642519712,326234,97930711239,326234,131337871227,1500000000,1500000000
34293843759,1648103970,325980,35793843759,325980,47075859790,1500000000,1500000000
168839738356,1650471113,316606,171121420856,316606,176559070070,2281682500,2281682500
41746748796,1650441575,66826,43246748796,66826,48680698844,1500000000,1500000000
37315113836,1650426242,64693,38815113836,64693,42354218649,1500000000,1500000000
34719027323,1646801243,67634,36719027323,67634,54968298702,2000000000,2000000000
55202624228,1649198880,56492,56702624228,51692,68401634018,1500000000,1500000000
127421134859,1645475521,319613,128921134859,319613,145590369370,1500000000,1500000000
71393765336,1648085101,60862,72893765336,56062,98256764215,1500000000,1500000000
34162318872,1646804796,55580,35662318872,50780,44037036747,1500000000,1500000000
57404963250,1645114596,67634,58904963250,62834,63000000000,1500000000,1500000000
77901778672,1642577415,60862,79901778672,56062,97449805346,2000000000,2000000000
132665681020,1642525375,313965,134547481020,313965,175416150923,1881800000,1881800000
33462060934,1645441179,67634,34962060934,62834,48552296289,1500000000,1500000000
25623730599,1648116955,60850,27123730599,56050,37605677735,1500000000,1500000000
26991776979,1648125754,67646,28491776979,62846,35867671208,1500000000,1500000000
58858227727,1644586197,64729,60358227727,59929,84113345030,1500000000,1500000000
56585499834,1649173864,60862,58085499834,56062,91221726107,1500000000,1500000000
152958005021,1650476983,60838,154458005021,60838,183784109217,1500000000,1500000000
36720843119,1646803281,327990,38220843119,327990,41269819800,1500000000,1500000000
54611776254,1645074926,67658,56111776254,62858,64929933589,1500000000,1500000000
104072106784,1642610215,326096,105572106784,326096,118556110673,1500000000,1500000000
84149661661,1642554292,52916,85649661661,52916,99027069013,1500000000,1500000000
104622619815,1642634399,60850,106122619815,56050,147599342905,1500000000,1500000000
141960985629,1642465914,67646,143460985629,62846,145598467768,1500000000,1500000000
127870536638,1642472548,325665,129370536638,325665,150340234638,1500000000,1500000000
49765144443,1649198658,54724,51265144443,49924,51563836978,1500000000,1500000000
61639047143,1642588264,315309,63139047143,315309,65000000000,1500000000,1500000000
70469488745,1645410943,55572,71969488745,50772,85946724850,1500000000,1500000000
37380790176,1646795303,337520,38880790176,337520,43855135599,1500000000,1500000000
171907730865,1642617678,67658,173407730865,62858,217710149409,1500000000,1500000000
109176863078,1648148716,67634,111221393204,67634,164315080824,2044530126,2044530126
37392707341,1646800652,60850,38892707341,60850,53685681340,1500000000,1500000000
102491276625,1642475351,55636,104991276625,55636,247316436788,2500000000,2500000000
139803273953,1642536215,54759,141303273953,49959,178431625060,1500000000,1500000000
87397860458,1642498257,325046,88897860458,325046,97245775372,1500000000,1500000000
89686323793,1642475105,55636,91186323793,50836,112797833148,1500000000,1500000000
67143824216,1649165566,49607,68643824216,44807,77621666732,1500000000,1500000000
127255159051,1642616830,67634,128755159051,67634,179782232237,1500000000,1500000000
76836182686,1642574983,343241,78336182686,343241,96991420569,1500000000,1500000000
73126685955,1649123506,60838,74626685955,60838,97975769625,1500000000,1500000000
81333824959,1645459117,322834,82833824959,322834,97960573657,1500000000,1500000000
122652728011,1649167673,67634,124152728011,62834,164135055514,1500000000,1500000000
22524511212,1648124489,60850,25000000000,56050,,,
67568866322,1650467420,64729,69068866322,59929,82249218429,1500000000,1500000000
82727146210,1645113587,333706,84227146210,333706,116301039572,1500000000,1500000000
69787422729,1642492582,67634,71287422729,62834,97173352237,1500000000,1500000000
15531518258,1648110543,67622,17031518258,67622,21607074860,1500000000,1500000000
37573460535,1648116045,67634,39073460535,67634,41688309243,1500000000,1500000000
36603571370,1648102790,55580,38103571370,50780,39672292537,1500000000,1500000000
18138643672,1648124132,67622,19638643672,67622,26429161235,1500000000,1500000000
54286717284,1644591274,302187,55100000000,302187,55100000000,1500000000,813282716
26069600470,1646820184,60030,27569600470,55230,37179447740,1500000000,1500000000
116403153479,1645110102,66730,117903153479,66730,130841706165,1500000000,1500000000
163501012100,1642626849,55660,165001012100,50860,220771843193,1500000000,1500000000
43379048615,1650413417,55668,44879048615,55668,52832918272,1500000000,1500000000
37141640638,1646805832,52928,38641640638,48128,46870363002,1500000000,1500000000
34625254752,1646836037,327363,36125254752,327363,41750403490,1500000000,1500000000
109989106876,1642600755,52916,111489106876,52916,125247967970,1500000000,1500000000
135021219551,1642528045,55717,136521219551,50917,178242133612,1500000000,1500000000
34423287017,1649156799,316620,35000000000,316620,35000000000,1500000000,576712983
20424912450,1648111541,55681,21924912450,50881,26717182024,1500000000,1500000000
33943921148,1648123477,67646,35032221632,62846,35032221632,1500000000,1088300484
20155830997,1648120614,67634,21655830997,62834,32962267205,1500000000,1500000000
59124982761,1650466273,67722,60624982761,62922,85964870588,1500000000,1500000000
152715485749,1642518356,60850,154215485749,56050,187152611727,1500000000,1500000000
168512190050,1645463258,52904,170512190050,48104,232743771395,2000000000,2000000000
22524904395,1648111316,67634,24524904395,62834,31421375994,2000000000,2000000000
69596770456,1648133437,67646,71096770456,62846,90629760317,1500000000,1500000000
93989845180,1642574017,331117,95489845180,331117,127154878234,1500000000,1500000000
93989845180,1642574017,328318,95489845180,328318,99786594608,1500000000,1500000000
69905618038,1642506728,60850,71405618038,56050,85000000000,1500000000,1500000000
150908513072,1642542440,67622,152908513072,67622,169713917491,2000000000,2000000000
61757663624,1650465103,331416,63257663624,331416,75559735355,1500000000,1500000000
47652042328,1646861965,60862,49533842328,56062,61778218349,1881800000,1881800000
79427186407,1642593269,56516,80927186407,51716,81904573565,1500000000,1500000000
39052104551,1649161721,66838,41052104551,62038,57829007999,2000000000,2000000000
36991899032,1646805765,64741,38491899032,59941,50047245359,1500000000,1500000000
132569620185,1642518486,324180,134069620185,324180,170715174172,1500000000,1500000000
52952209384,1648136842,314035,54452209384,314035,69022519337,1500000000,1500000000
40607509770,1648122487,67646,42107509770,62846,48340966400,1500000000,1500000000
32990806706,1650439526,340055,34990806706,340055,43140453118,2000000000,2000000000
113321813376,1642558424,66754,114821813376,66754,147703200017,1500000000,1500000000
113321813376,1642558424,67634,114821813376,67634,138347786163,1500000000,1500000000
57798342138,1649170467,67646,59298342138,67646,74125803930,1500000000,1500000000
36826427845,1648132698,55604,38826427845,50804,56752762282,2000000000,2000000000
81208109028,1650481684,67622,82708109028,67622,92295574174,1500000000,1500000000
40372491913,1650451118,65506,41872491913,60706,44609554428,1500000000,1500000000
16115292928,1646834434,316163,17615292928,316163,22708875848,1500000000,1500000000
122639505130,1642465625,326123,124139505130,326123,137530000000,1500000000,1500000000
114448845894,1645472899,67646,115948845894,62846,134481083980,1500000000,1500000000
23567130082,1648127503,67646,25067130082,62846,35490075013,1500000000,1500000000
30864463867,1648117015,60850,32364463867,56050,41222629258,1500000000,1500000000
24695464079,1648108730,67634,26195464079,67634,37861263018,1500000000,1500000000
34896849874,1648103063,67646,36396849874,62846,45684830767,1500000000,1500000000
49766143783,1645085414,319885,51266143783,319885,76064398970,1500000000,1500000000
93468700126,1642635932,320439,94968700126,320439,145607648917,1500000000,1500000000
91338491296,1642532726,55636,93838491296,55636,203342312862,2500000000,2500000000
27759213181,1648130177,67646,29259213181,62846,32793738823,1500000000,1500000000
26863618172,1648108776,67646,28363618172,62846,32570966145,1500000000,1500000000
21669636601,1648116208,55693,23169636601,50893,28895999428,1500000000,1500000000
53551337554,1650487307,334288,55051337554,334288,62244305465,1500000000,1500000000
63873195362,1645116694,66826,65373195362,62026,81505579678,1500000000,1500000000
130143659934,1642559797,331494,131643659934,331494,134540654019,1500000000,1500000000
74296019566,1649170787,60838,75796019566,56038,101570829252,1500000000,1500000000
39588569343,1648160941,55720,41088569343,50920,54361324508,1500000000,1500000000
22377033795,1648117587,60850,23877033795,56050,24735867850,1500000000,1500000000
33623307787,1650447885,60850,35123307787,56050,51030695043,1500000000,1500000000
96110498236,1645112285,60938,97610498236,56138,114020779964,1500000000,1500000000
59403641208,1649174995,63200,60903641208,63200,107115332448,1500000000,1500000000
91220944233,1645404114,346981,92720944233,346981,109900236763,1500000000,1500000000
22264542266,1648109662,60850,23764542266,56050,32419246893,1500000000,1500000000
23395504996,1648114729,333676,24895504996,333676,28937764760,1500000000,1500000000
40588173405,1650459391,60862,42088173405,56062,49990467097,1500000000,1500000000
76704588365,1645108777,55717,78704588365,50917,114022880697,2000000000,2000000000
73386440614,1642575949,308547,74886440614,308547,93170993679,1500000000,1500000000
62310722204,1650464280,55592,63810722204,50792,74178488692,1500000000,1500000000
48968117960,1646845518,55592,50468117960,50792,56783933318,1500000000,1500000000
78001182542,1645138425,318458,79501182542,318458,102231679608,1500000000,1500000000
140137174103,1642631100,317344,141637174103,317344,193265198893,1500000000,1500000000
75034978867,1642499258,52940,76534978867,48140,96000000000,1500000000,1500000000
100224898286,1642527707,60850,101724898286,60850,111005542393,1500000000,1500000000
174960291211,1642544972,60850,176460291211,56050,185429597623,1500000000,1500000000
51324909646,1649201191,59970,52824909646,55170,56564602464,1500000000,1500000000
33119663696,1648130769,67634,35119663696,62834,45976352596,2000000000,2000000000
68453007943,1648133940,63200,69953007943,63200,123209890160,1500000000,1500000000
27869334690,1648129225,67634,29411634690,62834,39862189345,1542300000,1542300000
27869334690,1648129225,60850,29411634690,56050,39862189345,1542300000,1542300000
146239128348,1650471632,67634,148009713968,62834,188051569553,1770585620,1770585620
66950041120,1644600163,313538,68450041120,313538,90353933455,1500000000,1500000000
58028463267,1646815521,60850,59528463267,56050,61646133267,1500000000,1500000000
20002641004,1646823795,67634,21502641004,67634,24817951728,1500000000,1500000000
23360481117,1648115878,67634,24860481117,67634,43955701862,1500000000,1500000000
39243602871,1644573115,66802,40743602871,66802,54322933987,1500000000,1500000000
96985527326,1642604323,55636,99485527326,55636,212631575430,2500000000,2500000000
95302364706,1642580288,60850,96802364706,56050,118397542702,1500000000,1500000000
125973361960,1642538475,60862,127473361960,56062,143195786923,1500000000,1500000000
79276070532,1649126399,67710,80776070532,67710,113516581199,1500000000,1500000000
185389182919,1650470741,317210,188874360098,317210,213354709798,3485177179,3485177179
46081057891,1645433330,333700,47581057891,333700,61732754539,1500000000,1500000000
65991373460,1650485874,67634,67991373460,62834,94020614774,2000000000,2000000000
200684509012,1643820872,63200,203184509012,63200,380295883478,2500000000,2500000000
141105645816,1643825597,54872,142605645816,50072,184646750744,1500000000,1500000000
66252745302,1643790549,317584,67752745302,317584,90838189332,1500000000,1500000000
37291892460,1644486208,55648,39791892460,55648,78884171618,2500000000,2500000000
310400435328,1643822082,55592,311900435328,50792,386299050909,1500000000,1500000000
51396153234,1644496102,55693,52896153234,50893,72773178733,1500000000,1500000000
98130837830,1644352567,55584,99630837830,50784,111731937565,1500000000,1500000000
77216890302,1644503466,340033,78716890302,340033,82176508922,1500000000,1500000000
75117566096,1644535596,337510,76325400000,337510,76325400000,1325400000,1207833904
75117566096,1644535596,340067,76325400000,340067,76325400000,1325400000,1207833904
151641470228,1644341918,343901,153141470228,337432,184029098257,1500000000,1500000000
102217831588,1644349145,319315,103717831588,319315,105000000000,1500000000,1500000000
42809286751,1644488032,55681,44309286751,50881,59168131638,1500000000,1500000000
81170847147,1643807296,56516,83170847147,51716,120353467541,2000000000,2000000000
85899212663,1644351578,315538,87399212663,315538,116908363592,1500000000,1500000000
44584271653,1644495932,66862,46084271653,62062,50406161417,1500000000,1500000000
84566835431,1644302550,340031,86066835431,340031,94637085967,1500000000,1500000000
86808089982,1644358081,67634,88308089982,67634,129769130803,1500000000,1500000000
65332069734,1644294078,337458,66832069734,337458,80653077715,1500000000,1500000000
103591245978,1644356096,60850,105091245978,60850,159136277188,1500000000,1500000000
60988847500,1644491948,52916,62488847500,48116,68456822135,1500000000,1500000000
88812454686,1643802226,60862,90312454686,56062,109080679829,1500000000,1500000000
61517234873,1644324893,334288,63017234873,334288,70360528889,1500000000,1500000000
603973065774,1643822752,55580,605473065774,50780,758860346960,1500000000,1500000000
63158069142,1644352123,64031,64658069142,64031,84605334928,1500000000,1500000000
82491926273,1644501695,322824,83991926273,322824,93655488624,1500000000,1500000000
121384212276,1644341959,60862,122884212276,56062,125770437115,1500000000,1500000000
128717701762,1643814101,52916,130367701762,52916,149270306970,1650000000,1650000000
70158720627,1644312777,332611,71658720627,332611,105454548764,1500000000,1500000000
73784852376,1643795339,60850,75284852376,60850,102881340849,1500000000,1500000000
104742597475,1644333100,336853,106242597475,336853,121719584584,1500000000,1500000000
138381955169,1644345600,66802,139881955169,66802,146671372293,1500000000,1500000000
70695118749,1644529955,67634,71695118749,62834,92297696213,1000000000,1000000000
86076358076,1643792733,64705,87576358076,59905,98344372459,1500000000,1500000000
58194355404,1644480570,54332,60194355404,49532,78065046938,2000000000,2000000000
66283308975,1644490288,54320,67783308975,49520,86735869160,1500000000,1500000000
155291327543,1644350655,60838,157116673543,60838,207000403862,1825346000,1825346000
41477209451,1644482566,67646,42977209451,62846,60088338585,1500000000,1500000000
148942792324,1643817080,55592,150442792324,50792,172221931488,1500000000,1500000000
55778127242,1644497111,328296,57278127242,328296,74706782255,1500000000,1500000000
43315707573,1644491032,54332,44815707573,49532,45781238103,1500000000,1500000000
49460192219,1644492635,343193,50960192219,343193,61173393988,1500000000,1500000000
99346395355,1643828046,340033,100000000000,340033,100000000000,1500000000,653604645
62075213389,1644344189,323916,63575213389,323916,69183787255,1500000000,1500000000
140327196017,1644505843,67734,141827196017,62934,148978197903,1500000000,1500000000
57154062377,1644324822,67622,58654062377,67622,81689285979,1500000000,1500000000
50551989027,1644327643,325637,51961989027,325637,61353932069,1410000000,1410000000
97557120958,1644500640,60850,99057120958,56050,136882121387,1500000000,1500000000
178278348122,1643825083,60862,179778348122,56062,256481816224,1500000000,1500000000
70277627186,1643801433,55580,71777627186,50780,109822651139,1500000000,1500000000
59562004375,1644335664,55668,61062004375,50868,63000000000,1500000000,1500000000
59562004375,1644335664,319681,61212004375,319681,62245747459,1650000000,1650000000
71740969987,1644327993,325046,73240969987,325046,80736908734,1500000000,1500000000
54472603410,1644492377,331462,55972603410,331462,67940396245,1500000000,1500000000
111296601311,1643845766,322957,112796601311,322957,130233594709,1500000000,1500000000
82386254474,1644329110,337488,83886254474,337488,85591391877,1500000000,1500000000
82386254474,1644329110,64705,83886254474,64705,85591391877,1500000000,1500000000
158523653288,1644520275,334334,160023653288,334334,189956353225,1500000000,1500000000
135592790563,1643815930,67634,137092790563,67634,149665298933,1500000000,1500000000
179133544569,1643834338,345085,180633544569,345085,199421556554,1500000000,1500000000
74701480859,1643791802,314358,76201480859,314358,89698270852,1500000000,1500000000
50874776984,1644495378,56504,52374776984,51704,66405714929,1500000000,1500000000
61236842485,1644344804,67710,62736842485,67710,85434075258,1500000000,1500000000
68485928473,1644304582,337470,69985928473,337470,72436323110,1500000000,1500000000
57134774112,1643800224,67634,58634774112,67634,86787593592,1500000000,1500000000
103701818489,1644507031,326115,105201818489,326115,129916335779,1500000000,1500000000
87985621342,1643807275,55636,90485621342,55636,199488932630,2500000000,2500000000
116014821668,1643764304,314420,117514821668,314420,150992514622,1500000000,1500000000
235592876216,1643832077,331165,237092876216,331165,239459897029,1500000000,1500000000
146412583416,1644364132,326262,147912583416,326262,169000750550,1500000000,1500000000
69281244461,1644501152,329193,70781244461,329193,82486445889,1500000000,1500000000
69281244461,1644501152,323578,70781244461,323578,84709780810,1500000000,1500000000
74887421825,1644358514,314158,76387421825,314158,101489071954,1500000000,1500000000
270380667412,1643822221,67634,271880667412,62834,372942296584,1500000000,1500000000
94213425286,1644291454,52916,95713425286,48116,126253683274,1500000000,1500000000
92751321510,1644338853,325992,94251321510,325992,108537045959,1500000000,1500000000
61822412896,1644530105,331987,63322412896,331987,91802870459,1500000000,1500000000
59259127548,1643799891,67634,60759127548,67634,85950379574,1500000000,1500000000
153745743837,1644341931,332116,155245743837,325647,200786394059,1500000000,1500000000
94126162072,1644537329,334533,96126162072,334533,115251932744,2000000000,2000000000
105361922467,1644534639,337524,106861922467,337524,127810286647,1500000000,1500000000
105016925507,1643778081,67622,106516925507,67622,145453960930,1500000000,1500000000
78310890636,1644524992,326119,79810890636,326119,90000000000,1500000000,1500000000
106505189582,1644519308,54872,108005189582,50072,142370211113,1500000000,1500000000
67239259308,1643796090,67646,68739259308,62846,86388419590,1500000000,1500000000
203884352692,1643761076,67646,205384352692,62846,238808208692,1500000000,1500000000
66564813461,1644313217,311707,68064813461,311707,71741760804,1500000000,1500000000
80630728640,1643803864,55648,83130728640,55648,175677118660,2500000000,2500000000
117378306535,1643842425,54308,118878306535,49508,120000000000,1500000000,1500000000
93225300889,1643787294,326083,94725300889,326083,94871174193,1500000000,1500000000
129773026240,1644524914,67646,131273026240,62846,151246826475,1500000000,1500000000
80216528850,1643807013,329390,101000000000,329390,,,
122328471687,1644285706,60862,123828471687,56062,133762587407,1500000000,1500000000
145726417066,1643768964,337462,147226417066,337462,150000000000,1500000000,1500000000
68379839736,1643792787,67634,69547949885,67634,69547949885,1500000000,1168110149
88260124908,1644308667,316572,89760124908,316572,90050890189,1500000000,1500000000
130094038858,1643811159,48603,131594038858,43803,158715460929,1500000000,1500000000
85865488265,1644358170,67634,87365488265,67634,120690986689,1500000000,1500000000
76169308545,1643804256,67634,76830684147,62834,76830684147,1500000000,661375602
213576757168,1643761055,326077,215076757168,326077,215594918793,1500000000,1500000000
122425430598,1644340525,343835,123925430598,343835,127001277889,1500000000,1500000000
163053893703,1644514375,60838,164553893703,56038,169137162382,1500000000,1500000000
95015723637,1643773403,55592,96515723637,50792,129010687753,1500000000,1500000000
40628189968,1644488800,54320,43628189968,49520,58196302495,3000000000,3000000000
309584298821,1643823601,67634,311084298821,62834,381512776318,1500000000,1500000000
139480509303,1644516888,59934,140980509303,55134,209040151217,1500000000,1500000000
79239193727,1644527687,55693,80739193727,50893,90153520762,1500000000,1500000000
55536945486,1644328566,299329,57036945486,299329,82374331128,1500000000,1500000000
142630317077,1643816373,313465,144130317077,313465,197641836918,1500000000,1500000000
46565587331,1644317704,332352,48065587331,332352,66695970145,1500000000,1500000000
84839756631,1644351590,329258,86339756631,329258,108874015829,1500000000,1500000000
84839756631,1644351590,382764,86339756631,382764,116469324169,1500000000,1500000000
97801441397,1644515749,54332,99301441397,49532,132023814702,1500000000,1500000000
83773764208,1643807209,336881,85273764208,336881,118765030683,1500000000,1500000000
104823297860,1644349027,55596,106323297860,55596,112260003858,1500000000,1500000000
304082687906,1644512987,67634,315254817580,67634,397352972246,11172129674,11172129674
134000600440,1644364085,54296,135500600440,49496,183615119593,1500000000,1500000000
51110815896,1644495375,67646,52610815896,67646,76043374228,1500000000,1500000000
104606884792,1644509821,54332,106606884792,49532,117731418300,2000000000,2000000000
55114221206,1644327432,55632,56614221206,50832,58896400589,1500000000,1500000000
64453109868,1644504907,66754,65953109868,66754,92129111697,1500000000,1500000000
70210016933,1644352057,55644,72710016933,55644,134330643448,2500000000,2500000000
68380023630,1643796743,60838,69880023630,56038,99316267867,1500000000,1500000000
146517400595,1643825543,60006,148017400595,55206,206246640490,1500000000,1500000000
100764728080,1644517307,60850,102264728080,56050,140256772174,1500000000,1500000000
73724390899,1644501607,321584,75224390899,321584,101234066990,1500000000,1500000000
101469150674,1644521007,67646,109000000000,62846,,,
80472417395,1644294253,60850,81972417395,56050,111449411833,1500000000,1500000000
144418756383,1643819555,67646,145918756383,62846,163262742158,1500000000,1500000000
137926233432,1643843830,323563,139426233432,323563,160408737678,1500000000,1500000000
60534204718,1644330496,296412,62534204718,296412,73300520351,2000000000,2000000000
80670539591,1644351036,64729,82170539591,59929,126716453864,1500000000,1500000000
72830166087,1643805525,314831,74330166087,314831,84068789433,1500000000,1500000000
74418309292,1643800689,333754,75918309292,333754,107024267593,1500000000,1500000000
109704119697,1644358349,55608,111204119697,50808,113485288860,1500000000,1500000000
177446112611,1644514570,49519,178946112611,44719,227640067007,1500000000,1500000000
40076682187,1644485764,326014,41576682187,326014,55246652210,1500000000,1500000000
111165663943,1643810534,67710,112665663943,67710,142671351012,1500000000,1500000000
92273262716,1644522100,326192,93773262716,326192,138920503942,1500000000,1500000000
48201589033,1644489661,55636,49114440777,50836,49114440777,1500000000,912851744
78143005832,1644339924,333652,79643005832,333652,84822795404,1500000000,1500000000
63458125646,1644482338,58612,64230255528,58612,64230255528,1500000000,772129882
52567665924,1644314349,67634,54567665924,67634,66599550125,2000000000,2000000000
147066177529,1643827389,63200,149566177529,63200,264164818840,2500000000,2500000000
98173847330,1644346491,66730,99673847330,66730,112989775883,1500000000,1500000000
81152824739,1644526269,340597,82242669959,340597,82242669959,1500000000,1089845220
142174267502,1643778543,323561,143674267502,323561,145155245159,1500000000,1500000000
81069756404,1644351597,332444,82569756404,332444,116469324169,1500000000,1500000000
70572607234,1644535591,334306,71898007234,334306,81325400000,1325400000,1325400000
70572607234,1644535591,326137,71898007234,326137,81325400000,1325400000,1325400000
249802026398,1643823890,55592,251302026398,50792,333481576730,1500000000,1500000000
79809169367,1644300008,334316,80341993958,334316,80341993958,1500000000,532824591
79809169367,1644300008,340025,80341993958,340025,80341993958,1500000000,532824591
50775971674,1644497572,328793,52275971674,328793,58710820813,1500000000,1500000000
78571761423,1643785016,67634,80071761423,62834,92787571503,1500000000,1500000000
119127793624,1643826391,67634,120627793624,62834,123950948500,1500000000,1500000000
119127793624,1643826391,60850,120627793624,56050,123743566743,1500000000,1500000000
54737306497,1644481121,54332,56237306497,49532,56944753097,1500000000,1500000000
99407927567,1643770993,67634,100907927567,67634,136723324745,1500000000,1500000000
102518857977,1644342385,315324,104018857977,315324,141429534318,1500000000,1500000000
57657293325,1644481830,311234,59157293325,311234,63536768887,1500000000,1500000000
118275480929,1643779350,66742,119775480929,61942,136590410197,1500000000,1500000000
135617601755,1642979543,328220,137027601755,328220,150000000000,1410000000,1410000000
90569642965,1642955630,331406,92069642965,331406,93211611284,1500000000,1500000000
115279046465,1642951585,52928,116779046465,48128,147899754582,1500000000,1500000000
41349830666,1648515239,67646,42849830666,62846,46816466194,1500000000,1500000000
33221023893,1648554000,336815,34721023893,336815,40121500498,1500000000,1500000000
37275890200,1648530019,55717,38775890200,50917,38891392624,1500000000,1500000000
49314739024,1648558267,60850,50814739024,60850,86846652990,1500000000,1500000000
34179838509,1648586245,60838,35679838509,56038,51161775442,1500000000,1500000000
100851806566,1642918549,320338,104851806566,320338,122286789595,4000000000,4000000000
122330219596,1642898440,55636,124830219596,55636,235459245986,2500000000,2500000000
35368586775,1648560948,54095,36868586775,49295,45341201835,1500000000,1500000000
70460524889,1647368758,319633,71960524889,319633,107477075367,1500000000,1500000000
111219383293,1642904485,67646,112719383293,62846,170342952337,1500000000,1500000000
79959201259,1642921516,322943,81459201259,322943,95872480735,1500000000,1500000000
135795967451,1642965292,56492,137295967451,56492,202687009467,1500000000,1500000000
42190099136,1648576085,67634,43690099136,62834,54875435208,1500000000,1500000000
77824234574,1642946825,340659,79324234574,340659,95152755475,1500000000,1500000000
38806314050,1647315156,66718,40306314050,66718,61586483705,1500000000,1500000000
13015007855,1647331897,325038,14515007855,325038,16577955744,1500000000,1500000000
19185687123,1647348158,331141,20685687123,331141,28226103505,1500000000,1500000000
41460469971,1648553416,59946,42960469971,55146,47589859648,1500000000,1500000000
61217686297,1647374228,67634,62717686297,62834,62747600293,1500000000,1500000000
230464958918,1642962833,54908,231964958918,50108,253723597552,1500000000,1500000000
43711322754,1647365746,333746,45211322754,333746,46000000000,1500000000,1500000000
111062347700,1642957882,59994,112562347700,55194,155809601537,1500000000,1500000000
12045314593,1647322284,324824,13545314593,324824,20260697088,1500000000,1500000000
98675827612,1642915371,343189,100175827612,343189,160724782637,1500000000,1500000000
16104689289,1647317833,67646,39000000000,62846,39000000000,39000000000,22895310711
18318418756,1647341106,54249,19818418756,49449,25597416229,1500000000,1500000000
18318418756,1647341106,60838,19818418756,60838,25557333637,1500000000,1500000000
104923837769,1642928425,49495,106589781778,44695,132231492982,1665944009,1665944009
19656212172,1647331558,328008,21156212172,328008,22538104527,1500000000,1500000000
54813917242,1648596516,64741,56313917242,59941,76943143589,1500000000,1500000000
16019741305,1647342992,55705,17519741305,50905,22458639178,1500000000,1500000000
79297467243,1642904842,319787,80797467243,319787,88255918010,1500000000,1500000000
26902835234,1647320921,67622,28402835234,67622,29839435355,1500000000,1500000000
32503243301,1647363871,321632,34003243301,321632,50114333349,1500000000,1500000000
62294613790,1647357290,330541,63794613790,330541,86134960447,1500000000,1500000000
186689183714,1642975580,340045,188629183714,340045,204353549328,1940000000,1940000000
85017048432,1642931234,56504,86517048432,51704,87294425924,1500000000,1500000000
19193994723,1648543569,67634,20693994723,62834,26559849334,1500000000,1500000000
14267019507,1647322577,310935,15603733637,310935,15603733637,1500000000,1336714130
96992352036,1642926507,54801,98492352036,50001,135097070364,1500000000,1500000000
113719146078,1642914028,67622,115219146078,67622,151739102330,1500000000,1500000000
29583598357,1647305467,312936,31083598357,312936,32798984462,1500000000,1500000000
123958573576,1642899391,55648,126458573576,55648,253876658408,2500000000,2500000000
40489197468,1648566103,60862,41489197468,56062,45000000000,1000000000,1000000000
104467842921,1642930864,67646,105967842921,62846,129975783570,1500000000,1500000000
25067875049,1648534522,333678,26567875049,333678,40000000000,1500000000,1500000000
34053129870,1647377765,317304,35953085278,317304,38178831468,1899955408,1899955408
36124898874,1648549977,334306,37624898874,334306,38242020248,1500000000,1500000000
178359781156,1642979835,54897,180009781156,50097,250000000000,1650000000,1650000000
92124791558,1642948051,329282,93624791558,329282,99153846282,1500000000,1500000000
14887519903,1647348438,66778,16387519903,66778,20157101967,1500000000,1500000000
14820427720,1647320394,333744,16320427720,333744,23164107950,1500000000,1500000000
80389685281,1642908306,340661,82809685281,340661,86000000000,2420000000,2420000000
45804885133,1648594697,65518,47304885133,60718,60598440068,1500000000,1500000000
40252303403,1647363794,322484,41752303403,322484,45588381178,1500000000,1500000000
33722566014,1647308296,327922,35222566014,241801,35527936048,1500000000,1500000000
15564517633,1647342871,60850,17564517633,60850,26458231392,2000000000,2000000000
25334646640,1647334829,55705,26834646640,50905,30508361340,1500000000,1500000000
35669171358,1647308289,327922,36866917529,241801,36866917529,1500000000,1197746171
35669171358,1647308289,327922,37169171358,241801,39090851864,1500000000,1500000000
28124782761,1648585096,331354,29624782761,331354,30000000000,1500000000,1500000000
35113269958,1647378795,67646,36613269958,62846,40049144039,1500000000,1500000000
21003281481,1647310509,67646,22503281481,62846,22944282708,1500000000,1500000000
97685209438,1642930396,340639,99185209438,340639,139926849629,1500000000,1500000000
31860328213,1648531474,320483,33360328213,320483,41068853280,1500000000,1500000000
30165892848,1647309476,60862,31446814059,56062,31446814059,1500000000,1280921211
84683586494,1642954529,343839,85000000000,343839,85000000000,1500000000,316413506
84683586494,1642954529,329328,85000000000,329328,85000000000,1500000000,316413506
84683586494,1642954529,332611,85000000000,332611,85000000000,1500000000,316413506
55920416634,1648561657,55648,58420416634,55648,99536491516,2500000000,2500000000
36251267013,1648526399,60862,37751267013,56062,45473851639,1500000000,1500000000
19083264980,1647340984,337490,20583264980,337490,26520904277,1500000000,1500000000
114673189940,1642911753,319560,116173189940,319560,155896455752,1500000000,1500000000
56040289672,1648590509,343211,58040289672,343211,75053142385,2000000000,2000000000
32656185921,1648553206,326103,34156185921,326103,40531487300,1500000000,1500000000
46049670202,1648564307,485828,47549670202,482034,55086274455,1500000000,1500000000
11436230306,1647333176,67634,12936230306,62834,16023082682,1500000000,1500000000
124397888481,1642897889,55636,126897888481,55636,223680095000,2500000000,2500000000
96976623744,1642929262,340667,98476623744,340667,144694443202,1500000000,1500000000
106020274385,1642939716,340671,108445274385,340671,141485467640,2425000000,2425000000
106020274385,1642939716,326113,108445274385,326113,141485467640,2425000000,2425000000
32311355030,1648555356,60850,33811355030,56050,41344073159,1500000000,1500000000
107895933198,1642919724,67622,109395933198,67622,124375586937,1500000000,1500000000
23022091366,1647342297,60862,24522091366,56062,25452926053,1500000000,1500000000
29262893729,1648593582,329990,30762893729,329990,40156252084,1500000000,1500000000
47510215733,1648586529,55648,50010215733,55648,93267008688,2500000000,2500000000
10180499681,1647338100,67722,11680499681,67722,15828357698,1500000000,1500000000
162474290294,1642975678,326228,163974290294,326228,172049774589,1500000000,1500000000
18956515885,1647336706,314136,20456515885,314136,25198066798,1500000000,1500000000
92895668867,1642904552,313435,94395668867,313435,110000000000,1500000000,1500000000
49963692276,1648565051,67658,51463692276,62858,54046717204,1500000000,1500000000
124041502937,1642903190,55648,126541502937,55648,228509429540,2500000000,2500000000
26408951321,1648548624,60850,27908951321,56050,36066907990,1500000000,1500000000
95949554483,1642952671,331384,97449554483,331384,140613970097,1500000000,1500000000
100860967789,1642899438,320455,102360967789,320455,145290367050,1500000000,1500000000
118863764831,1642929929,150000,120363764831,148610,128076631334,1500000000,1500000000
88013144322,1642961589,67634,89513144322,62834,107566928025,1500000000,1500000000
105504245943,1642916536,340059,107004245943,340059,124126764545,1500000000,1500000000
37824651997,1647363658,321604,39324651997,321604,48735884190,1500000000,1500000000
101785764581,1642966766,333724,103285764581,333724,153180268694,1500000000,1500000000
63898964103,1648578250,67634,65398964103,62834,81373472949,1500000000,1500000000
42022139492,1648522607,60150,43522139492,55350,43575230709,1500000000,1500000000
84913079955,1642931147,54715,86913079955,54715,110329693961,2000000000,2000000000
17422164970,1647317802,321054,18922164970,321054,23412220165,1500000000,1500000000
84160152106,1642959989,54836,85660152106,50036,103201571874,1500000000,1500000000
46332650556,1648517397,349072,47832650556,317338,53000000000,1500000000,1500000000
82665453756,1647368245,54760,84165453756,49960,115568343972,1500000000,1500000000
85698888265,1642929704,56516,87198888265,51716,107108220035,1500000000,1500000000
48374928555,1648584504,60838,49874928555,60838,68335523787,1500000000,1500000000
225983531079,1642910494,320408,227483531079,320408,234591079065,1500000000,1500000000
30591847473,1648577608,302713,32241847473,302713,33000000000,1650000000,1650000000
93193516674,1642899215,318082,94693516674,318082,126319442338,1500000000,1500000000
38908755420,1648525105,317232,40408755420,317232,42565798984,1500000000,1500000000
53123589953,1648589460,319705,55123589953,319705,68664407498,2000000000,2000000000
16766911342,1647342983,52928,18766911342,48128,26419380684,2000000000,2000000000
45283417757,1647353986,60850,46783417757,56050,58717983485,1500000000,1500000000
105768064590,1642901300,64741,107768064590,59941,138944890259,2000000000,2000000000
11865663173,1647344403,330561,13365663173,330561,17504699189,1500000000,1500000000
101147146401,1642951923,311701,108217402624,311701,108217402624,108217402624,7070256223
109722082331,1642899082,54872,111222082331,50072,163855443525,1500000000,1500000000
37373281476,1648519266,333652,39373281476,333652,42152986708,2000000000,2000000000
78488694611,1642938417,343797,79988694611,343797,109251447959,1500000000,1500000000
128908919355,1642980520,327926,130408919355,327926,133000000000,1500000000,1500000000
51338123827,1648564538,67622,52838123827,67622,59629626430,1500000000,1500000000
98726296671,1642954826,327990,100226296671,327990,131772080473,1500000000,1500000000
84256107570,1642923986,56516,85756107570,51716,118154882554,1500000000,1500000000
58260128091,1648588613,343831,59760128091,343831,77679406395,1500000000,1500000000
105939329706,1642925229,343241,107439329706,343241,135966586775,1500000000,1500000000
63725300564,1647358962,52592,65225300564,47792,75934872572,1500000000,1500000000
67925125479,1642938183,340059,69425125479,340059,80000000000,1500000000,1500000000
130424774487,1642950491,343227,131924774487,343227,175225157254,1500000000,1500000000
83227130422,1642918729,55681,85227130422,50881,119382131596,2000000000,2000000000
34268578356,1647307838,52916,35768578356,52916,46023665460,1500000000,1500000000
89657824961,1642918528,322943,93657824961,322943,133041933029,4000000000,4000000000
116461791840,1642910088,54872,117961791840,50072,121525781578,1500000000,1500000000
72838810978,1647356898,60862,74338810978,56062,85599235249,1500000000,1500000000
22869530175,1647305941,333724,24369530175,245049,25944590227,1500000000,1500000000
22869530175,1647305941,324852,24369530175,324852,25944590227,1500000000,1500000000
22869530175,1647305941,333724,24369530175,333724,27267581967,1500000000,1500000000
38954817564,1647373498,324852,40000000000,324852,40000000000,1500000000,1045182436
40831121244,1647351943,67634,41942650968,62834,41942650968,1500000000,1111529724
109370552625,1642929036,55580,110780552625,55580,117158926580,1410000000,1410000000
108236575390,1642927388,55580,109736575390,50780,129182717819,1500000000,1500000000
11018356251,1647325581,60862,12518356251,56062,18069268203,1500000000,1500000000
22533716037,1647311224,55592,24033716037,50792,26116526600,1500000000,1500000000
48288467338,1647357881,324154,49788467338,324154,66852699265,1500000000,1500000000
20001169054,1647308791,67646,22001169054,58046,30302628243,2000000000,2000000000
52989970066,1648589974,56492,54489970066,51692,74027013622,1500000000,1500000000
24715996629,1648537672,67634,26215996629,67634,29091640553,1500000000,1500000000
11851334583,1647331650,67622,13351334583,62822,17693365668,1500000000,1500000000
217486190618,1642979955,60862,218986190618,56062,252303241635,1500000000,1500000000
65009925825,1642938800,56516,66509925825,51716,88267763272,1500000000,1500000000
25655885522,1648556116,60862,27155885522,56062,39421124007,1500000000,1500000000
28938179857,1648525611,320467,29938179857,320467,31931011747,1000000000,1000000000
146775247914,1642976547,67634,148275247914,62834,150000000000,1500000000,1500000000
17262601771,1647327649,67634,18762601771,67634,23192260343,1500000000,1500000000
93218904794,1642899255,55580,94718904794,55580,117991895843,1500000000,1500000000
35020054825,1647363719,319303,36520054825,319303,49456193529,1500000000,1500000000
30962754146,1648585502,329182,32462754146,329182,40547623747,1500000000,1500000000
95955079235,1642928883,60862,97455079235,56062,121762507374,1500000000,1500000000
31709929889,1647386424,67634,33209929889,62834,44344196973,1500000000,1500000000
28183463750,1648545208,55693,29683463750,50893,38127701907,1500000000,1500000000
80286139611,1642906522,325661,81306139611,325661,82000000000,1020000000,1020000000
76759262557,1642946901,48603,78259262557,48603,93527979128,1500000000,1500000000
45347282350,1647365958,59982,46847282350,55182,50914538935,1500000000,1500000000
32354739726,1647376587,55717,33854739726,50917,48362798628,1500000000,1500000000
107186394429,1642953158,122029,109186394429,117229,113388322745,2000000000,2000000000
157389868625,1642950573,340625,158889868625,340625,159042375693,1500000000,1500000000
160949607573,1642965221,336841,162449607573,336841,218490656334,1500000000,1500000000
44790648837,1647360089,54759,46730648837,49959,63859358750,1940000000,1940000000
106400046278,1642904727,336839,107900046278,336839,125180518584,1500000000,1500000000
102390526134,1642944473,60850,103890526134,56050,126803828564,1500000000,1500000000
16604138199,1647341017,60862,18604138199,60862,26808244474,2000000000,2000000000
33887468554,1648546073,55592,35387468554,50792,41861706945,1500000000,1500000000
35671136616,1647359933,327323,37171136616,327323,46674679244,1500000000,1500000000
13773773721,1647331643,60838,15273773721,60838,19105856438,1500000000,1500000000
48930888765,1647350788,324124,50430888765,324124,68250005628,1500000000,1500000000
144442933619,1642975654,337500,145942933619,337500,260250976054,1500000000,1500000000
105674915066,1642909389,67634,107174915066,62834,116321635560,1500000000,1500000000
14142589557,1647330922,315552,15642589557,315552,20405997213,1500000000,1500000000
17562475733,1647323496,324818,19062475733,324818,23865825358,1500000000,1500000000
105143952551,1642926678,326089,106643952551,326089,128311102322,1500000000,1500000000
34484909027,1648523441,336865,35605410356,336865,37556085014,1120501329,1120501329
52723239116,1648573185,49495,54223239116,44695,62646031035,1500000000,1500000000
34994344714,1647377109,55584,36494344714,50784,43282663594,1500000000,1500000000
110585337267,1642919706,340641,112085337267,340641,129261105882,1500000000,1500000000
90185514997,1642950346,67634,91685514997,62834,116579389674,1500000000,1500000000
20498901294,1647340351,302595,21998901294,302595,27190931568,1500000000,1500000000
102255059120,1642927155,337510,103972527171,337510,130474309498,1717468051,1717468051
55785019229,1648557952,67634,57785019229,67634,77585487857,2000000000,2000000000
34887061871,1647383130,67646,36387061871,62846,51412850815,1500000000,1500000000
11952366474,1647325205,293117,13452366474,293117,18758157274,1500000000,1500000000
107389543118,1642901112,55648,109889543118,55648,221279305934,2500000000,2500000000
99528953579,1642956864,340649,101028953579,340649,142453950497,1500000000,1500000000
21449725793,1648536422,55717,22949725793,50917,32287710553,1500000000,1500000000
67522308630,1647365641,66814,69022308630,62014,73611027048,1500000000,1500000000
76750663065,1642915938,60850,78250663065,56050,85000000000,1500000000,1500000000
32816508206,1648574316,323030,34316508206,323030,53537714875,1500000000,1500000000
32151088390,1647364056,60838,33651088390,60838,48310915638,1500000000,1500000000
9474662406,1647330106,55705,10974662406,50905,15643012140,1500000000,1500000000
109313994276,1642896475,337508,110813994276,337508,153974196168,1500000000,1500000000
30858639638,1648534218,55680,32358639638,50880,42415231479,1500000000,1500000000
78136556705,1647370329,67634,79636556705,62834,95521090007,1500000000,1500000000
23101492199,1648541343,337474,24601492199,337474,31530279978,1500000000,1500000000
17003982388,1647321009,307841,18503982388,307841,36467747693,1500000000,1500000000
37222966909,1648568846,67646,38722966909,67646,63019570562,1500000000,1500000000
38729066827,1648560095,55720,40229066827,50920,75404062914,1500000000,1500000000
122760540391,1642962283,326099,124260540391,326099,139729627095,1500000000,1500000000
107173740079,1642925185,332600,108673740079,332600,152930989967,1500000000,1500000000
53464204078,1647364877,310181,54964204078,310181,65009231523,1500000000,1500000000
176876303205,1642976138,67634,178376303205,62834,189881655230,1500000000,1500000000
34843810103,1647363833,327960,36343810103,327960,55028831413,1500000000,1500000000
34642737282,1648553284,322933,36142737282,322933,42320232402,1500000000,1500000000
34908113448,1648549860,340689,36408113448,340689,41428947347,1500000000,1500000000
99367696967,1642959516,55717,101017696967,50917,104500000000,1650000000,1650000000
52219053996,1648559692,320396,53719053996,320396,99068977747,1500000000,1500000000
40451926410,1647355450,60850,41951926410,56050,55710840815,1500000000,1500000000
171052350047,1642970601,323050,172552350047,323050,230717044808,1500000000,1500000000
55467271035,1648592734,48663,60000000000,48663,60000000000,5000000000,4532728965
109396082086,1642978497,346356,110896082086,346356,112725608932,1500000000,1500000000
89225216642,1642915600,337482,90725216642,337482,105693868432,1500000000,1500000000
31353652975,1647363725,67634,32853652975,62834,49456193529,1500000000,1500000000
92077124964,1642917710,56504,93577124964,51704,113562622728,1500000000,1500000000
29439157529,1648523498,60850,30939157529,56050,44205931358,1500000000,1500000000
102658428487,1642935701,343221,104158428487,343221,123163011652,1500000000,1500000000
102658428487,1642935701,340659,104158428487,340659,123163011652,1500000000,1500000000
26353078383,1648542170,326806,27853078383,326806,30064445278,1500000000,1500000000
17287375519,1647346596,56564,18787375519,56564,23693320365,1500000000,1500000000
41384198987,1648558679,67634,42884198987,67634,50526792167,1500000000,1500000000
31716548113,1647329328,327337,33216548113,327337,39403953862,1500000000,1500000000
10688055583,1647333041,324222,12188055583,324222,14358867739,1500000000,1500000000
22700218520,1647384720,64741,24200218520,59941,30196814925,1500000000,1500000000
59206738654,1648595556,60862,60706738654,56062,71981177743,1500000000,1500000000
40496054401,1648597495,54812,41996054401,54812,60332463097,1500000000,1500000000
27071261325,1647308584,55693,28571261325,50893,37626257733,1500000000,1500000000
92259611219,1642929647,56516,93759611219,51716,111943290915,1500000000,1500000000
100529053524,1642902092,55648,103029053524,55648,181224203360,2500000000,2500000000
44941171051,1648571432,60874,87132771012,56074,,,
102154769830,1642936686,336855,103654769830,336855,112034283559,1500000000,1500000000
16104032386,1647338677,60850,17407137355,56050,17407137355,1500000000,1303104969
97052136572,1642945592,336825,98552136572,336825,119606743112,1500000000,1500000000
18019198191,1647343014,67646,20019198191,67646,23796984745,2000000000,2000000000
29664558185,1647318569,60838,30803391638,60838,30803391638,1500000000,1138833453
29591497534,1647378708,310888,31091497534,310888,45319178154,1500000000,1500000000
31710422803,1647310062,318508,33210422803,318508,36109776432,1500000000,1500000000
31710422803,1647310062,304002,33210422803,304002,36109776432,1500000000,1500000000
88026364939,1642933239,340025,89526364939,322925,110905783405,1500000000,1500000000
88026364939,1642933239,340071,89526364939,340071,122263474555,1500000000,1500000000
157224958585,1642972914,326069,158724958585,326069,162550474012,1500000000,1500000000
39508886391,1648597080,56492,41008886391,51692,48103678197,1500000000,1500000000
38613913483,1647316315,327407,40113913483,327407,54988105310,1500000000,1500000000
120474447008,1642907893,336657,121974447008,336657,161183675569,1500000000,1500000000
120474447008,1642907893,341875,121974447008,341875,161183675569,1500000000,1500000000
36494640944,1648563124,66778,37994640944,66778,47604165625,1500000000,1500000000
80582399274,1647367430,56576,82102861390,56576,123161208212,1520462116,1520462116
17734488022,1647319046,60850,19234488022,56050,24985045433,1500000000,1500000000
16158634137,1647323450,327395,17929219757,327395,24459615009,1770585620,1770585620
17423716441,1647341053,67646,19423716441,67646,24730260184,2000000000,2000000000
35044747035,1647316389,60850,36544747035,56050,42284996260,1500000000,1500000000
22327300875,1647348092,60838,23827300875,56038,31257268499,1500000000,1500000000
180823635030,1642965745,326095,182823635030,326095,216314630387,2000000000,2000000000
40262772495,1647365858,56576,41762772495,56576,53643127624,1500000000,1500000000
20770674282,1647342169,60862,22270674282,56062,25292061350,1500000000,1500000000
165311798829,1642970416,59994,166811798829,55194,210950267319,1500000000,1500000000
30338643840,1647362444,316586,31838643840,316586,44927767069,1500000000,1500000000
95483566873,1642955322,329268,96983566873,329268,112378766289,1500000000,1500000000
31067793008,1648532716,67634,32567793008,67634,38728723689,1500000000,1500000000
195626256912,1642910408,340041,197126256912,340041,215000495077,1500000000,1500000000
27328539779,1648535109,67646,28328539779,62846,30359162633,1000000000,1000000000
80156994427,1648591699,67646,85000000000,62846,,,
39697732037,1648587569,67646,41197732037,62846,48582993590,1500000000,1500000000
24670639942,1647307965,306944,25000000000,306944,25000000000,1100000000,329360058
33162101596,1647375751,328026,34662101596,328026,43776267730,1500000000,1500000000
107434007589,1642970916,329994,108934007589,329994,161189438490,1500000000,1500000000
29064161045,1647384522,322858,30564161045,322858,32946905278,1500000000,1500000000
122269323855,1642898651,329960,123769323855,329960,124117444312,1500000000,1500000000
98635882763,1642904899,67622,100135882763,67622,100621834054,1500000000,1500000000
100169292686,1647367265,60838,101835236695,60838,103809984300,1665944009,1665944009
18293775707,1647332253,60838,19793775707,60838,22715558234,1500000000,1500000000
72764880500,1642961334,67562,74264880500,67562,106821121418,1500000000,1500000000
133754867687,1642902578,60838,135254867687,60838,143992118545,1500000000,1500000000
30080898556,1648546732,67722,31580898556,62922,42936411069,1500000000,1500000000
15543478940,1647332134,60838,17043478940,60838,18878909914,1500000000,1500000000
55318469953,1641734514,54872,57818469953,54872,123267779502,2500000000,2500000000
17289443654,1647119932,67646,18789443654,62846,23151834594,1500000000,1500000000
184848931774,1643748841,55648,187348931774,55648,423017453126,2500000000,2500000000
73253370918,1645685305,334625,74853370918,334625,76000000000,1600000000,1600000000
34563764966,1650024796,60850,36063764966,60850,37000000000,1500000000,1500000000
40595932943,1649989757,54380,42095932943,49580,44639193895,1500000000,1500000000
50289800628,1645707681,332367,52289800628,332367,74158918660,2000000000,2000000000
19728636339,1647115138,67634,21228636339,62834,25649652834,1500000000,1500000000
60605019029,1645591104,52729,62105019029,52729,72490049548,1500000000,1500000000
49418740716,1650035407,60850,50918740716,60850,74544545773,1500000000,1500000000
29388295968,1649992321,64741,30888295968,59941,200000000000,1500000000,1500000000
12202725839,1647067452,353370,13702725839,353370,14780877467,1500000000,1500000000
30345800922,1650014955,60862,31845800922,56062,37189116548,1500000000,1500000000
97653423785,1641705496,319739,99153423785,319739,128040249215,1500000000,1500000000
32067188743,1649994365,67634,34067188743,67634,38171153912,2000000000,2000000000
22059936592,1647055450,340065,23559936592,340065,24361545224,1500000000,1500000000
49661340987,1650036144,67634,51161340987,62834,57000000000,1500000000,1500000000
49661340987,1650036144,60862,51161340987,56062,52000000000,1500000000,1500000000
16766103944,1647044872,340039,18266103944,340039,24374858467,1500000000,1500000000
47955923312,1645742666,326750,49465923312,326750,57112407584,1510000000,1510000000
52308091992,1650042102,55693,53808091992,50893,65281711413,1500000000,1500000000
158127353741,1641763540,67646,159627353741,62846,193228639110,1500000000,1500000000
99116609520,1645579796,55804,100616609520,55804,123668488007,1500000000,1500000000
42678283063,1650029158,60862,44178283063,56062,50223747413,1500000000,1500000000
17388493634,1647114515,60850,18888493634,56050,27839186792,1500000000,1500000000
53993773258,1645619463,55584,56243773258,50784,60500647568,2250000000,2250000000
64708995280,1645732866,54897,66708995280,50097,300000000000,2000000000,2000000000
47121253851,1650037247,67634,48621253851,67634,65144576837,1500000000,1500000000
24581925892,1647117491,67634,26081925892,62834,31629029197,1500000000,1500000000
15007708937,1647080297,67646,16507708937,62846,18563898377,1500000000,1500000000
43021210001,1649995894,67646,44521210001,62846,63856027509,1500000000,1500000000
33216350486,1649999278,346999,34716350486,346999,37515595777,1500000000,1500000000
22835090271,1647061585,331165,24335090271,331165,32158134372,1500000000,1500000000
24204773253,1647046731,331334,25704773253,331334,47158597238,1500000000,1500000000
31148729844,1650017676,60862,32648729844,56062,43214438802,1500000000,1500000000
47907738994,1650038728,66778,49407738994,61978,62874862170,1500000000,1500000000
23789896569,1650003788,49507,25289896569,49507,30324572478,1500000000,1500000000
87892204436,1641709174,60850,89392204436,56050,93846824190,1500000000,1500000000
230554181614,1641747735,49495,232054181614,49495,241116084060,1500000000,1500000000
54850800543,1645693539,325044,56360800543,325044,57101944339,1510000000,1510000000
48229476605,1650045539,67646,49729476605,62846,58537138492,1500000000,1500000000
142599894745,1641771058,60838,144099894745,56038,218634936843,1500000000,1500000000
19666448034,1647061653,336859,21166448034,336859,28990829388,1500000000,1500000000
60690750128,1645628353,60862,62190750128,56062,81623620417,1500000000,1500000000
27644610627,1650034484,340037,29144610627,340037,35147473590,1500000000,1500000000
45961436670,1645612232,55668,47471436670,50868,51530313370,1510000000,1510000000
57562434858,1650037723,67646,59062434858,62846,68439751114,1500000000,1500000000
55851890186,1650037955,60862,57351890186,56062,69195846783,1500000000,1500000000
58430599502,1650040212,330563,59930599502,330563,66207498297,1500000000,1500000000
70430776213,1645732834,55648,72930776213,55648,157398148408,2500000000,2500000000
32914289235,1650015527,67646,36000000000,62846,,,
92398778184,1643718913,337510,93898778184,337510,117122781930,1500000000,1500000000
194104975789,1645678234,67634,195614975789,67634,255583145152,1510000000,1510000000
194337523383,1641748941,343233,195383915680,343233,195383915680,10000000000,1046392297
175780084967,1645676173,350157,177280084967,350157,220639278013,1500000000,1500000000
60665255064,1645695192,329235,62175255064,329235,70233121767,1510000000,1510000000
10718743595,1647078106,67634,12218743595,67634,14584344817,1500000000,1500000000
47714634691,1650031152,54861,53714634691,50061,200000000000,6000000000,6000000000
146291038997,1641731569,54848,147791038997,54848,212515483770,1500000000,1500000000
30118335130,1647103072,60862,31618335130,56062,36824917625,1500000000,1500000000
45146086836,1645692407,328164,46656086836,328164,50631203795,1510000000,1510000000
47676819475,1650036164,60862,49176819475,56062,69900934017,1500000000,1500000000
59699632395,1650037540,67634,60699633395,67634,74482074179,1000001000,1000001000
59699632395,1650037540,49595,61199632395,44795,77585871929,1500000000,1500000000
36558890221,1650014872,67634,38058890221,62834,45442601678,1500000000,1500000000
39505297827,1650039391,66754,41005297827,61954,57753231653,1500000000,1500000000
77254941425,1650032219,67710,78754941425,67710,99733896490,1500000000,1500000000
14934480781,1647054259,340025,16434480781,340025,18015427555,1500000000,1500000000
29398610595,1647103053,55680,30898610595,50880,36824917625,1500000000,1500000000
65874453019,1645585607,349516,67374453019,349516,93969989622,1500000000,1500000000
38244040630,1650005776,310947,39744040630,310947,54730584773,1500000000,1500000000
45620106041,1647126835,320485,47120106041,320485,62634063020,1500000000,1500000000
21583189838,1650011021,67646,23083189838,67646,37389481273,1500000000,1500000000
35057030116,1650034680,67646,36557030116,62846,36934033948,1500000000,1500000000
56808065725,1645738931,329875,58808065725,329875,82198219276,2000000000,2000000000
63930837078,1650054395,60938,65430837078,56138,68417844702,1500000000,1500000000
123752026813,1641690228,325966,125752026813,308866,159091794506,2000000000,2000000000
123752026813,1641690228,329237,125752026813,329237,165041911230,2000000000,2000000000
92833108642,1643700561,303381,94333108642,303381,110460253308,1500000000,1500000000
29800525017,1645622901,326214,31310525017,326214,43799831733,1510000000,1510000000
19004306991,1647103594,340047,20504306991,340047,28364810960,1500000000,1500000000
66049102038,1645736582,48567,67549102038,48567,91010291264,1500000000,1500000000
28604595093,1647129330,71444,30104595093,66644,33284576265,1500000000,1500000000
136637941325,1643741817,340617,138137941325,340617,172583625473,1500000000,1500000000
58385659343,1650037448,60862,59885659343,56062,71545192145,1500000000,1500000000
95151263486,1641722018,336887,96651263486,336887,103177912027,1500000000,1500000000
17372149761,1647058100,55592,18872149761,45992,28922345305,1500000000,1500000000
43923220310,1645605467,349550,45423220310,349550,61819296482,1500000000,1500000000
43923220310,1645605467,329390,45433220310,329390,46734332955,1510000000,1510000000
30231046056,1650002206,67646,31731046056,62846,37010386132,1500000000,1500000000
23517855853,1650012872,60838,25017855853,60838,34805086140,1500000000,1500000000
25369742663,1650013930,55680,26869742663,50880,33274943254,1500000000,1500000000
137811847776,1641725649,54872,139311847776,50072,151287732167,1500000000,1500000000
26614353493,1647114239,67634,28114353493,58034,37780429847,1500000000,1500000000
13119753552,1647069871,314041,14005862984,314041,14005862984,1500000000,886109432
59760854141,1650035852,60850,61260854141,60850,66822752733,1500000000,1500000000
59760854141,1650035852,67634,61260854141,62834,66822752733,1500000000,1500000000
45662979968,1650002460,67634,47162979968,62834,53017137698,1500000000,1500000000
32641627449,1650031013,60862,34641627449,56062,48541111198,2000000000,2000000000
36994273559,1650034329,60850,38494273559,56050,55961107170,1500000000,1500000000
27490654858,1650064302,316579,28990654858,316579,38007296610,1500000000,1500000000
33457885552,1650008830,66814,34957885552,66814,40358512722,1500000000,1500000000
27842824323,1647090750,67634,29342824323,62834,44761734894,1500000000,1500000000
124724930734,1645640465,55624,126224930734,50824,150117129928,1500000000,1500000000
41315791577,1645610455,55740,42575216062,55740,42575216062,1510000000,1259424485
112992776377,1645710916,331941,114492776377,331941,120051758858,1500000000,1500000000
47636106988,1650059966,343189,49136106988,343189,60164113600,1500000000,1500000000
60179386976,1641735775,340069,61679386976,340069,84980931578,1500000000,1500000000
94604981182,1643718823,336881,96104981182,336881,134100380984,1500000000,1500000000
23078340783,1650021386,67634,24578340783,62834,33589789175,1500000000,1500000000
64768771946,1650038206,67634,66268771946,67634,90572129087,1500000000,1500000000
64768771946,1650038206,67634,72257703269,62834,,,
41422748286,1649986042,331123,42922748286,331123,49673589198,1500000000,1500000000
39001127077,1650006147,67622,44000000000,67622,,,
109352710906,1641723100,336887,110852710906,336887,123018690730,1500000000,1500000000
84459030537,1645577012,329974,85959030537,329974,114629309985,1500000000,1500000000
16722195070,1647064151,326028,18000000000,326028,18000000000,1500000000,1277804930
50702811580,1650037304,67646,52202811580,62846,67121819903,1500000000,1500000000
112759223479,1641722935,320380,114259223479,320380,158434705314,1500000000,1500000000
17594122806,1647088320,319767,18925778834,319767,18925778834,1500000000,1331656028
42902937871,1645626527,340661,44412937871,340661,48384941045,1510000000,1510000000
43915594706,1650031319,60862,45415594706,56062,52725409992,1500000000,1500000000
21856140953,1647096413,60926,23356140953,56126,32642766823,1500000000,1500000000
24586518251,1647116585,326950,26086518251,320481,28478234442,1500000000,1500000000
55359781843,1645694778,315505,56859781843,315505,65364778904,1500000000,1500000000
103413638644,1643726519,67722,104913638644,67722,123782219344,1500000000,1500000000
32450043705,1645617844,311655,33960043705,311655,42637887119,1510000000,1510000000
31628237530,1649992221,322908,33128237530,322908,35425685080,1500000000,1500000000
86600757813,1645579534,329268,105930480619,329268,105930480619,30520000000,19329722806
36629086966,1650033976,67634,38129086966,62834,42707722836,1500000000,1500000000
36629086966,1650033976,67622,38129086966,67622,40790703233,1500000000,1500000000
86080982578,1641726072,60862,87580982578,56062,91637464825,1500000000,1500000000
132137352649,1643699873,60874,133637352649,56074,147859142573,1500000000,1500000000
37273302091,1645616859,55668,38783302091,50868,41377821427,1510000000,1510000000
59461609934,1645687131,337448,62000000000,337448,,,
59461609934,1645687131,346352,62000000000,346352,,,
54606904820,1650037220,67634,56106904820,62834,73094331980,1500000000,1500000000
87008944907,1645663202,52916,88538944907,52916,99307674853,1530000000,1530000000
53314531755,1645694372,317222,54814531755,317222,64599154487,1500000000,1500000000
38276708252,1650030695,60838,39776708252,56038,55470122115,1500000000,1500000000
24275886120,1650021556,67634,25775886120,62834,26266907733,1500000000,1500000000
25677160855,1649997725,67634,27177160855,67634,32804411014,1500000000,1500000000
47588591419,1650028003,67698,49088591419,62898,54381182794,1500000000,1500000000
132981303978,1641747439,54771,134481303978,49971,139419456499,1500000000,1500000000
25012985777,1650021844,67646,26512985777,62846,32601886683,1500000000,1500000000
30103355692,1650034701,67646,31603355692,62846,34409087177,1500000000,1500000000
29948879396,1647127442,320471,31448879396,320471,37936370102,1500000000,1500000000
53770321632,1650041664,67646,55270321632,62846,85285910414,1500000000,1500000000
88658767504,1650057484,49583,90158767504,44783,102487712328,1500000000,1500000000
132665888882,1641701441,334306,134165888882,334306,145493850868,1500000000,1500000000
17926455322,1647054337,323563,19426455322,323563,21923153395,1500000000,1500000000
109310573553,1645679150,337454,110820573553,337454,162077284874,1510000000,1510000000
109310573553,1645679150,343225,110510573553,343225,115508179907,1200000000,1200000000
34862306019,1649981287,319577,36362306019,319577,40223353754,1500000000,1500000000
112829192861,1641688975,67634,114329192861,62834,159381238325,1500000000,1500000000
104234349149,1641696969,326178,105394915602,326178,105394915602,1500000000,1160566453
105306873164,1643744161,340053,106806873164,340053,171743060143,1500000000,1500000000
199779855257,1641756365,64717,201279855257,64717,219805011834,1500000000,1500000000
34340396125,1645614073,331985,35367647746,331985,36262691183,1027251621,1027251621
61797297366,1645720508,343159,63307297366,343159,74300758713,1510000000,1510000000
25703369976,1650026715,60862,27703369976,56062,31705492110,2000000000,2000000000
25703369976,1650026715,67646,27703369976,62846,34671337001,2000000000,2000000000
29781353465,1649986669,60938,31281353465,56138,39369810243,1500000000,1500000000
29781353465,1649986669,304737,31281353465,304737,33747698784,1500000000,1500000000
59110350349,1650035920,67646,60610350349,62846,77591987603,1500000000,1500000000
67244476084,1641735435,321630,68744476084,321630,90805029865,1500000000,1500000000
57215095496,1650036829,60850,58123474283,56050,58123474283,1500000000,908378787
57882977687,1650036849,64068,59882977687,54468,80166395811,2000000000,2000000000
56446710145,1645652360,343245,57158692672,343245,57158692672,1690000000,711982527
213308860957,1645674944,67634,214808860957,67634,232853272798,1500000000,1500000000
49321958065,1650032633,67622,50821958065,67622,56301812973,1500000000,1500000000
33397759871,1650013354,67734,34897759871,62934,46172823550,1500000000,1500000000
24764723868,1650011359,67634,26264723868,67634,34915792628,1500000000,1500000000
67169596607,1645594690,346993,68669596607,346993,107769541967,1500000000,1500000000
76120628151,1645707191,314845,77630628151,314845,84737654233,1510000000,1510000000
62286621200,1641735662,314164,63786621200,314164,87632593425,1500000000,1500000000
68572278541,1645707593,333171,70072278541,333171,80350092610,1500000000,1500000000
68572278541,1645707593,341911,70072278541,341911,80350092610,1500000000,1500000000
57692728410,1645703121,55705,59192728410,50905,72940528799,1500000000,1500000000
71050878576,1645700894,52940,72550878576,48140,89196031724,1500000000,1500000000
86600124921,1643693705,325044,88000000000,325044,88000000000,1500000000,1399875079
49625067450,1645697871,329150,51125067450,254560,67484050970,1500000000,1500000000
24325846884,1650024095,67634,25825846884,62834,36103391920,1500000000,1500000000
12321875828,1647083016,55592,14321875828,50792,25000000000,2000000000,2000000000
292540024846,1643735049,67646,294040024846,62846,436791411852,1500000000,1500000000
44180116198,1645620194,64067,45680116198,59267,49441467953,1500000000,1500000000
98323888124,1645658483,334531,99973888124,334531,127205338912,1650000000,1650000000
95145800944,1641722230,314146,96645800944,314146,116650339580,1500000000,1500000000
142126581006,1641720161,67634,143626581006,62834,199260004949,1500000000,1500000000
52413060626,1645593137,331153,53923060626,331153,61906165533,1510000000,1510000000
20397900500,1647061595,333718,21897900500,333718,32774491552,1500000000,1500000000
50907968258,1645603965,49483,52417968258,44683,58069140033,1510000000,1510000000
53268911607,1645593876,55693,54768911607,50893,72899890164,1500000000,1500000000
27407006071,1650013946,67634,28907006071,67634,33274943254,1500000000,1500000000
87255099811,1645634469,54727,88755099811,49927,105861005334,1500000000,1500000000
27363521450,1650022025,60862,29363521450,56062,45359856516,2000000000,2000000000
27363521450,1650022025,67734,29363521450,62934,65000000000,2000000000,2000000000
44550943967,1650034831,67646,46050943967,67646,46429828552,1500000000,1500000000
44550943967,1650034831,60862,46050943967,56062,46429828552,1500000000,1500000000
44550943967,1650034831,67646,46050943967,62846,48137720388,1500000000,1500000000
123388761216,1643724702,67646,124888761216,62846,136513892404,1500000000,1500000000
28713467731,1649994144,60862,30713467731,60862,39970062766,2000000000,2000000000
55930517557,1650036031,60950,57430517557,56150,75437261619,1500000000,1500000000
37264569256,1650008060,67646,38764569256,62846,47668502127,1500000000,1500000000
25772808975,1650025750,333652,27272808975,333652,29465857825,1500000000,1500000000
75581229739,1641715315,67634,77081229739,62834,112333184624,1500000000,1500000000
102784784962,1641706751,308938,104284784962,308938,122376233608,1500000000,1500000000
18944840227,1647070532,322148,20444840227,322148,22555955318,1500000000,1500000000
80917113104,1645580562,55828,82437113104,51028,87234362683,1520000000,1520000000
24259406545,1650024029,67634,25759406545,62834,32504389600,1500000000,1500000000
15490673999,1647080661,316738,16990673999,316738,18941255698,1500000000,1500000000
164995952773,1643737886,67646,166368352773,62846,187624868853,1372400000,1372400000
36173510787,1650002631,66742,37673510787,61942,56786407080,1500000000,1500000000
43841450378,1650032607,60862,45341450378,56062,50864859879,1500000000,1500000000
39554579540,1650034261,54322,41054579540,54322,53679361332,1500000000,1500000000
33158510480,1649996889,327984,34658510480,327984,41014000908,1500000000,1500000000
22401039350,1650013883,54320,23401039350,49520,35000000000,1000000000,1000000000
194616198432,1641741443,340033,196116198432,340033,199382449735,1500000000,1500000000
12755811254,1647084066,55717,13755811254,50917,14000000000,1000000000,1000000000
29234078284,1650029007,60850,30734078284,56050,43438653250,1500000000,1500000000
12839453341,1647060267,55592,14339453341,50792,18223038674,1500000000,1500000000
38039430308,1645622084,331947,39168575465,331947,39168575465,1500000000,1129145157
127483963912,1645637263,54861,129983963912,54861,250133223656,2500000000,2500000000
24370460011,1650022346,60862,25870460011,56062,38654585357,1500000000,1500000000
30393968081,1650019198,60862,31893968081,56062,37441142338,1500000000,1500000000
37149033706,1650034372,67634,38649033706,62834,46672412243,1500000000,1500000000
17444168660,1647088342,307768,18944168660,307768,25884078287,1500000000,1500000000
17444168660,1647088342,310973,18944168660,310973,21102455653,1500000000,1500000000
51545052845,1645597868,55592,53645052845,55592,60876315989,2100000000,2100000000
36044056114,1650024539,60862,37544056114,56062,40207318799,1500000000,1500000000
104769470936,1641692095,313395,106769470936,313395,129663325722,2000000000,2000000000
31765383862,1650063924,55271,33265383862,50471,41767005460,1500000000,1500000000
52179899974,1645608479,56588,53679899974,51788,65490948767,1500000000,1500000000
289630019406,1641719885,316087,291130019406,316087,368743924184,1500000000,1500000000
76129427366,1645583201,60850,77659427366,56050,80477570318,1530000000,1530000000
82651236366,1645590944,54688,84151236366,49888,112649063040,1500000000,1500000000
28916140723,1650026739,67634,30416140723,67634,32914747117,1500000000,1500000000
26538454271,1650020624,67646,28538454271,62846,37852719948,2000000000,2000000000
23886307353,1650017444,66778,25386307353,61978,34083930315,1500000000,1500000000
29799350586,1649986786,67634,31299350586,62834,32599259780,1500000000,1500000000
107444598183,1641741712,60850,108944598183,60850,159292020700,1500000000,1500000000
107444598183,1641741712,323571,108944598183,323571,147496882937,1500000000,1500000000
169049960993,1643683058,67634,170549960993,62834,207415160425,1500000000,1500000000
58700687546,1645724727,346320,60700687546,346320,69231824121,2000000000,2000000000
23402539724,1650021312,67734,24902539724,62934,30398399273,1500000000,1500000000
27845723877,1650000912,67646,29345723877,62846,33005962500,1500000000,1500000000
29866460197,1649983011,60850,31366460197,56050,52130726929,1500000000,1500000000
44337380533,1650033886,60862,45837380533,56062,61593675927,1500000000,1500000000
190736836772,1641758768,67634,192236836772,62834,266486508203,1500000000,1500000000
28961281233,1647116653,60850,30461281233,60850,39624612302,1500000000,1500000000
66641416910,1650036758,60850,68141416910,60850,78620009943,1500000000,1500000000
74528605162,1645592073,54727,76028605162,49927,89462697783,1500000000,1500000000
206286932205,1645676075,52928,209536932205,48128,225283353228,3250000000,3250000000
114758996816,1641693715,64729,116758996816,59929,119892053276,2000000000,2000000000
83361021537,1641733816,323660,84861021537,323660,96916844942,1500000000,1500000000
110300518471,1641763026,327984,112605723471,327984,113000000000,2305205000,2305205000
79345678713,1643707741,326308,80845678713,326308,87020123275,1500000000,1500000000
84475442033,1645728879,55648,86975442033,55648,158997030438,2500000000,2500000000
35510932582,1649988469,316584,37010932582,316584,48221143502,1500000000,1500000000
311510542041,1643734800,322998,313010542041,322998,333692101483,1500000000,1500000000
38741370578,1650030913,67646,41000000000,62846,,,
72249939985,1641733684,314051,73749939985,314051,95481010608,1500000000,1500000000
157132971284,1643743975,319713,158632971284,319713,168894431052,1500000000,1500000000
34380535980,1650004982,60862,35880535980,56062,36390069077,1500000000,1500000000
22495982225,1650022793,49583,23995982225,44783,30069789523,1500000000,1500000000
52258202186,1650035771,67634,54258202186,62834,55684104942,2000000000,2000000000
22566404159,1650026940,66778,24566404159,66778,30372688022,2000000000,2000000000
82555716713,1641732962,333732,84055716713,333732,85000000000,1500000000,1500000000
92363492753,1645646751,67634,94363492753,62834,123987788623,2000000000,2000000000
52059533684,1645600352,55620,53559533684,50820,60178075877,1500000000,1500000000
25817681653,1650024928,67634,27317681653,62834,30913190500,1500000000,1500000000
53997419749,1650028226,55681,55497419749,55681,62329250240,1500000000,1500000000
53997419749,1650028226,67646,55497419749,62846,57403798572,1500000000,1500000000
70517180882,1650032021,67634,72017180882,62834,82780291742,1500000000,1500000000
115679489396,1643721835,60862,117179489396,56062,125276330340,1500000000,1500000000
71493003228,1643712733,333696,72993003228,333696,94326541969,1500000000,1500000000
172911589621,1641759717,54837,174411589621,50037,216930517105,1500000000,1500000000
27066765475,1650019110,67646,28566765475,62846,34599264997,1500000000,1500000000
192346496049,1641767451,67634,193846496049,62834,252889402969,1500000000,1500000000
191080449573,1643673659,60862,192580449573,56062,251177611874,1500000000,1500000000
58234575192,1650040119,67646,60234575192,62846,69295798229,2000000000,2000000000
59043071036,1641735046,67646,60543071036,62846,74302313353,1500000000,1500000000
342581733526,1641757166,60862,344269710891,56062,403746930030,1687977365,1687977365
33587806944,1649992679,60862,35087806944,56062,40150197925,1500000000,1500000000
87329714291,1641726111,67622,88930214291,67622,98635123789,1600500000,1600500000
29502013316,1650064352,67734,31002013316,67734,34768695815,1500000000,1500000000
27349724150,1650029567,60862,28849724150,56062,34076909205,1500000000,1500000000
38231705167,1650027501,67646,39731705167,62846,47273269433,1500000000,1500000000
18972737430,1650021217,330553,20472737430,330553,24754024193,1500000000,1500000000
245791283290,1641754295,336877,247291283290,336877,287905030595,1500000000,1500000000
94211153506,1643719121,60838,95711153506,60838,109804067584,1500000000,1500000000
57149005759,1645588413,55584,58809005759,50784,65509488183,1660000000,1660000000
38635360992,1650042653,301610,40135360992,301610,40314839354,1500000000,1500000000
34530528307,1647106998,67646,36030528307,62846,41487204237,1500000000,1500000000
34530528307,1647106998,333692,36030528307,333692,43848778657,1500000000,1500000000
22512520949,1647073329,317330,24012520949,317330,27988232097,1500000000,1500000000
107340394664,1641687970,330547,108840394664,330547,120979465688,1500000000,1500000000
140230325950,1641729611,67622,141730325950,67622,154218776775,1500000000,1500000000
49082721078,1645619437,55668,50632721078,50868,58019832720,1550000000,1550000000
38210187787,1650031059,67646,39710187787,62846,42302034312,1500000000,1500000000
85918423953,1645576467,67634,86412642492,67634,86412642492,1500000000,494218539
26148431074,1645623594,67634,27648431074,67634,38795316395,1500000000,1500000000
152664921220,1643748209,331356,154164921220,331356,155000000000,1500000000,1500000000
83623273405,1645642498,52916,85123273405,48116,114323828332,1500000000,1500000000
37469891262,1645617181,55584,38969891262,50784,47027729980,1500000000,1500000000
32025398097,1650034388,333704,33525398097,333704,46672412243,1500000000,1500000000
32025398097,1650034388,67646,33525398097,62846,49737235435,1500000000,1500000000
148076653215,1641772678,60850,149576653215,56050,207293607068,1500000000,1500000000
148076653215,1641772678,60862,149576653215,56062,164111483427,1500000000,1500000000
53892873215,1650036269,60862,55542873215,56062,56000000000,1650000000,1650000000
141962458706,1641731821,67646,143462458706,62846,166711204862,1500000000,1500000000
18313790856,1647054407,306977,19813790856,306977,25729272469,1500000000,1500000000
25686402138,1650026296,67622,27686402138,67622,43828256961,2000000000,2000000000
38100970560,1649988743,67734,39600970560,62934,45404798533,1500000000,1500000000
207549907398,1641749897,67634,209049907398,67634,232142039812,1500000000,1500000000
136627073431,1645680835,343823,138127073431,343823,165482964107,1500000000,1500000000
28327330923,1650025980,67634,29827330923,67634,40829217083,1500000000,1500000000
31086810177,1650008794,60850,32586810177,60850,33492143682,1500000000,1500000000
43649889265,1650028756,60950,45149889265,56150,66497417042,1500000000,1500000000
18250071368,1647070975,67634,19750071368,62834,21268691430,1500000000,1500000000
23927847734,1647103412,67622,25427847734,62822,31695345949,1500000000,1500000000
110958439465,1643699905,67658,112458439465,62858,142198801419,1500000000,1500000000
85186161604,1643722225,55717,86262590924,50917,86262590924,1500000000,1076429320
24905505017,1650020399,67646,26405505017,62846,32693987788,1500000000,1500000000
138477153112,1641759878,340671,139977153112,340671,147162656934,1500000000,1500000000
56059089803,1641735234,67634,57559089803,62834,75701791645,1500000000,1500000000
47245185381,1645707844,326850,48755185381,326850,59998354224,1510000000,1510000000
57473971646,1650036019,67634,58973971646,62834,75664154542,1500000000,1500000000
169271550159,1641770099,55580,170771550159,50780,226626776514,1500000000,1500000000
86242686772,1643707589,331093,87742686772,331093,150026616234,1500000000,1500000000
44484207516,1650040932,54676,45984207516,49876,65448409508,1500000000,1500000000
46471553996,1650036515,67622,47881553996,67622,49458533553,1410000000,1410000000
50627340004,1645746451,56516,52627340004,51716,300000000000,2000000000,2000000000
49473539824,1645599788,55644,51973539824,55644,100469901518,2500000000,2500000000
154539156232,1641741575,340721,156039156232,340721,193856337483,1500000000,1500000000
224967922162,1641754225,67634,226467922162,62834,287350611939,1500000000,1500000000
116767209094,1641687521,322466,118267209094,322466,135498975825,1500000000,1500000000
11399255744,1647075328,67622,12899255744,67622,16353050277,1500000000,1500000000
126868500754,1643729974,67646,146000000000,62846,,,
56873052550,1645618758,55584,58373052550,50784,67261947277,1500000000,1500000000
59409580279,1645700084,337442,60909580279,337442,79381840067,1500000000,1500000000
39696495462,1645669510,49483,40766495462,49483,43465086080,1070000000,1070000000
50074488559,1650036508,60850,51574488559,56050,62677968945,1500000000,1500000000
38912285474,1650039428,67646,46000000000,62846,,,
31842272129,1649992248,322436,32740311369,322436,32740311369,1500000000,898039240
70493958624,1641718165,66754,71993958624,61954,86215823138,1500000000,1500000000
52443839766,1645700126,316097,53943839766,316097,84395767239,1500000000,1500000000
52443839766,1645700126,336857,55150469906,336857,,,
17573886546,1647091737,310469,19073886546,310469,26754400135,1500000000,1500000000
121521552554,1645714879,337428,123021552554,337428,142168186568,1500000000,1500000000
35168769685,1650001281,59970,36668769685,55170,36798154222,1500000000,1500000000
86369025792,1645596199,49507,87869025792,49507,94573601124,1500000000,1500000000
58801278674,1650035265,67646,60683078674,62846,81342857879,1881800000,1881800000
35277256581,1650045064,340041,36552431605,340041,36552431605,1500000000,1275175024
49007411549,1650061567,67634,50507411549,62834,61917729155,1500000000,1500000000
61200924970,1645630993,326089,62710924970,326089,75908774227,1510000000,1510000000
39278480301,1645701933,55572,40778480301,50772,53888901543,1500000000,1500000000
36778389233,1650039411,60938,42000000000,60938,,,
23134214291,1650065145,67646,25134214291,62846,37405007259,2000000000,2000000000
133085780045,1641724613,60850,134585780045,60850,181849188849,1500000000,1500000000
65468656294,1645647863,340027,66968656294,340027,76593491540,1500000000,1500000000
58834132358,1645700115,334288,60334132358,317188,79381840067,1500000000,1500000000
50067547045,1650032956,55705,51567547045,50905,69968341825,1500000000,1500000000
82195762625,1643696271,67634,83695762625,62834,111205942417,1500000000,1500000000
47929633646,1645603615,60850,49459633646,56050,51095000563,1530000000,1530000000
60767949723,1645735187,54909,62767949723,50109,200000000000,2000000000,2000000000
45629710793,1650045487,67622,47129710793,62822,66685301133,1500000000,1500000000
47277926596,1650037235,67634,48777926596,67634,68969194939,1500000000,1500000000
47736767809,1645669376,335080,49236767809,335080,62675069463,1500000000,1500000000
57942933237,1650058030,59934,59442933237,59934,74827849917,1500000000,1500000000
33863143890,1650034708,60850,35363143890,56050,44373562325,1500000000,1500000000
39755604340,1650036390,333694,41255604340,333694,51000000000,1500000000,1500000000
14854043826,1647113823,67646,16354043826,62846,20037190033,1500000000,1500000000
18428200771,1647061670,331203,19928200771,331203,29077802130,1500000000,1500000000
25287535619,1650010238,66778,26787535619,61978,36031499840,1500000000,1500000000
101588898036,1641689229,66742,103088898036,61942,127908299674,1500000000,1500000000
63820042769,1645709662,336799,65230042769,336799,71859538047,1410000000,1410000000
28385409251,1650014692,60850,29785175810,60850,29785175810,1500000000,1399766559
35880665655,1650015493,320449,37380665655,320449,42135044097,1500000000,1500000000
121290445956,1641721126,60862,122790445956,56062,137769588098,1500000000,1500000000
50274189412,1645666149,337536,51784189412,337536,59537283590,1510000000,1510000000
50480395131,1650036309,60862,51980395131,56062,71099106674,1500000000,1500000000
119251291603,1641687357,67622,120751291603,67622,183934261583,1500000000,1500000000
29656568392,1645621410,59958,31156568392,55158,42275322460,1500000000,1500000000
47449392877,1645587698,326081,48949392877,326081,50000000000,1500000000,1500000000
38095010540,1650034728,314134,39129194615,314134,39129194615,1500000000,1034184075
191887292837,1641758520,67634,193387292837,67634,249381281270,1500000000,1500000000
26432861169,1647099481,66862,27932861169,66862,28349420903,1500000000,1500000000
49818604812,1645619476,55608,52098604812,50808,62853401348,2280000000,2280000000
117525999088,1645734773,55592,119025999088,50792,135130646839,1500000000,1500000000
29714345718,1650009540,54688,31214345718,54688,43800467184,1500000000,1500000000
11589801639,1647084526,67634,13529801639,67634,15628698928,1940000000,1940000000
29528779953,1650013796,54748,31028779953,49948,36784322590,1500000000,1500000000
29528779953,1650013796,60850,31028779953,60850,36566458363,1500000000,1500000000
34818593087,1645621696,55644,36318593087,55644,49413301875,1500000000,1500000000
30186222509,1650028953,54861,35186222509,50061,100000000000,5000000000,5000000000
170252728322,1641759171,64741,171752728322,59941,225819025199,1500000000,1500000000
180142878940,1641739584,343261,181642878940,343261,185271256890,1500000000,1500000000
15174901409,1647071737,54332,17174901409,49532,18673813171,2000000000,2000000000
54195848663,1650036236,60838,55695848663,60838,61686007760,1500000000,1500000000
77865218609,1643720969,302605,79365218609,302605,104271394527,1500000000,1500000000
56770138881,1650037862,67634,58270138881,62834,68447652545,1500000000,1500000000
56770138881,1650037862,67634,58270138881,62834,68447652545,1500000000,1500000000
65692251376,1650038190,67634,70737718913,62834,,,
62169346503,1645694705,54920,63669346503,50120,80453655087,1500000000,1500000000
108024761486,1645683846,329988,109524761486,329988,126827334548,1500000000,1500000000
51338044174,1650037018,60078,52838044174,55278,72407670029,1500000000,1500000000
51338044174,1650037018,67634,53338044174,67634,82109257481,2000000000,2000000000
44219400270,1650045252,67646,45719400270,62846,47734612250,1500000000,1500000000
169284275796,1641756374,67634,170784275796,62834,179797981808,1500000000,1500000000
81182626042,1645627833,326019,82682626042,326019,87273829685,1500000000,1500000000
66010309022,1645712251,66766,67510309022,66766,92720867017,1500000000,1500000000
32498216415,1650014831,54700,33998216415,49900,46516023162,1500000000,1500000000
119655577375,1641690396,329239,121155577375,329239,137464920153,1500000000,1500000000
86957587090,1641729137,331185,88457587090,331185,95953875799,1500000000,1500000000
46944592573,1645607300,55572,48444592573,50772,57438011015,1500000000,1500000000
122756806473,1641714013,322971,124256806473,322971,169254410464,1500000000,1500000000
122756806473,1641714013,337476,124256806473,337476,169254410464,1500000000,1500000000
103704161373,1641717451,325637,105204161373,325637,111000000000,1500000000,1500000000
74666904827,1643715058,67646,76166904827,62846,94850463529,1500000000,1500000000
69690371809,1645582941,349574,71190371809,349574,78800010803,1500000000,1500000000
27996775068,1650026368,319733,29429105604,319733,29429105604,1500000000,1432330536
55007177548,1650038264,67710,57000000000,67710,,,
124362172904,1643753481,55648,126862172904,55648,249466026168,2500000000,2500000000
26231960114,1650066001,67634,27731960114,62834,31083836357,1500000000,1500000000
26106841094,1647119670,313545,27606841094,313545,36479503635,1500000000,1500000000
49308708181,1645612934,343809,50808708181,343809,65505002900,1500000000,1500000000
65162393511,1645739315,54921,67162393511,50121,300000000000,2000000000,2000000000
31773298261,1650046932,59982,32910400372,59982,32910400372,1410000000,1137102111
13991809821,1647079962,52916,15491809821,52916,18063954164,1500000000,1500000000
35663353932,1645616598,55584,37173353932,50784,44458176052,1510000000,1510000000
73458084788,1645587262,55584,74968084788,50784,79141756514,1510000000,1510000000
18205233637,1647104117,67634,19705233637,62834,27579292085,1500000000,1500000000
30032534390,1649993760,63200,31532534390,63200,58989220400,1500000000,1500000000
88715400219,1641729173,320493,90215400219,320493,107496501159,1500000000,1500000000
27954474546,1649997855,67646,28954474546,62846,33309429349,1000000000,1000000000
52455117454,1645736257,67646,53955117454,62846,69488681504,1500000000,1500000000
33978252375,1649989010,319713,35478252375,319713,39638097615,1500000000,1500000000
33978252375,1649989010,54332,35478252375,49532,41691936280,1500000000,1500000000
57005947817,1650040861,333728,58945947817,333728,71743612679,1940000000,1940000000
25707456843,1650011398,328212,27207456843,328212,30773082730,1500000000,1500000000
422971788318,1643732365,316606,424911788318,316606,505760736635,1940000000,1940000000
37625057351,1645598416,55668,39135057351,50868,40000000000,1510000000,1510000000
26103805763,1650027360,67634,27603805763,62834,41793581644,1500000000,1500000000
32406766704,1650012051,54712,33906766704,49912,34224244862,1500000000,1500000000
26313012856,1650012576,55680,27813012856,50880,37134600682,1500000000,1500000000
232766821304,1645674339,335144,234346821304,335144,337467079838,1580000000,1580000000
125757640545,1645678969,325012,127257640545,325012,130475272163,1500000000,1500000000
89177125372,1641729147,331185,90677125372,245063,105612799100,1500000000,1500000000
29337015052,1649999570,305796,30837015052,305796,42449311902,1500000000,1500000000
23684216410,1647059177,56504,25184216410,51704,27816071185,1500000000,1500000000
23684216410,1647059177,324226,25184216410,324226,27816071185,1500000000,1500000000
59725299997,1645719368,49519,61225299997,44719,69796419175,1500000000,1500000000
48556846208,1650030308,336863,50056846208,336863,50188896552,1500000000,1500000000
162840046602,1641750117,67646,164340046602,62846,204825989018,1500000000,1500000000
117946767338,1641771984,60838,119446767338,60838,165707787400,1500000000,1500000000
33881419974,1645607592,343773,35000000000,343773,35000000000,1500000000,1118580026
68604056646,1645650155,326071,70000000000,326071,70000000000,1500000000,1395943354
24795249975,1650006814,67634,26295249975,67634,31094433448,1500000000,1500000000
33550922600,1650028972,55717,35050922600,50917,39285549545,1500000000,1500000000
151882010208,1641747189,55592,153382010208,50792,161159140610,1500000000,1500000000
33154607260,1645601536,340639,34664607260,340639,35797450794,1510000000,1510000000
28248828628,1650012615,67710,29748828628,67710,34810359204,1500000000,1500000000
42550803188,1649995545,60850,44050803188,56050,48779317830,1500000000,1500000000
54478134760,1645692908,332333,55978134760,332333,63748729230,1500000000,1500000000
48129606797,1645670664,54724,58000000000,49924,,,
23847041487,1649991572,60850,25121817744,56050,25121817744,1500000000,1274776257
105319921030,1641730552,60838,106819921030,60838,107466888004,1500000000,1500000000
23989233257,1647103565,67634,25489233257,67634,29208983998,1500000000,1500000000
26870301136,1650028926,60862,28370301136,56062,46427050759,1500000000,1500000000
60557773971,1650036795,67634,62057773971,62834,77350845595,1500000000,1500000000
35358847661,1650033686,67646,36858847661,62846,52589577675,1500000000,1500000000
22953237021,1650018401,67646,24453237021,62846,31524282024,1500000000,1500000000
23730772518,1647101157,67646,25230772518,62846,26985943174,1500000000,1500000000
47483629328,1645692316,54310,48983629328,54310,56000000000,1500000000,1500000000
47509346666,1645724774,337418,49509346666,337418,69759223349,2000000000,2000000000
35432064547,1650034018,67634,36932064547,62834,46497190272,1500000000,1500000000
22629062889,1650024360,67622,24129062889,62822,31573439468,1500000000,1500000000
14176616357,1647054749,60850,15676616357,60850,19630447103,1500000000,1500000000
12414947435,1647087559,67634,13914947435,62834,16564012694,1500000000,1500000000
39268575575,1650039525,67722,41000000000,67722,,,
174375400510,1643741291,67634,175875400510,62834,247153165808,1500000000,1500000000
101003435543,1643723580,55705,102503435543,50905,113369019970,1500000000,1500000000
54482774848,1650041718,67634,55982774848,67634,66407767628,1500000000,1500000000
36377042820,1650033642,60874,37877042820,56074,52589577675,1500000000,1500000000
62167254403,1645577174,55620,63687254403,50820,63817562729,1520000000,1520000000
23433349798,1650022480,67734,24933349798,62934,35852703123,1500000000,1500000000
15803807039,1647114741,67646,17303807039,62846,22116066054,1500000000,1500000000
114512761755,1645640111,66766,116012761755,61966,129299124695,1500000000,1500000000
55014711869,1650059544,67634,56514711869,62834,75263841293,1500000000,1500000000
63568846303,1650035220,67646,65508846303,62846,68267728639,1940000000,1940000000
63568846303,1650035220,60862,65508846303,56062,68267728639,1940000000,1940000000
70293260675,1643710737,67646,71793260675,62846,98523450085,1500000000,1500000000
36757461464,1645607942,55572,38267461464,50772,45102748179,1510000000,1510000000
127131897838,1645734144,64741,129231897838,59941,148920845342,2100000000,2100000000
147767856390,1641711189,60850,149267856390,60850,183611465850,1500000000,1500000000
42261071793,1645617274,55584,43761071793,50784,47027729980,1500000000,1500000000
57275465584,1650037192,60850,58775465584,60850,69438815970,1500000000,1500000000
16760118999,1647115941,67634,18260118999,67634,24256800804,1500000000,1500000000
61643209683,1641735069,54872,64143209683,54872,112094070150,2500000000,2500000000
32810812816,1649991860,67634,34310812816,67634,38534100955,1500000000,1500000000
36904735777,1650006171,67622,38404735777,67622,48696977734,1500000000,1500000000
24863349652,1650029521,337458,26363349652,337458,31067144948,1500000000,1500000000
15240309471,1647085590,67646,16740309471,62846,18892346502,1500000000,1500000000
50362595963,1645605693,55584,51882595963,50784,68019396712,1520000000,1520000000
44750408812,1645607266,323612,46250408812,323612,61359158137,1500000000,1500000000
55059635659,1645603581,60862,56559635659,56062,73085796487,1500000000,1500000000
123791430378,1645714852,346328,124767927574,346328,124767927574,1620000000,976497196
51213112741,1650059434,59982,52713112741,55182,69256198624,1500000000,1500000000
11816099522,1647086678,336295,13316099522,336295,13562696493,1500000000,1500000000
67531220749,1645660354,333055,81000000000,333055,,,
23550755667,1650022941,64056,25050755667,59256,36765780813,1500000000,1500000000
35099714578,1650044262,60862,36599714578,56062,50945237873,1500000000,1500000000
67269820527,1641736803,60850,68769820527,56050,76249300345,1500000000,1500000000
22192359874,1647063642,67634,23422412693,62834,23422412693,1500000000,1230052819
53975355951,1650037215,67634,55975355951,67634,76458105260,2000000000,2000000000
59361433316,1641735188,325651,60492220346,325651,63051436665,1130787030,1130787030
106220659208,1641742135,67622,107720659208,67622,132744868795,1500000000,1500000000
18546477800,1647112110,324796,20046477800,324796,22000000000,1500000000,1500000000
126752266239,1641700429,60838,128252266239,56038,139704465260,1500000000,1500000000
82509579011,1645711407,328210,84009579011,328210,85207023819,1500000000,1500000000
30919389291,1649992711,67646,32419389291,62846,48153640528,1500000000,1500000000
43440008205,1650038555,67622,45440008205,62822,46000000000,2000000000,2000000000
29668163950,1650010103,60850,31168163950,60850,37377993952,1500000000,1500000000
21065739262,1650062349,67622,22565739262,67622,31336752557,1500000000,1500000000
48753991416,1650036624,67634,50753991416,62834,77000000000,2000000000,2000000000
18937119540,1647102692,67622,20437119540,67622,21239535388,1500000000,1500000000
164819784266,1643738891,67634,166319784266,67634,169132774895,1500000000,1500000000
69273083613,1645575581,332524,78000000000,332524,,,
53552384119,1650040264,67622,55052384119,67622,77379844312,1500000000,1500000000
57038022635,1650037351,66814,58538022635,62014,67121819903,1500000000,1500000000
22232360643,1647116411,60006,23732360643,55206,34238774595,1500000000,1500000000
26492291955,1650022961,60054,27992291955,60054,30938444584,1500000000,1500000000
53223723838,1650041458,60850,54723723838,56050,72859345407,1500000000,1500000000
47111129381,1650042330,66790,48611129381,61990,71070841849,1500000000,1500000000
10419352702,1647081835,60862,11919352702,56062,15777740078,1500000000,1500000000
51622210836,1645603222,55680,53132210836,50880,62074631103,1510000000,1510000000
110575835254,1641763038,323616,112075835254,323616,146841497043,1500000000,1500000000
23047560209,1647062070,317322,24547560209,317322,32825913412,1500000000,1500000000
40126260793,1645605742,67622,41626260793,62822,61643798305,1500000000,1500000000
45121603361,1650036552,67646,46621603361,67646,51000000000,1500000000,1500000000
45121603361,1650036552,67646,46621603361,62846,64093110699,1500000000,1500000000
27841240844,1650004407,67646,29341240844,62846,32435169695,1500000000,1500000000
27890112283,1647119248,67634,29390112283,62834,36835008464,1500000000,1500000000
24257308116,1649996147,60838,25757308116,56038,39270610185,1500000000,1500000000
65091957721,1645731793,55648,67591957721,55648,132714790468,2500000000,2500000000
125217903404,1641701612,319759,126717903404,319759,142005467173,1500000000,1500000000
150177030722,1641750284,49471,151677030722,49471,188229530997,1500000000,1500000000
54344707238,1647045646,67646,56344707238,62846,80961847817,2000000000,2000000000
51131182041,1650035393,67646,52631182041,62846,70475915670,1500000000,1500000000
102478913344,1641726340,322915,103984823794,322915,129281830519,1505910450,1505910450
14073389076,1647074059,67634,15573389076,67634,22567418904,1500000000,1500000000
25816916396,1650012655,67634,27316916396,67634,37113995644,1500000000,1500000000
109474571454,1641730689,332448,110974571454,332448,123138887107,1500000000,1500000000
73629168635,1645583598,329994,75129168635,329994,75915773245,1500000000,1500000000
102583493314,1645715372,338712,104083493314,338712,123268442910,1500000000,1500000000
214170197316,1641765734,67634,215670197316,62834,239653487567,1500000000,1500000000
26569780418,1650019950,60838,28069780418,60838,32237588553,1500000000,1500000000
23722795132,1649987635,67646,25222795132,62846,35036135190,1500000000,1500000000
177478034155,1641758543,67634,178978034155,62834,223903084969,1500000000,1500000000
11230173814,1647069930,67646,13230173814,62846,15000000000,2000000000,2000000000
104265992591,1643680744,337486,105765992591,251364,189991800830,1500000000,1500000000
63505758220,1645651947,340653,65025758220,340653,67291948762,1520000000,1520000000
46275688299,1645606882,326110,48705688299,326110,58891944699,2430000000,2430000000
119243123873,1641723117,331177,120743123873,331177,123018690730,1500000000,1500000000
81136816139,1643701955,340619,82636816139,340619,85000000000,1500000000,1500000000
77009196781,1645583367,54748,78509196781,49948,98825107494,1500000000,1500000000
26632849565,1650026099,60938,28132849565,56138,41184285773,1500000000,1500000000
36026192172,1650028478,67634,37526192172,62834,42062652653,1500000000,1500000000
80830913353,1643723360,54921,82330913353,50121,300000000000,1500000000,1500000000
29080663027,1650028836,49595,30580663027,44795,44210913935,1500000000,1500000000
26373737270,1650014405,67646,27873737270,62846,39962173834,1500000000,1500000000
27682657047,1650011527,60018,28842503167,60018,28842503167,1500000000,1159846120
27682657047,1650011527,67634,29182657047,67634,32259434722,1500000000,1500000000
36300200762,1650045108,316588,37800200762,316588,45004236343,1500000000,1500000000
35263086959,1650028899,67646,36763086959,62846,37850828784,1500000000,1500000000
121296053796,1641690202,60862,122796053796,56062,164844124753,1500000000,1500000000
106524467208,1643697598,60838,108024467208,60838,119875077502,1500000000,1500000000
27414369459,1650022399,329187,28914369459,329187,32614513092,1500000000,1500000000
58435904133,1650037065,60850,59935904133,60850,65672555218,1500000000,1500000000
31758232963,1649989051,67646,33258232963,62846,43972815469,1500000000,1500000000
79011347797,1645595994,329899,81011347797,329899,111768502896,2000000000,2000000000
51378949468,1645693079,337099,52878949468,337099,63850226215,1500000000,1500000000
48917948313,1645666115,340023,50417948313,340023,75061183405,1500000000,1500000000
28486580325,1650013732,49607,29986580325,44807,39399747357,1500000000,1500000000
48062940856,1650005848,67646,49562940856,62846,55278018345,1500000000,1500000000
127182064429,1641712582,60838,128682064429,60838,174381804823,1500000000,1500000000
39962693005,1645607874,67646,41462693005,62846,45244170002,1500000000,1500000000
27526240080,1650024432,60862,29026240080,56062,30117139273,1500000000,1500000000
34521713352,1650002667,55705,36021713352,50905,39873429312,1500000000,1500000000
60127996777,1650036821,49571,61627996777,49571,77197217464,1500000000,1500000000
43540314332,1650028313,60862,45540314332,56062,57130945475,2000000000,2000000000
32728403197,1647127543,67622,34228403197,62822,45441480555,1500000000,1500000000
42245378089,1645618613,55644,44745378089,55644,78618617332,2500000000,2500000000
24689395679,1650019082,55705,26689395679,50905,36423235597,2000000000,2000000000
25833607332,1650020726,336877,27333607332,336877,28436194113,1500000000,1500000000
64388564858,1641718399,320380,65888564858,320380,94922517425,1500000000,1500000000
68801027703,1650037407,60850,70801027703,56050,76149429426,2000000000,2000000000
146576183283,1641710580,340681,148293651334,340681,156285984169,1717468051,1717468051
89673603722,1643721688,326848,91173603722,326848,94701567364,1500000000,1500000000
63070986928,1645588445,320479,64570986928,320479,64794215498,1500000000,1500000000
24716579266,1649987050,67634,26216579266,67634,30635317620,1500000000,1500000000
48701534373,1650032298,67634,50201534373,67634,59191776444,1500000000,1500000000
103202492256,1643707246,54095,104258653482,54095,104258653482,1500000000,1056161226
54587833470,1645725653,55681,56087833470,50881,59114707845,1500000000,1500000000
21105121228,1649997651,67634,22605121228,62834,29202103792,1500000000,1500000000
52892228333,1645652015,316518,54892228333,316518,64297293331,2000000000,2000000000
56036153716,1650037428,48639,57536153716,43839,79388112788,1500000000,1500000000
91367685344,1641706725,56516,92867685344,51716,119566146183,1500000000,1500000000
62403195069,1645626313,329296,63903195069,329296,65327850797,1500000000,1500000000
54695556636,1645740300,48627,56195556636,43827,62100650789,1500000000,1500000000
53975704196,1650040469,54664,55475704196,54664,69966358104,1500000000,1500000000
122420485709,1641704958,54739,123920485709,49939,187256030438,1500000000,1500000000
34166051777,1645615182,55572,35666051777,50772,48228184863,1500000000,1500000000
95938928001,1641746180,332285,97438928001,332285,115494133570,1500000000,1500000000
95938928001,1641746180,312882,97438928001,312882,124939875165,1500000000,1500000000
95938928001,1641746180,54071,97438928001,54071,124939875165,1500000000,1500000000
51595371713,1645612922,352675,53115371713,352675,61358555420,1520000000,1520000000
32970300822,1650011836,49495,34470300822,49495,48866332105,1500000000,1500000000
32970300822,1650011836,67622,34470300822,67622,48866332105,1500000000,1500000000
19204560728,1647082729,67646,20704560728,62846,25695790118,1500000000,1500000000
60672550328,1641734412,67646,62172550328,62846,79209372030,1500000000,1500000000
108030893528,1641688717,55000,109746718768,55000,127155792964,1715825240,1715825240
43013385659,1645619777,55608,44543385659,50808,46256411973,1530000000,1530000000
81985835490,1645706719,318480,83485835490,318480,121204440978,1500000000,1500000000
19816145885,1650018504,67634,21316145885,67634,30590145823,1500000000,1500000000
25184822738,1650006027,67634,26684822738,67634,37742890364,1500000000,1500000000
44426645172,1645622596,346364,45926645172,346364,62848362850,1500000000,1500000000
64714670859,1645736747,329895,66214670859,329895,85486819954,1500000000,1500000000
94934744843,1645686462,55584,96434744843,50784,103302391423,1500000000,1500000000
112314555940,1641717222,316598,113814555940,316598,134276255964,1500000000,1500000000
119626784806,1641717201,67646,121126784806,62846,188657878437,1500000000,1500000000
72045494825,1645728839,59922,73575494825,55122,80934714953,1530000000,1530000000
33780861658,1650022238,60850,35280861658,56050,35704401813,1500000000,1500000000
116580963570,1641724521,334358,118080963570,334358,149446873359,1500000000,1500000000
13226471683,1647088566,67722,14726471683,62922,19971441037,1500000000,1500000000
155126931013,1643743806,60838,156626931013,60838,161719879125,1500000000,1500000000
39601626717,1650034801,66766,41251626717,66766,45321287645,1650000000,1650000000
29002397560,1645621594,302743,30512397560,302743,38492672140,1510000000,1510000000
61585687112,1650036751,60874,62442489270,56074,62442489270,1500000000,856802158
37953609798,1649988528,319777,39453609798,319777,47849064143,1500000000,1500000000
27744964241,1649989195,331167,29244964241,331167,34856986380,1500000000,1500000000
36689899399,1649998815,327369,38189899399,327369,41054426439,1500000000,1500000000
72506665568,1645708461,333457,74056665568,333457,79958196004,1550000000,1550000000
35789811193,1650034685,60862,36934033948,56062,36934033948,1500000000,1144222755
71913359726,1643715000,52940,73413359726,48140,104000000000,1500000000,1500000000
45718406666,1645603395,343853,47218406666,343853,58598759022,1500000000,1500000000
77367123047,1645692249,330103,78877123047,323634,92701075322,1510000000,1510000000
68087926877,1650037417,67646,69587926877,62846,79388112788,1500000000,1500000000
131272838036,1641699626,316602,132772838036,316602,153014884227,1500000000,1500000000
146313455418,1641742827,67634,147813455418,62834,159016290245,1500000000,1500000000
22645303681,1647095971,60850,24145303681,60850,28959390253,1500000000,1500000000
66224540255,1645645451,320350,67754540255,320350,75691817238,1530000000,1530000000
51806363945,1645692282,306540,53306363945,306540,81930548028,1500000000,1500000000
16710394087,1647073743,67646,18210394087,62846,22003782044,1500000000,1500000000
42703339991,1650005659,60850,44203339991,56050,48955277078,1500000000,1500000000
35657347747,1650007782,67634,37157347747,62834,47551454987,1500000000,1500000000
113076077517,1641726328,331181,114581987967,331181,129281830519,1505910450,1505910450
12633931907,1647087097,67646,14133931907,62846,15102144302,1500000000,1500000000
21236065912,1647094417,55580,24265019917,50780,24265019917,24265019917,3028954005
51601821180,1650035055,60862,53101821180,56062,68870447875,1500000000,1500000000
51601821180,1650035055,60850,53601821180,56050,71722929114,2000000000,2000000000
27565212660,1650062451,60838,29065212660,60838,33041079169,1500000000,1500000000
37310176310,1650034767,54813,38810176310,50013,49118763175,1500000000,1500000000
46969249850,1650033937,67634,48469249850,67634,56921725667,1500000000,1500000000
59327316196,1650037631,60850,60327316206,56050,88412367433,1000000010,1000000010
345688212242,1641753085,67634,347188212242,62834,418763859502,1500000000,1500000000
61223081023,1645629461,67634,62723081023,62834,87848344237,1500000000,1500000000
39066647847,1650000301,60850,40566647847,56050,48356834210,1500000000,1500000000
158750350742,1641716792,55717,160250350742,50917,179845841919,1500000000,1500000000
129498641122,1643681599,67646,130998641122,67646,155489583498,1500000000,1500000000
46937183704,1645599523,55584,48437183704,50784,56285597133,1500000000,1500000000
82571557216,1641700227,323106,84071557216,323106,128511361270,1500000000,1500000000
35364849679,1649998541,60850,36864849679,56050,42167189538,1500000000,1500000000
112469531420,1641722913,333710,113969531420,333710,187224053653,1500000000,1500000000
121840828093,1641729862,59982,123340828093,59982,174139324733,1500000000,1500000000
16693229568,1647102572,336893,18193229568,336893,27153646259,1500000000,1500000000
118357498687,1641724505,333752,119857498687,333752,138182176739,1500000000,1500000000
24422285814,1647052991,67634,25922285814,62834,29964365205,1500000000,1500000000
78246121155,1643720002,60838,78786566945,60838,78786566945,1500000000,540445790
37469312713,1650034181,67634,39469312713,62834,50791830866,2000000000,2000000000
20786926948,1650026988,67622,22286926948,67622,29708005199,1500000000,1500000000
220714776764,1641765923,67634,222214776764,62834,322063387350,1500000000,1500000000
113084534769,1641746970,67646,150000000000,62846,,,
42842285097,1650033570,67658,44342285097,62858,48000000000,1500000000,1500000000
42842285097,1650033570,67646,44342285097,62846,52331629670,1500000000,1500000000
48611706611,1650037123,60850,50111706611,56050,73371185765,1500000000,1500000000
40693558661,1650046558,66718,42193558661,66718,48338061905,1500000000,1500000000
26414271278,1650062702,67722,27914271278,67722,30553251770,1500000000,1500000000
29813013434,1650047010,66742,31313013434,61942,43038640627,1500000000,1500000000
53062182911,1650035196,60926,54562182911,60926,70892303170,1500000000,1500000000
53062182911,1650035196,67622,55002182911,62822,60281298439,1940000000,1940000000
102517093187,1641714851,340039,104517093187,340039,137408441932,2000000000,2000000000
153706258170,1641764033,331149,155206258170,331149,184844146389,1500000000,1500000000
25533228178,1649997506,60862,27033228178,56062,32766362472,1500000000,1500000000
25533228178,1649997506,67646,27033228178,62846,32016806137,1500000000,1500000000
19790461677,1650010373,60850,21290461677,56050,37271394125,1500000000,1500000000
42051893753,1650033590,67646,43551893753,62846,57970476825,1500000000,1500000000
28019131148,1650023514,67646,29519131148,62846,36057699242,1500000000,1500000000
24766641365,1649991598,60850,25121817744,56050,25121817744,1500000000,355176379
39411677642,1645613710,60938,40911677642,56138,54002491934,1500000000,1500000000
71287633144,1645744014,340619,72797633144,340619,85025001975,1510000000,1510000000
35068623713,1650031011,60850,36568623713,56050,46251068459,1500000000,1500000000
20238038897,1650029999,60862,21738038897,56062,30117012979,1500000000,1500000000
90240291281,1641694860,317328,92240291281,317328,134313842279,2000000000,2000000000
13926654751,1647093457,67634,15426654751,62834,16975108465,1500000000,1500000000
55241960763,1645605980,55612,56771960763,55612,63914394417,1530000000,1530000000
42933794868,1645612522,60850,44453794868,56050,45000000000,1520000000,1520000000
55108993340,1650035240,67634,56518993340,67634,62490291779,1410000000,1410000000
48285685111,1650027802,60850,49785685111,56050,50771351803,1500000000,1500000000
20980118982,1650021184,48615,22480118982,43815,32048647230,1500000000,1500000000
9943700572,1647070734,55705,11443700572,50905,16283371109,1500000000,1500000000
42191399823,1650031482,49483,43691399823,44683,54193259542,1500000000,1500000000
92237976134,1641725242,331151,93737976134,331151,99690766200,1500000000,1500000000
31611511017,1647051351,54795,33611511017,49995,45431579093,2000000000,2000000000
26490323877,1650001685,67634,27990323877,67634,30809481415,1500000000,1500000000
24193397527,1647053668,325637,25693397527,325637,31808761250,1500000000,1500000000
122264357969,1645715080,335138,125264357969,335138,128333249543,3000000000,3000000000
32564258796,1650015104,304488,34064258796,304488,43302792629,1500000000,1500000000
65692752421,1641694096,302880,67212752421,302880,71200000000,1520000000,1520000000
65692752421,1641694096,302902,67202752421,302902,71100000000,1510000000,1510000000
123466335153,1641691313,331995,124966335153,331995,132410573927,1500000000,1500000000
49428412769,1650028080,60862,51428412769,56062,78000926967,2000000000,2000000000
110487413966,1645642409,329328,111987413966,329328,126923662385,1500000000,1500000000
47634390660,1645606108,55668,49134390660,50868,74123565570,1500000000,1500000000
24748135756,1650004385,67634,26248135756,62834,26604211535,1500000000,1500000000
11737979243,1647087268,67634,13093956210,67634,13093956210,1500000000,1355976967
77138719714,1645686035,340585,78648719714,340585,108684907638,1510000000,1510000000
54885257135,1650034951,60850,56385257135,60850,77416756879,1500000000,1500000000
25412343151,1650016199,49583,26912343151,44783,31196970493,1500000000,1500000000
152315447775,1641758323,327996,153815447775,327996,189304452904,1500000000,1500000000
13610790533,1647077931,332490,38000000000,332490,38000000000,38000000000,24389209467
31874814966,1650019256,54921,33374814966,50121,299000000000,1500000000,1500000000
43510658731,1650036448,67634,45010658731,67634,57775317599,1500000000,1500000000
45327257339,1650034093,49507,46827257339,49507,60248785788,1500000000,1500000000
45327257339,1650034093,67622,46827257339,67622,60248785788,1500000000,1500000000
25026999306,1650062531,67646,26526999306,62846,34123828600,1500000000,1500000000
28857650771,1650009547,67646,30357650771,62846,42034362010,1500000000,1500000000
73609136768,1641736751,67646,75109136768,62846,91050076262,1500000000,1500000000
34221966737,1645626620,55644,35721966737,55644,59528115969,1500000000,1500000000
59017690632,1645694519,67634,60517690632,67634,78940276507,1500000000,1500000000
29580178018,1650017304,67734,31080178018,62934,31497360448,1500000000,1500000000
50025249347,1650036894,60838,51525249347,60838,73853722109,1500000000,1500000000
50025249347,1650036894,60862,52025249347,56062,76379624145,2000000000,2000000000
33764675491,1650010706,54908,35264675491,50108,44378767527,1500000000,1500000000
360628309371,1641751520,337510,362128309371,337510,386105588360,1500000000,1500000000
22262507993,1650010390,67646,23762507993,67646,31246343410,1500000000,1500000000
106117386245,1645679034,338296,134750630689,338296,,,
34857566695,1650029089,67646,36357566695,62846,41745833248,1500000000,1500000000
62961033559,1650053004,60950,64461033559,56150,80146159210,1500000000,1500000000
86678448530,1641699984,333670,88178448530,333670,90000000000,1500000000,1500000000
28118131483,1647049099,55705,29618131483,50905,35879634754,1500000000,1500000000
148707127551,1645679705,55680,150207127551,50880,167877753262,1500000000,1500000000
41080045992,1647118159,55580,42580045992,50780,55995937573,1500000000,1500000000
99430214733,1643700258,71420,100930214733,66620,130000000000,1500000000,1500000000
39066778362,1645611665,55681,40566778362,50881,45169604863,1500000000,1500000000
39066778362,1645611665,55608,40576778362,50808,51408119843,1510000000,1510000000
202660317887,1645672731,55644,205160317887,55644,362810482194,2500000000,2500000000
51096164948,1645697751,329150,52596164948,329150,57743236763,1500000000,1500000000
51620767238,1650037873,67646,53120767238,67646,76790995378,1500000000,1500000000
26067144252,1650017398,67634,27000000000,67634,,,
45020254079,1650036423,55592,46520254079,50792,58293720485,1500000000,1500000000
13548025066,1647079254,60850,15048025066,60850,16293090393,1500000000,1500000000
43091785266,1645613109,343747,44591785266,343747,48552966954,1500000000,1500000000
29663772974,1650034470,67634,31163772974,58034,41504032682,1500000000,1500000000
41911121234,1645701912,67634,43741121234,62834,54551393164,1830000000,1830000000
95463355928,1641695591,307720,96963355928,307720,130329427499,1500000000,1500000000
89803677338,1641705667,67646,90000000000,62846,90000000000,2000000000,196322662
99717134177,1645661348,339979,101217134177,339979,101559662015,1500000000,1500000000
129978660174,1641716478,336839,131978660174,336839,150544127069,2000000000,2000000000
41390323264,1650030908,66730,42890323264,66730,56643466795,1500000000,1500000000
28247002780,1647109785,67634,29747002780,67634,34419046913,1500000000,1500000000
39004700995,1650031162,60862,40504700995,56062,65637866457,1500000000,1500000000
12609139897,1647082418,67634,14109139897,62834,17280736550,1500000000,1500000000
22688445385,1650021438,67722,24188445385,67722,30347925979,1500000000,1500000000
41295465340,1650035733,60862,42795465340,56062,60688350273,1500000000,1500000000
41295465340,1650035733,336881,43295465340,336881,47000000000,2000000000,2000000000
49567731770,1650037262,67646,51567731770,67646,63500517562,2000000000,2000000000
54684755370,1650037159,67646,56684755370,62846,63000000000,2000000000,2000000000
27578073470,1650048522,54700,29078073470,49900,31287028505,1500000000,1500000000
28840660289,1646945271,60850,30340660289,60850,32259933242,1500000000,1500000000
97973860982,1649353362,49571,99473860982,49571,118312041959,1500000000,1500000000
46799667731,1649375566,54715,48299667731,54715,59797347903,1500000000,1500000000
21592203893,1646893626,321652,23092203893,321652,24952625869,1500000000,1500000000
49376225808,1649368228,54921,50876225808,50121,200000000000,1500000000,1500000000
91512125272,1641559466,67634,93012125272,67634,114964344679,1500000000,1500000000
30050400879,1648312078,67646,31550400879,62846,41209815323,1500000000,1500000000
25217802531,1648308051,317312,26717802531,317312,32704021004,1500000000,1500000000
33769336951,1650411390,55720,35269336951,50920,200000000000,1500000000,1500000000
31657057369,1650357054,67634,33157057369,67634,35562365943,1500000000,1500000000
62838091145,1650403409,60850,64338091145,60850,67957877050,1500000000,1500000000
23767551567,1646871490,338902,25267551567,338902,32190503064,1500000000,1500000000
31888331406,1646879266,55717,33888331406,50917,46179091463,2000000000,2000000000
33977129191,1649294922,308974,35477129191,308974,43764293023,1500000000,1500000000
187159105598,1641571002,67634,188659105598,67634,216639168313,1500000000,1500000000
127400515622,1641592544,324824,128900515622,324824,134876090859,1500000000,1500000000
118046298316,1641592174,88447,119546298316,88447,162057422365,1500000000,1500000000
79888340464,1641548919,67646,81388340464,62846,111117933162,1500000000,1500000000
51828828316,1641104482,314079,53777119764,314079,,,
51828828316,1641104482,313425,53000000000,313425,,,
39781636661,1649322359,54320,41281636661,49520,47697577235,1500000000,1500000000
36382111435,1649360679,55693,37882111435,50893,58569786197,1500000000,1500000000
53344965525,1641103727,67622,54844965525,67622,74574537101,1500000000,1500000000
49029688323,1650384979,309728,50529688323,309728,52341654905,1500000000,1500000000
60298869202,1649368687,67622,61798869202,67622,83158360222,1500000000,1500000000
32916947399,1648306979,67634,34416947399,62834,42489215039,1500000000,1500000000
168098928542,1641149158,313538,169598928542,313538,181126902825,1500000000,1500000000
50339405234,1641124970,309696,51749405234,309696,68206032896,1410000000,1410000000
81913940150,1641552192,60850,83413940150,60850,93847897022,1500000000,1500000000
68471773672,1641104661,323618,69971773672,323618,85105268874,1500000000,1500000000
96511993657,1641160922,326824,98011993657,326824,119295168287,1500000000,1500000000
18472045054,1646895053,67634,19972045054,62834,22027535774,1500000000,1500000000
43859300646,1649290259,300262,45359300646,300262,57567190003,1500000000,1500000000
51736594007,1649375989,52640,53236594007,47840,200000000000,1500000000,1500000000
36092018926,1650380414,67634,37592018926,62834,52205610250,1500000000,1500000000
59703573529,1641116582,330531,61203573529,330531,78189076956,1500000000,1500000000
31455744416,1646919035,60938,32955744416,56138,41581976347,1500000000,1500000000
124978984270,1641532814,67634,126478984270,62834,165952282808,1500000000,1500000000
49160693625,1650327540,66802,50660693625,66802,75230248930,1500000000,1500000000
75756588790,1641134768,319739,77256588790,319739,84125979048,1500000000,1500000000
31029721695,1646876822,63200,33529721695,63200,57671834086,2500000000,2500000000
20587926579,1646902867,60850,22087926579,60850,31105239182,1500000000,1500000000
116014622796,1641558793,67634,117514622796,67634,128683725713,1500000000,1500000000
141060293438,1641597639,340713,144060293438,340713,183106786915,3000000000,3000000000
24652518245,1646904712,67634,26152518245,67634,42718976249,1500000000,1500000000
30793404704,1648310633,316163,32293404704,316163,33103460180,1500000000,1500000000
74043898877,1641108925,330543,76043898877,330543,90514861517,2000000000,2000000000
18192552171,1648268671,333601,20000000000,333404,20000000000,2000000000,1807447829
20191392670,1650329920,323642,21691392670,323642,26487214895,1500000000,1500000000
53331511203,1649353709,67646,54831511203,62846,68988732883,1500000000,1500000000
25435771509,1650355475,63200,26935771509,63200,55903887210,1500000000,1500000000
80150279364,1641143145,336873,82150279364,336873,85000000000,2000000000,2000000000
24753920912,1646937830,60838,26253920912,60838,30503733348,1500000000,1500000000
92982678572,1641520306,67646,94482678572,62846,95000000000,1500000000,1500000000
20310406586,1648285414,307712,21810406586,307712,28239298214,1500000000,1500000000
69461986730,1641108111,321062,70961986730,321062,80872663737,1500000000,1500000000
17335037852,1646899205,52940,19335037852,48140,23104077894,2000000000,2000000000
55478529097,1649372815,63200,56978529097,63200,119925341672,1500000000,1500000000
55478529097,1649372815,319797,56978529097,319797,75492915262,1500000000,1500000000
53701656568,1649342753,64705,54938696568,59905,57378575256,1237040000,1237040000
163601513561,1641529847,60838,165101513561,60838,183053518234,1500000000,1500000000
20636589780,1650335580,340087,22136589780,340087,25776026143,1500000000,1500000000
75816245454,1641108105,318508,77316245454,318508,80872663737,1500000000,1500000000
16739845771,1646909081,304524,22000000000,304524,22000000000,22000000000,5260154229
125393680365,1641597537,334308,128393680365,334308,183106786915,3000000000,3000000000
103769528960,1641154702,66862,105269528960,62062,136269736756,1500000000,1500000000
40247240511,1646918125,314158,41747240511,314158,50640878710,1500000000,1500000000
80111925446,1649355493,67634,82111925446,62834,104763618453,2000000000,2000000000
117010382550,1641569173,333728,118510382550,316628,153193568055,1500000000,1500000000
53166301640,1650403394,319801,54666301640,319801,72175386410,1500000000,1500000000
20956412442,1650352507,67634,22456412442,62834,32285812514,1500000000,1500000000
27572327762,1646878039,55720,29072327762,50920,35654582649,1500000000,1500000000
70336987887,1649340321,334789,71836987887,334789,123923537342,1500000000,1500000000
90129532473,1641554151,53799,91629532473,53799,112867432270,1500000000,1500000000
37435654724,1650403754,67634,38935654724,62834,40000000000,1500000000,1500000000
37985000470,1650385593,66766,39985000470,66766,48137690629,2000000000,2000000000
54183693853,1650363165,66730,55683693853,66730,69889854108,1500000000,1500000000
54183693853,1650363165,64741,66183693853,59941,350000000000,12000000000,12000000000
20423988374,1646952923,333704,22423988374,333704,24021258015,2000000000,2000000000
66688334945,1649375166,55717,68688334945,50917,78022074273,2000000000,2000000000
79364640896,1641549357,55705,80864640896,50905,106665981639,1500000000,1500000000
45662290010,1650409472,64717,47162290010,59917,52247036479,1500000000,1500000000
37438250912,1646935876,60850,38938250912,60850,52788636804,1500000000,1500000000
97513560784,1649352694,67634,99013560784,67634,115948978860,1500000000,1500000000
97513560784,1649352694,314084,99013560784,314084,103252332179,1500000000,1500000000
48067785941,1649357963,67634,50067785941,62834,57550818659,2000000000,2000000000
95021959743,1641550063,54836,96521959743,50036,118617773034,1500000000,1500000000
25477217272,1648270914,63200,26977217272,63200,54468959062,1500000000,1500000000
37512936265,1650371185,67646,39012936265,62846,39864239994,1500000000,1500000000
94022936663,1641561801,334332,95522936663,334332,117224351669,1500000000,1500000000
29212669468,1648325452,67622,30712669468,67622,40663779368,1500000000,1500000000
32230669798,1650332493,327974,33730669798,327974,41179273625,1500000000,1500000000
92212104021,1641167088,60862,93712104021,56062,95340929854,1500000000,1500000000
19296320066,1646905849,60926,20000000000,56126,20000000000,1000000000,703679934
94982559879,1641541147,60850,96482559879,56050,144501864380,1500000000,1500000000
118296063774,1641534419,64705,119796063774,59905,124901969678,1500000000,1500000000
32412322290,1648274025,54332,33912322290,49532,36945893534,1500000000,1500000000
45262015511,1650405088,67634,46762015511,67634,58893543419,1500000000,1500000000
30105411831,1646937018,60006,31605411831,55206,42952825877,1500000000,1500000000
38214222088,1649360602,319771,39714222088,319771,50044756514,1500000000,1500000000
51974716736,1649375974,49445,53474716736,44645,69818025277,1500000000,1500000000
50930534622,1650385782,55680,52430534622,50880,66813206902,1500000000,1500000000
103414633141,1641083901,336915,104914633141,336915,129635259501,1500000000,1500000000
16157063467,1646895146,67634,17657063467,58034,20000000000,1500000000,1500000000
59640744367,1650404031,55740,61140744367,50940,87696074492,1500000000,1500000000
37830806472,1649328879,60850,39330806472,60850,41531748068,1500000000,1500000000
39286420397,1649329659,60862,40786420397,56062,60225970369,1500000000,1500000000
88327397838,1641595009,60850,89827397838,56050,131450418002,1500000000,1500000000
18613246841,1650354823,63200,20113246841,63200,37008550714,1500000000,1500000000
54814131845,1650404145,321626,56314131845,321626,68327797734,1500000000,1500000000
65518299330,1650403053,67634,67018299330,67634,76437243799,1500000000,1500000000
23438373127,1646931473,316660,25438373127,316660,39279547048,2000000000,2000000000
52850356321,1646917855,324254,53646801294,324254,,,
58845532173,1649368361,67646,60345532173,62846,78885073550,1500000000,1500000000
157750413052,1641522132,60838,159250413052,60838,190592047010,1500000000,1500000000
58392899085,1650405873,60850,59892899085,56050,63301298783,1500000000,1500000000
31795149936,1646941734,67646,44821143981,62846,,,
63707336051,1649308674,64741,68707336051,59941,100000000000,5000000000,5000000000
78863279522,1641545608,54824,80363279522,54824,100549163848,1500000000,1500000000
23150808135,1648283401,331089,24650808135,331089,35020322299,1500000000,1500000000
50716170796,1650376957,63200,52216170796,63200,81662359456,1500000000,1500000000
49521839320,1650377769,64741,51171839320,59941,66444445513,1650000000,1650000000
45859283171,1650389259,67634,47359283171,62834,49350649219,1500000000,1500000000
29803136088,1650340338,67746,31303136088,62946,33814694198,1500000000,1500000000
18591699108,1650329314,66778,20091699108,66778,22800734649,1500000000,1500000000
16455177519,1646908370,55608,17955177519,50808,22710985728,1500000000,1500000000
16455177519,1646908370,60926,17955177519,56126,20000000000,1500000000,1500000000
53407976069,1646877465,60838,54907976069,60838,67721464023,1500000000,1500000000
36321211657,1649315506,315574,37821211657,315574,46502387132,1500000000,1500000000
76062995679,1650359634,60862,78062995679,56062,94216833678,2000000000,2000000000
24247765489,1646883571,60938,24747765489,56138,25000000000,500000000,500000000
30734207494,1648282371,310159,32234207494,310159,33806046692,1500000000,1500000000
64281733686,1641098288,309836,66281733686,309836,84104916560,2000000000,2000000000
201746712497,1641571993,67646,203746712497,62846,280328940757,2000000000,2000000000
101349750127,1641085337,327950,102849750127,327950,122872275730,1500000000,1500000000
79996767726,1641098555,60838,81496767726,60838,84183283716,1500000000,1500000000
115361898037,1641537653,60850,116861898037,56050,144123997310,1500000000,1500000000
26366834970,1646927608,55580,28366834970,50780,38040794077,2000000000,2000000000
117556884677,1641533721,67622,119056884677,67622,164901529894,1500000000,1500000000
29349030565,1650374520,55693,30849030565,50893,39977464984,1500000000,1500000000
72752967374,1641097198,67646,74752967374,62846,84832894713,2000000000,2000000000
49374700847,1646882223,60862,50874700847,56062,80584354460,1500000000,1500000000
52575004140,1649340513,314152,54075004140,314152,68301753955,1500000000,1500000000
40411062710,1650389585,60938,42411062710,56138,43514273047,2000000000,2000000000
39851886159,1650410046,63200,41351886159,63200,72356826246,1500000000,1500000000
82824383290,1641547228,54824,84324383290,50024,99230878314,1500000000,1500000000
26747141373,1648321908,60850,28247141373,56050,30097225412,1500000000,1500000000
21491372013,1648303431,331141,23491372013,331141,33002289571,2000000000,2000000000
106307952543,1641087907,67634,107807952543,62834,129457601146,1500000000,1500000000
41134547610,1646879818,52592,42634547610,47792,52075311055,1500000000,1500000000
48385710416,1649375459,55717,53385710416,50917,200000000000,5000000000,5000000000
82632983735,1641550403,54884,83000000000,50084,83000000000,1000000000,367016265
27804282372,1650364056,322913,29304282372,322913,45135846005,1500000000,1500000000
53189601813,1650403514,67634,54689601813,67634,62173287548,1500000000,1500000000
27774448838,1646946660,310247,29274448838,310247,38154608329,1500000000,1500000000
43239854741,1650381219,340637,44739854741,340637,47971089848,1500000000,1500000000
65058528810,1641107557,25005,68000000000,22738,,,
65058528810,1641107557,25005,68000000000,22738,,,
65058528810,1641107557,25005,68000000000,22738,,,
65058528810,1641107557,25005,68000000000,22738,,,
65058528810,1641107557,25005,68000000000,22738,,,
65058528810,1641107557,25005,68000000000,22738,,,
65058528810,1641107557,25005,68000000000,22738,,,
65058528810,1641107557,25005,68000000000,22738,,,
65058528810,1641107557,25005,68000000000,22738,,,
65058528810,1641107557,25005,68000000000,22738,,,
46289321703,1649357340,67634,47789321703,62834,80000000000,1500000000,1500000000
84710751162,1641555976,337482,86210751162,337482,86718994048,1500000000,1500000000
114080635843,1649335676,333718,125438102125,333718,,,
48642713780,1649316869,66814,50073887628,62014,50073887628,1500000000,1431173848
28741359426,1650379739,55580,30241359426,55580,41060668515,1500000000,1500000000
53566947426,1650386276,66766,55566947426,61966,95000000000,2000000000,2000000000
65501550541,1641086018,67646,67001550541,62846,80612016460,1500000000,1500000000
65000901888,1641107153,330501,66000000000,330501,,,
69614928016,1641131872,60862,71114928016,56062,85974504741,1500000000,1500000000
27551100791,1646905108,55592,29551100791,50792,36188726695,2000000000,2000000000
105700682831,1641152314,67622,107200682831,67622,126116289213,1500000000,1500000000
141417001496,1641587556,336891,142917001496,336891,184637695033,1500000000,1500000000
55718370639,1650403428,60850,57218370639,60850,80047613932,1500000000,1500000000
51280914443,1641118916,334372,53780914443,334372,55359505520,2500000000,2500000000
43741171924,1649322141,324842,45241171924,324842,52966296759,1500000000,1500000000
52498747483,1650386506,67710,53998747483,67710,65866050942,1500000000,1500000000
81196738639,1641145928,324224,82696738639,324224,111358825406,1500000000,1500000000
81196738639,1641145928,327982,82696738639,327982,111358825406,1500000000,1500000000
14976208538,1648290908,55705,16476208538,50905,23159774455,1500000000,1500000000
43997516567,1650363062,66730,45497516567,66730,60613328337,1500000000,1500000000
17591717905,1650353867,55693,19091717905,50893,23872988072,1500000000,1500000000
24336098195,1646929670,67634,25836098195,67634,28062877175,1500000000,1500000000
70228730572,1649340991,60850,71728730572,56050,84271630182,1500000000,1500000000
98961246899,1641093809,60862,100461246899,56062,113334529821,1500000000,1500000000
26117704109,1646937727,60838,27617704109,60838,34763819613,1500000000,1500000000
37639605801,1649316570,319697,39139605801,319697,55288720100,1500000000,1500000000
35408673286,1650379533,55668,36908673286,55668,46860621980,1500000000,1500000000
32329597374,1650376440,60862,33829597374,56062,41702337278,1500000000,1500000000
62028556850,1649338116,49519,64028556850,44719,89597683705,2000000000,2000000000
64759760175,1649307425,336811,66259760175,336811,86030502449,1500000000,1500000000
37733091004,1650409640,60850,39233091004,60850,51660731508,1500000000,1500000000
49639843590,1650402650,350181,51139843590,350181,62547450125,1500000000,1500000000
49639843590,1650402650,67622,51139843590,67622,67800459333,1500000000,1500000000
59137194697,1641124424,327359,60637194697,327359,69342040894,1500000000,1500000000
21467090587,1648292189,324170,22967090587,324170,30555478485,1500000000,1500000000
42390724384,1650375893,56516,43890724384,51716,200000000000,1500000000,1500000000
53296261415,1641133607,67646,54796261415,62846,78918779195,1500000000,1500000000
146579292563,1641146663,67634,148079292563,67634,194133812312,1500000000,1500000000
38606865253,1649327207,60838,40106865253,60838,47747060227,1500000000,1500000000
27365771733,1650344503,66730,28865771733,61930,40149914000,1500000000,1500000000
43634181397,1650341761,322896,45134181397,322896,52785448287,1500000000,1500000000
66498170086,1641140189,310421,67050103752,310421,67050103752,1500000000,551933666
64238923807,1641117859,331209,65238923807,331209,70068010752,1000000000,1000000000
78115484016,1641100401,67634,79615484016,67634,95206175645,1500000000,1500000000
62240743928,1641119583,54759,63740743928,49959,83615787428,1500000000,1500000000
78574365671,1649307747,60850,80074365671,56050,91967503233,1500000000,1500000000
113529346563,1641591949,60006,115029346563,55206,146993500137,1500000000,1500000000
28165469382,1650345452,319295,29665469382,319295,30000000000,1500000000,1500000000
46539680386,1646878777,55592,48039680386,50792,66066224072,1500000000,1500000000
49641596531,1649363501,307744,51141596531,307744,65736832592,1500000000,1500000000
94282549971,1641581263,67634,95782549971,67634,127487359824,1500000000,1500000000
28783241521,1648282575,67634,30283241521,62834,33733668059,1500000000,1500000000
37411788048,1650384898,60938,38911788048,56138,55977330607,1500000000,1500000000
43867873356,1650396861,60950,45367873356,56150,55535051704,1500000000,1500000000
59995418977,1641127671,67634,61495418977,62834,77034247246,1500000000,1500000000
64331075732,1649371122,60850,65831075732,56050,90173498373,1500000000,1500000000
23178320955,1648269603,325992,24678320955,325992,29299699149,1500000000,1500000000
40352791638,1650399017,59958,41852791638,55158,50806261430,1500000000,1500000000
22805592397,1650356607,333714,24305592397,333714,38701924268,1500000000,1500000000
32466010664,1650370256,55693,33966010664,50893,41695046713,1500000000,1500000000
44575629408,1650366109,340033,46075629408,340033,52119532912,1500000000,1500000000
68674444353,1641105845,299388,70174444353,299388,88365904738,1500000000,1500000000
53081659694,1649358365,67634,55081659694,62834,86985177435,2000000000,2000000000
81851362034,1641561574,60850,83351362034,56050,113649913279,1500000000,1500000000
97522159134,1641135004,60838,99022159134,56038,108012992903,1500000000,1500000000
79694397071,1641093123,319769,80000000000,319769,80000000000,1500000000,305602929
35487023273,1650409194,66730,36987023273,61930,45367852743,1500000000,1500000000
27914224209,1650355508,59970,29414224209,59970,35502429507,1500000000,1500000000
103084574335,1641167420,330499,104584574335,330499,112075912437,1500000000,1500000000
49994648957,1649316904,64741,51494648957,59941,2100000000000,1500000000,1500000000
135072994831,1641537085,320348,136572994831,320348,145059723395,1500000000,1500000000
17488572522,1648335279,304973,18988572522,304973,22911454128,1500000000,1500000000
67665591075,1650358076,60938,69165591075,60938,87018001598,1500000000,1500000000
22302221228,1646937787,60838,23802221228,60838,30360611982,1500000000,1500000000
23273747098,1646908766,67634,25273747098,67634,25761211530,2000000000,2000000000
54103908478,1649364892,63200,55603908478,63200,97686075864,1500000000,1500000000
120109082140,1641589763,67634,121609082140,67634,128951102305,1500000000,1500000000
33454050687,1646936915,60838,34954050687,60838,39811952764,1500000000,1500000000
143214892093,1641579657,67634,144714892093,67634,152131400663,1500000000,1500000000
28171682470,1650365603,64741,29671682470,59941,100000000000,1500000000,1500000000
25988987736,1650337718,66730,27488987736,61930,36400771162,1500000000,1500000000
21483844157,1650349661,67634,22725022190,67634,22725022190,1500000000,1241178033
29609359687,1650343893,67622,31109359687,67622,35985089208,1500000000,1500000000
61038413561,1641134359,67634,62538413561,62834,79542512264,1500000000,1500000000
86820830500,1641082563,67646,88320830500,62846,108246778916,1500000000,1500000000
241019861838,1641086749,319901,242519861838,319901,246544996772,1500000000,1500000000
37845875778,1650381507,67622,39345875778,62822,44956135417,1500000000,1500000000
42197436496,1649316961,305804,43697436496,305804,53800362650,1500000000,1500000000
99279309474,1641151836,319727,101279309474,319727,131453018054,2000000000,2000000000
58636814539,1649371885,60862,60136814539,56062,73723021539,1500000000,1500000000
111046405411,1641522741,316632,112546405411,316632,166745550997,1500000000,1500000000
27033970920,1650342190,59946,28201216967,55146,28201216967,1500000000,1167246047
85738918947,1641143627,54771,87238918947,49971,114519900999,1500000000,1500000000
36900192722,1649292262,59982,38400192722,55182,45622938072,1500000000,1500000000
94212528398,1641540365,320972,95712528398,320972,105965999302,1500000000,1500000000
28684145565,1648304112,54736,30184145565,49936,36305045574,1500000000,1500000000
56783694045,1649340833,48651,58783694045,43851,63858080697,2000000000,2000000000
20964063779,1648296172,63200,22464063779,63200,39945630014,1500000000,1500000000
31052797312,1650333368,63200,32552797312,63200,59250031206,1500000000,1500000000
23327863934,1648255993,320489,24327863934,320489,25000000000,1000000000,1000000000
27096425166,1650328622,56516,28596425166,51716,35467050828,1500000000,1500000000
27096425166,1650328622,314144,28596425166,314144,35467050828,1500000000,1500000000
78704406272,1641142035,60850,81704406272,60850,101000000000,3000000000,3000000000
146922724699,1641147309,299673,148422724699,299673,150379062654,1500000000,1500000000
151236845751,1641575641,340671,152736845751,340671,161050559550,1500000000,1500000000
64735029007,1641101768,60862,66735029007,56062,69999683563,2000000000,2000000000
43414562915,1646880395,330563,44914562915,330563,59314557638,1500000000,1500000000
56860865745,1646935209,60838,58360865745,60838,61387654680,1500000000,1500000000
43944498047,1650385052,53512,45273793494,53512,45273793494,1500000000,1329295447
37940154321,1650404610,60838,39440154321,60838,54122493463,1500000000,1500000000
33651290388,1650336884,312119,35151290388,312119,42817839074,1500000000,1500000000
66572369825,1649370770,67622,68072369825,67622,85103281182,1500000000,1500000000
88070050223,1649370182,60850,89570050223,60850,99500772324,1500000000,1500000000
30446788793,1646920129,60938,31946788793,56138,35033206973,1500000000,1500000000
175354951531,1641522581,60850,176854951531,60850,229940021609,1500000000,1500000000
113941970247,1641520152,337546,115441970247,337546,134179555864,1500000000,1500000000
28457228537,1648269689,331075,29957228537,331075,37174390819,1500000000,1500000000
20844323081,1650350367,511006,22000000000,340671,,,
64850195801,1641127352,64705,66350195801,59905,80122188468,1500000000,1500000000
155097959047,1641574175,67634,156597959047,62834,160063424177,1500000000,1500000000
40327186260,1648281868,60926,41827186260,60926,54263106192,1500000000,1500000000
60185431729,1641134690,67646,61685431729,62846,79569996387,1500000000,1500000000
25023648450,1646937767,60838,26523648450,60838,36696679398,1500000000,1500000000
18704709770,1648294994,67646,20204709770,62846,21802566165,1500000000,1500000000
32924666419,1650331989,63200,34424666419,63200,67457881942,1500000000,1500000000
26300125623,1646871417,343109,27800125623,343109,49025894300,1500000000,1500000000
48518236892,1649314283,331139,50018236892,331139,50322621129,1500000000,1500000000
24753933151,1648336441,323612,26253933151,323612,28836689163,1500000000,1500000000
27745548339,1648281470,322939,29084510698,322939,29084510698,1500000000,1338962359
28147631355,1650374347,323638,29647631355,323638,32000000000,1500000000,1500000000
26183144473,1650349307,55693,27683144473,50893,36675902059,1500000000,1500000000
43959763869,1650405290,64729,45459763869,59929,60000863715,1500000000,1500000000
25424847044,1650330101,65530,26924847044,60730,27236773515,1500000000,1500000000
45064500060,1650386908,66754,46564500060,61954,58285327582,1500000000,1500000000
42308960547,1650327343,339983,43347193119,339983,43347193119,1500000000,1038232572
67560140426,1641097276,60862,69060140426,56062,86164166459,1500000000,1500000000
20472522338,1646929630,318722,21972522338,318722,22000000000,1500000000,1500000000
50550508910,1649375910,55580,52050508910,50780,71648309430,1500000000,1500000000
87763848098,1641551140,312168,89263848098,312168,107660374597,1500000000,1500000000
81633870425,1641545472,67646,83133870425,62846,108463496424,1500000000,1500000000
44793391131,1648262676,320388,46293391131,320388,66005783620,1500000000,1500000000
136272594545,1641149559,60862,137772594545,56062,149065995994,1500000000,1500000000
69485042255,1641122877,331141,70985042255,331141,76041316745,1500000000,1500000000
24457471723,1648285680,67646,25957471723,62846,27374329338,1500000000,1500000000
24864156902,1646930568,56576,26063061333,51776,26063061333,1500000000,1198904431
58478518671,1649375129,60838,59978518671,60838,65900331043,1500000000,1500000000
141332696736,1649346444,67646,142832696736,62846,149037287138,1500000000,1500000000
29961622196,1648317650,55693,31461622196,50893,39157704185,1500000000,1500000000
52458089104,1650377129,331159,54216326777,331159,54216326777,1940000000,1758237673
38553147140,1649294289,303886,40053147140,303886,50716245493,1500000000,1500000000
95544578391,1649374594,67622,97305664974,62822,150850018278,1761086583,1761086583
35192353673,1650364224,66742,36692353673,66742,45421122065,1500000000,1500000000
56902401844,1641133353,319807,58902401844,319807,220000000000,2000000000,2000000000
69635537008,1641138289,333720,71135537008,333720,80695816864,1500000000,1500000000
33848909064,1646943899,60838,35348909064,60838,40202329308,1500000000,1500000000
42186991294,1646943984,60838,43686991294,60838,49790718040,1500000000,1500000000
41277550619,1649366736,67646,42777550619,62846,45000000000,1500000000,1500000000
40155918821,1649329401,67622,41655918821,67622,62559584515,1500000000,1500000000
29593417795,1649295067,55681,31093417795,55681,42077689537,1500000000,1500000000
173674872842,1641530101,67646,175174872842,62846,197785411108,1500000000,1500000000
172684045795,1641158995,60838,174184045795,56038,190674322156,1500000000,1500000000
60297530168,1649342815,336815,61797530168,336815,75000000000,1500000000,1500000000
48830902038,1649357663,54921,50330902038,50121,200000000000,1500000000,1500000000
33271120099,1648309580,54712,35096466099,49912,47350777564,1825346000,1825346000
37588537396,1650331326,64741,39092037396,59941,55478577577,1503500000,1503500000
55233614353,1646913662,60850,57515296853,56050,76735452264,2281682500,2281682500
88223520065,1641549046,327335,89723520065,327335,99073514190,1500000000,1500000000
56055860491,1650411975,67646,58055860491,62846,81831237804,2000000000,2000000000
44102456085,1650386830,60018,45602456085,60018,46772060233,1500000000,1500000000
52707014593,1641117005,67634,54207014593,62834,76595552834,1500000000,1500000000
69188171226,1641106287,67634,70688171226,62834,80623130610,1500000000,1500000000
61314798891,1649343029,64032,62814798891,59232,76360315742,1500000000,1500000000
56435197782,1649317281,67646,58435197782,67646,82760162230,2000000000,2000000000
101878945054,1641559479,313463,103878945054,313463,120002918466,2000000000,2000000000
28944426338,1646919740,55681,30444426338,50881,34971358688,1500000000,1500000000
35307213475,1646933417,55632,37807213475,55632,66399770868,2500000000,2500000000
123478391567,1641525289,67634,124978391567,67634,162314504992,1500000000,1500000000
164608604161,1641574212,60862,166108604161,56062,192331633757,1500000000,1500000000
194919225757,1641531815,314043,196419225757,314043,257901674295,1500000000,1500000000
20354357351,1648272695,55592,21854357351,50792,30397187467,1500000000,1500000000
34344674867,1650370322,331153,35844674867,331153,38158318850,1500000000,1500000000
62304311433,1650403458,67646,63804311433,62846,76014008715,1500000000,1500000000
79367664426,1641097644,314027,80867664426,314027,84338753483,1500000000,1500000000
23905121484,1646929621,60862,25405121484,56062,33991066307,1500000000,1500000000
40418337061,1650389150,316602,41918337061,316602,54329457040,1500000000,1500000000
41104361098,1646943774,60838,42604361098,60838,53740957614,1500000000,1500000000
65954408156,1649359790,335583,67454408156,335583,68663139894,1500000000,1500000000
49712509645,1649361558,60862,51212509645,56062,52180603199,1500000000,1500000000
45272479399,1646933934,67634,46772479399,62834,60733003070,1500000000,1500000000
92333263507,1649373606,60838,93833263507,60838,95000000000,1500000000,1500000000
44892785919,1649311336,320483,46392785919,320483,61965193685,1500000000,1500000000
30812739872,1649328962,49507,32312739872,44707,43042928517,1500000000,1500000000
50650372063,1649372617,67634,52150372063,62834,59633580934,1500000000,1500000000
45391105258,1650366136,340685,46891105258,340685,52119532912,1500000000,1500000000
19321449255,1650350690,67634,20821449255,62834,26613454640,1500000000,1500000000
14909029518,1646907704,60926,16000000000,56126,16000000000,1500000000,1090970482
23027653845,1646938897,67658,24527653845,62858,31991724477,1500000000,1500000000
29988908410,1648274927,60838,31488908410,60838,38129562812,1500000000,1500000000
53749985666,1641104433,306059,55249985666,306059,77786606890,1500000000,1500000000
89091070949,1641165597,60862,91091070949,56062,121914034933,2000000000,2000000000
21498773604,1646924934,336877,22998773604,336877,24458216669,1500000000,1500000000
22992977430,1646945111,60850,24492977430,60850,24560290303,1500000000,1500000000
144636406725,1641567607,67634,146136406725,67634,174699819770,1500000000,1500000000
33537248218,1648265883,337476,35037248218,337476,39097581244,1500000000,1500000000
77474060621,1641102722,60850,78974060621,56050,84144381401,1500000000,1500000000
30893409015,1648274541,55592,32393409015,50792,35831730862,1500000000,1500000000
37879631425,1646936712,60838,39379631425,60838,41023884765,1500000000,1500000000
64298508345,1649372853,67634,65798508345,62834,70848161372,1500000000,1500000000
99309559897,1641153985,60850,100809559897,56050,115396444613,1500000000,1500000000
117951653681,1641152613,66778,119451653681,66778,119558232802,1500000000,1500000000
22381255646,1646945988,301716,23881255646,301716,32606076669,1500000000,1500000000
36083455717,1649368045,67634,37583455717,67634,45211247774,1500000000,1500000000
70828849445,1649357521,60862,72328849445,56062,76015025420,1500000000,1500000000
36826964629,1650363793,60862,38326964629,56062,42499162002,1500000000,1500000000
132437968353,1641539611,52928,133937968353,48128,145252856123,1500000000,1500000000
47671321616,1650404799,49507,49171321616,44707,53074775425,1500000000,1500000000
47671321616,1650404799,55693,49171321616,50893,53074775425,1500000000,1500000000
18513721404,1648289088,334304,20013721404,334304,20219319644,1500000000,1500000000
37675604178,1650340843,326946,39175604178,326946,45227092123,1500000000,1500000000
67674783314,1649359571,67634,69174783314,67634,78015811824,1500000000,1500000000
67674783314,1649359571,60838,69174783314,60838,78015811824,1500000000,1500000000
182182112318,1641564015,332398,183682112318,332398,214012194852,1500000000,1500000000
148581954837,1641529724,54237,150081954837,54237,213271734623,1500000000,1500000000
57744897050,1650405953,60850,59244897050,60850,65656138803,1500000000,1500000000
62627754208,1641138982,67634,64127754208,67634,68962396625,1500000000,1500000000
130232287008,1641521387,54322,132432287008,54322,146207342527,2200000000,2200000000
170234152171,1641585275,55608,171734152171,50808,212099910945,1500000000,1500000000
132512096883,1641594335,67634,134012096883,67634,136110649999,1500000000,1500000000
95266224566,1649373435,67646,96766224566,62846,118621278055,1500000000,1500000000
45369378838,1649334132,60962,46869378838,56162,61869673517,1500000000,1500000000
95721417733,1649348751,67658,97221417733,62858,115404647779,1500000000,1500000000
22634594186,1646944763,60850,24134594186,60850,31703482923,1500000000,1500000000
35239691575,1646911937,55680,37179691575,50880,43642237410,1940000000,1940000000
86847132149,1641544455,314065,88847132149,314065,90000000000,2000000000,2000000000
61583314132,1641122757,67646,63083314132,62846,68203110365,1500000000,1500000000
126351972444,1641083645,333714,127851972444,333714,154597415694,1500000000,1500000000
30624078657,1646911720,60838,32124078657,56038,38518099192,1500000000,1500000000
31682073712,1646877699,55568,32775770692,55568,32775770692,1500000000,1093696980
70707438898,1641107048,317210,72207438898,317210,77475352877,1500000000,1500000000
45718033721,1649330612,327952,46966797479,327952,46966797479,1500000000,1248763758
97960104539,1641554957,54739,99460104539,49939,121645473667,1500000000,1500000000
115747117296,1641594532,67646,117247117296,62846,163731351913,1500000000,1500000000
74796065533,1650359660,67646,76796065533,62846,100881894383,2000000000,2000000000
28257743927,1650342194,67634,29757743927,62834,31538366260,1500000000,1500000000
51635184082,1650384361,66766,53135184082,61966,60762460704,1500000000,1500000000
47491984178,1650404385,67634,48991984178,67634,69010317574,1500000000,1500000000
47491984178,1650404385,60926,48991984178,60926,69010317574,1500000000,1500000000
90757629840,1649373449,55717,93757629840,50917,129914436922,3000000000,3000000000
167131184742,1641531901,55693,168631184742,55693,214998199773,1500000000,1500000000
21877993657,1648284822,53498,23377993657,48698,29003258412,1500000000,1500000000
26165522688,1650353368,67646,27665522688,62846,31074499469,1500000000,1500000000
62662130768,1641107647,25005,68000000000,22738,,,
62662130768,1641107647,25005,68000000000,22738,,,
62662130768,1641107647,25005,68000000000,22738,,,
62662130768,1641107647,25005,68000000000,22738,,,
62662130768,1641107647,25005,68000000000,22738,,,
62662130768,1641107647,25005,68000000000,22738,,,
62662130768,1641107647,25005,68000000000,22738,,,
62662130768,1641107647,25005,68000000000,22738,,,
62662130768,1641107647,25005,68000000000,22738,,,
62662130768,1641107647,25005,68000000000,22738,,,
62662130768,1641107647,25005,68000000000,22738,,,
19907390376,1646937931,60838,21407390376,60838,27316859487,1500000000,1500000000
24503778731,1646884226,67646,26003778731,62846,28750133049,1500000000,1500000000
30479606393,1650328649,55680,31979606393,55680,35467050828,1500000000,1500000000
81455948332,1641083299,330489,82955948332,330489,85423720001,1500000000,1500000000
23075625620,1646902084,55592,24575625620,50792,27942657193,1500000000,1500000000
78957420713,1649356196,64741,80457420713,59941,300000000000,1500000000,1500000000
69393687415,1649351124,67622,70893687415,67622,81609556925,1500000000,1500000000
86755390372,1641580921,60862,88255390372,56062,125627139360,1500000000,1500000000
100899748989,1641543788,54824,102399748989,54824,124764619660,1500000000,1500000000
100899748989,1641543788,54884,102399748989,50084,137615017574,1500000000,1500000000
41864086602,1650381853,55680,43364086602,50880,48732451139,1500000000,1500000000
39558668067,1646882323,324802,40000000000,324802,40000000000,1500000000,441331933
50779962727,1650404353,48675,52279962727,43875,79981052274,1500000000,1500000000
61244080779,1641108013,331155,64000000000,331155,,,
54362368876,1646942994,331249,55862368876,331249,83063760527,1500000000,1500000000
113098101987,1641567378,63200,115598101987,63200,203579302670,2500000000,2500000000
27701428830,1650343095,55592,29201428830,50792,39118092462,1500000000,1500000000
33981329560,1649360587,320445,35481329560,320445,44426658729,1500000000,1500000000
34180163005,1648275832,52568,35680163005,47768,43780482838,1500000000,1500000000
55411969803,1650404347,67634,56911969803,62834,69251897473,1500000000,1500000000
55254657118,1649320328,67622,56754657118,67622,63254946525,1500000000,1500000000
135001905351,1641522681,67646,136501905351,62846,216708390658,1500000000,1500000000
27702399874,1648302630,321680,29202399874,321680,30289486615,1500000000,1500000000
19277091933,1650354347,48603,20777091933,43803,24923557967,1500000000,1500000000
93966906044,1641543276,55705,94991505204,50905,94991505204,1500000000,1024599160
35235472133,1650378984,332642,36735472133,332642,43865652579,1500000000,1500000000
15308578992,1646898723,333708,16308578992,333708,20126493722,1000000000,1000000000
22544940210,1646920307,60938,24044940210,56138,27375118023,1500000000,1500000000
20393236323,1646908714,52940,22393236323,48140,23033550965,2000000000,2000000000
84358290710,1641541531,336903,85858290710,336903,108972309475,1500000000,1500000000
33828236006,1650382309,67734,35328236006,62934,52070592782,1500000000,1500000000
39601504178,1650403790,67622,41101504178,67622,54140528107,1500000000,1500000000
182541941902,1641149462,60850,184041941902,56050,192034662341,1500000000,1500000000
73060941229,1649343286,67722,74560941229,67722,94875203738,1500000000,1500000000
79907137676,1649341364,327980,81407137676,327980,93915200354,1500000000,1500000000
17192985596,1648284740,55656,18692985596,50856,26285336518,1500000000,1500000000
27386966660,1650344423,59946,28886966660,55146,36679949887,1500000000,1500000000
24695090083,1650354968,65586,26195090083,65586,35625135430,1500000000,1500000000
190818164084,1641148033,60838,192318164084,56038,195028007498,1500000000,1500000000
228356197153,1649374003,60838,230651269463,60838,231530964132,2295072310,2295072310
110454932635,1641520196,326806,111954932635,326806,128683746402,1500000000,1500000000
163041458088,1641572473,325683,164541458088,325683,179706494987,1500000000,1500000000
19467123826,1650353981,55705,20967123826,50905,27036799217,1500000000,1500000000
33492543936,1650362053,320416,34992543936,320416,40528813570,1500000000,1500000000
24436820383,1646944733,60850,25936820383,60850,33815127249,1500000000,1500000000
21329901484,1646937889,60838,22829901484,60838,29488397472,1500000000,1500000000
188912082212,1649373874,307690,191326422955,307690,213562144158,2414340743,2414340743
56760500271,1649367771,336889,58260500271,336889,71951904192,1500000000,1500000000
65494882677,1649343048,60862,66994882677,56062,69637640695,1500000000,1500000000
65494882677,1649343048,60850,67494882677,60850,81709238559,2000000000,2000000000
118270190594,1641577577,327383,120095536594,327383,165067307229,1825346000,1825346000
22342393477,1646885476,52916,23842393477,48116,31025341905,1500000000,1500000000
55348629298,1641140480,67634,56758629298,62834,63294324071,1410000000,1410000000
55348629298,1641140480,333696,57348629298,333696,60000000000,2000000000,2000000000
55348629298,1641140480,327982,57348629298,327982,60000000000,2000000000,2000000000
26496387872,1650355194,319757,27996387872,248182,35669975509,1500000000,1500000000
26496387872,1650355194,319757,27996387872,319757,38132437263,1500000000,1500000000
17579385796,1646892980,55592,19079385796,50792,23781640039,1500000000,1500000000
127033843009,1641531925,55572,128973843009,55572,132000000000,1940000000,1940000000
155606591543,1641575834,54872,158106591543,54872,299877327594,2500000000,2500000000
18730893442,1646923956,331165,20230893442,331165,26414633712,1500000000,1500000000
60687086251,1646943066,67646,62187086251,58046,75322343200,1500000000,1500000000
28776634782,1646939029,333706,30276634782,333706,36105873873,1500000000,1500000000
84995177297,1641161215,67634,86995177297,62834,130839727672,2000000000,2000000000
84995177297,1641161215,52928,86495177297,48128,147385843839,1500000000,1500000000
45900467546,1650384355,323602,47400467546,323602,60762460704,1500000000,1500000000
29287414134,1646885040,67646,30787414134,62846,45456788354,1500000000,1500000000
76061475616,1641547381,49495,77561475616,49495,122707406907,1500000000,1500000000
31340718587,1648299959,54296,32840718587,54296,36357469617,1500000000,1500000000
40549116584,1650327583,67634,42049116584,62834,54464929429,1500000000,1500000000
73243894061,1641088013,55592,75243894061,55592,80000000000,2000000000,2000000000
94433845443,1641151972,55580,95933845443,50780,100621680224,1500000000,1500000000
53372100694,1641117890,64729,54872100694,59929,55000000000,1500000000,1500000000
95050788683,1641144861,316790,96112663446,316790,96112663446,1500000000,1061874763
36417605001,1646874682,296474,38417605001,296474,49873642955,2000000000,2000000000
76518041844,1641552946,67634,78023952294,67634,107847264664,1505910450,1505910450
23130340058,1648272571,325637,24630340058,325637,28197877003,1500000000,1500000000
86954648030,1641151849,64729,88954648030,59929,131060448680,2000000000,2000000000
54842979464,1641124880,331159,56842979464,331159,69298018084,2000000000,2000000000
58385997918,1641107542,25005,68000000000,22738,,,
58385997918,1641107542,25005,68000000000,22738,,,
58385997918,1641107542,25005,68000000000,22738,,,
58385997918,1641107542,25005,68000000000,22738,,,
43518314047,1649305345,60862,45518314047,56062,48737301306,2000000000,2000000000
149330393812,1641584541,67622,150830393812,67622,197275840933,1500000000,1500000000
34065461423,1649302926,54908,35565461423,50108,53488018920,1500000000,1500000000
61480824828,1641120989,60850,62308176590,60850,62308176590,1500000000,827351762
86373705528,1641083175,60862,87873705528,56062,113496824470,1500000000,1500000000
41060419319,1649363226,56516,42560419319,51716,200000000000,1500000000,1500000000
49618973342,1649350323,313399,51118973342,313399,70579947232,1500000000,1500000000
36407916865,1649321601,67722,38407916865,67722,50865164183,2000000000,2000000000
210016179311,1641514888,67634,211516179311,67634,246272281710,1500000000,1500000000
15830616036,1650351780,49483,17330616036,44683,33300951523,1500000000,1500000000
17927747123,1650329014,66862,19927747123,66862,26685630785,2000000000,2000000000
39406024459,1650361149,67646,40906024459,67646,51254702145,1500000000,1500000000
59677381572,1646916113,67646,61177381572,62846,77000000000,1500000000,1500000000
37564656451,1646926242,67634,39064656451,62834,54659407629,1500000000,1500000000
32220963824,1649292197,66766,33720963824,61966,37371409909,1500000000,1500000000
70801626428,1649369462,67622,72301626428,67622,93420294910,1500000000,1500000000
37355366536,1649292239,48639,38855366536,43839,41142498018,1500000000,1500000000
55320748861,1649320385,55636,56820748861,50836,70568321398,1500000000,1500000000
28754411764,1650380565,65530,30254411764,60730,35393932943,1500000000,1500000000
31114699706,1650327789,336901,32114699706,336901,33369046317,1000000000,1000000000
31114699706,1650327789,55720,32614699706,50920,200000000000,1500000000,1500000000
60985363909,1650402772,60850,62985363909,60850,74251980909,2000000000,2000000000
43888387210,1646936856,60838,45388387210,60838,54404505197,1500000000,1500000000
21145062030,1646894161,67634,22645062030,62834,25426821947,1500000000,1500000000
40908976133,1649363833,67722,42408976133,67722,59197487002,1500000000,1500000000
40225974988,1650411503,49519,41725974988,44719,60325092115,1500000000,1500000000
90121665347,1641141283,60862,91621665347,56062,105506274272,1500000000,1500000000
59916775892,1649335860,331163,62576875952,331163,,,
48485078692,1650412239,64717,49985078692,59917,57900763418,1500000000,1500000000
20467549548,1646892696,67634,21967549548,67634,25413932408,1500000000,1500000000
91360249021,1649374698,67634,93017255387,62834,109706792862,1657006366,1657006366
107913064180,1641567264,67634,109413064180,62834,144829910218,1500000000,1500000000
56115638896,1650360247,333704,57615638896,333704,68448825812,1500000000,1500000000
81253153136,1641092273,54848,82753153136,50048,102285515529,1500000000,1500000000
34678845462,1646888333,67646,35754966175,67646,35754966175,1500000000,1076120713
43035227040,1649294009,67646,44535227040,62846,55000593334,1500000000,1500000000
17901043721,1648287292,55592,19401043721,50792,25802770343,1500000000,1500000000
31554850081,1648321368,21000,33054850081,21000,45680709227,1500000000,1500000000
41124887005,1649317622,66730,42624887005,61930,52015966105,1500000000,1500000000
152076586891,1641574578,292724,153576586891,292724,184980531293,1500000000,1500000000
91781488330,1641561954,327990,93281488330,327990,93607044889,1500000000,1500000000
91781488330,1641561954,316572,93281488330,316572,100761840424,1500000000,1500000000
94681887990,1641088769,67646,96181887990,62846,135585313203,1500000000,1500000000
35993896731,1650412399,60862,37493896731,56062,56114098498,1500000000,1500000000
76410832859,1649373332,55580,77910832859,50780,98535732939,1500000000,1500000000
45262888904,1649363816,60862,46762888904,56062,63699626589,1500000000,1500000000
49079464913,1649372918,320473,50144583747,320473,50144583747,1500000000,1065118834
105873828895,1641088267,60862,107373828895,56062,111647228940,1500000000,1500000000
39235164638,1649312899,67646,40735164638,62846,48058932894,1500000000,1500000000
216564714345,1641528965,329179,218214714345,329179,234290204357,1650000000,1650000000
145641703183,1641528491,60862,147141703183,56062,230237509455,1500000000,1500000000
85440603533,1649374731,55580,87047899708,50780,109904515133,1607296175,1607296175
58293771764,1649371712,60850,59793771764,60850,66277770472,1500000000,1500000000
74977908546,1641141583,60850,76477908546,60850,120582301782,1500000000,1500000000
67234069293,1641552868,319735,69234069293,319735,99056195506,2000000000,2000000000
21810752462,1648300837,66730,23310752462,66730,34677490155,1500000000,1500000000
96203473640,1641130364,60838,97703473640,60838,98952884156,1500000000,1500000000
148895033000,1641573524,66754,150395033000,61954,177571497744,1500000000,1500000000
117762265802,1641566383,333688,119262265802,333688,122207617655,1500000000,1500000000
117668125423,1641534634,320479,119168125423,320479,123500380414,1500000000,1500000000
40662768220,1649316150,67634,42162768220,62834,48763067227,1500000000,1500000000
65884832689,1649369011,122017,67384832689,122017,94735585869,1500000000,1500000000
177566410771,1641586039,60850,179066410771,56050,185251392968,1500000000,1500000000
157966227178,1641597843,67646,159466227178,62846,185986438140,1500000000,1500000000
44250976316,1650399557,67634,45750976316,67634,50000000000,1500000000,1500000000
64008314950,1646942787,336982,65508314950,336982,86831350187,1500000000,1500000000
123539619168,1641589581,324218,125039619168,324218,126505024832,1500000000,1500000000
30264300210,1650372843,323674,31764300210,323674,32200498718,1500000000,1500000000
64959384542,1649371753,67622,66459384542,67622,80742211593,1500000000,1500000000
64959384542,1649371753,67646,70000000000,62846,70000000000,60000000000,5040615458
66030095082,1641084794,60862,67530095082,56062,78493004747,1500000000,1500000000
76385020737,1641101550,54861,78885020737,54861,155161847314,2500000000,2500000000
39768894610,1649335438,64741,41268894610,59941,47960817705,1500000000,1500000000
36389510067,1650364398,64741,37889510067,59941,53485014382,1500000000,1500000000
34587394056,1646931302,313399,36587394056,313399,36816649644,2000000000,2000000000
72357730412,1649349633,321678,73857730412,321678,92619055492,1500000000,1500000000
35538531311,1650361485,60054,37038531311,55254,49131599335,1500000000,1500000000
19611703100,1650348658,55693,21111703100,50893,29135492447,1500000000,1500000000
62252851318,1646943090,60874,63752851318,56074,75322343200,1500000000,1500000000
62087247834,1649306031,66778,300000000000,61978,300000000000,300000000000,237912752166
37932562809,1649335261,331181,39432562809,331181,56547468710,1500000000,1500000000
233470318824,1649374021,67622,235765391134,67622,256042286532,2295072310,2295072310
63130078793,1650360294,60850,64630078793,56050,76810867207,1500000000,1500000000
46844646805,1650386542,59970,48344646805,55170,57529660729,1500000000,1500000000
229694543431,1641086668,60862,231694543431,56062,257255204970,2000000000,2000000000
45261378445,1646878837,55580,46761378445,55580,55678251434,1500000000,1500000000
38632574432,1646943935,60838,40132574432,60838,43811136330,1500000000,1500000000
55573568024,1649300469,55580,57073568024,50780,61776177054,1500000000,1500000000
140958653076,1641589085,67646,142458653076,62846,211348684202,1500000000,1500000000
153502022203,1641572568,331151,155002022203,331151,162547288595,1500000000,1500000000
29711048032,1648268511,56516,31211048032,51716,41179826690,1500000000,1500000000
40430738304,1650371258,67722,41930738304,62922,51310837293,1500000000,1500000000
71689319900,1641124188,329277,73189319900,329277,94965224213,1500000000,1500000000
96605385811,1641145474,67646,98105385811,62846,125563013206,1500000000,1500000000
51913678120,1649366841,60850,53413678120,56050,60018551757,1500000000,1500000000
80182462364,1649297100,60950,81682462364,56150,90603773289,1500000000,1500000000
27798643069,1650355838,317278,29298643069,317278,30911367675,1500000000,1500000000
60358642520,1650402744,67634,61858642520,67634,63260538099,1500000000,1500000000
20751709024,1646945106,60850,22251709024,60850,25700990889,1500000000,1500000000
20751709024,1646945106,60850,22251709024,60850,25700990889,1500000000,1500000000
46888062839,1650370447,67734,48388062839,62934,56335757979,1500000000,1500000000
43099650185,1649314810,67734,44599650185,62934,53066978517,1500000000,1500000000
61876026926,1649341454,60850,63376026926,56050,78704327685,1500000000,1500000000
75408079229,1649369438,312139,76908079229,312139,104584459937,1500000000,1500000000
30527624912,1649315879,67646,32027624912,62846,47683869864,1500000000,1500000000
30527624912,1649315879,66802,32027624912,66802,47683869864,1500000000,1500000000
40645703796,1649363205,60938,42145703796,56138,59879025083,1500000000,1500000000
40645703796,1649363205,56516,45645703796,51716,200000000000,5000000000,5000000000
40452677446,1649364508,54921,41952677446,50121,200000000000,1500000000,1500000000
40452677446,1649364508,67646,65000000000,67646,,,
165104804159,1641589033,55580,166604804159,55580,211179132625,1500000000,1500000000
85493441157,1641556288,67646,86993441157,67646,91394308425,1500000000,1500000000
25851755358,1650340280,55684,27351755358,50884,34557834030,1500000000,1500000000
25851755358,1650340280,60962,27351755358,56162,33019990474,1500000000,1500000000
25417729227,1650329662,60862,26917729227,56062,28290738485,1500000000,1500000000
81712114486,1641136787,55592,83712114486,50792,93859323214,2000000000,2000000000
279810199095,1649344510,60006,281310199095,55206,348614401937,1500000000,1500000000
22390717977,1646937857,60838,23890717977,60838,30080749904,1500000000,1500000000
36893293943,1650409732,321076,37000000000,321076,37000000000,1500000000,106706057
46246017960,1650368424,66766,47746017960,61966,52889365809,1500000000,1500000000
74250827222,1641085901,91461,75750827222,86661,89521709446,1500000000,1500000000
141787345823,1641087393,67634,143287345823,62834,184649083551,1500000000,1500000000
41317899610,1650401373,67646,42817899610,62846,53638439098,1500000000,1500000000
15793672036,1646897256,60938,16293672036,56138,17000000000,500000000,500000000
38479144559,1646878881,60862,39979144559,56062,55678251434,1500000000,1500000000
36866087067,1649315966,60862,38366087067,56062,46783211983,1500000000,1500000000
112828170357,1641547867,67646,114328170357,62846,132153217515,1500000000,1500000000
39016508475,1646913288,60938,39888269545,60938,39888269545,1565987370,871761070
37939891090,1649311830,64741,39939891090,59941,50051410212,2000000000,2000000000
22681870136,1648283518,314114,24181870136,314114,27268153019,1500000000,1500000000
37312646645,1650367283,67710,38812646645,62910,44627731542,1500000000,1500000000
88177078456,1641123961,54909,89677078456,50109,110937281906,1500000000,1500000000
62718705037,1641097232,52916,73752967374,48116,,,
81181620315,1641084688,296441,82681620315,296441,87591882854,1500000000,1500000000
51050613740,1646877276,60862,52550613740,56062,56920253552,1500000000,1500000000
51050613740,1646877276,67634,52550613740,67634,56920253552,1500000000,1500000000
50979663984,1649318518,60838,52479663984,60838,54508468904,1500000000,1500000000
138869368820,1641576437,326782,140369368820,326782,189261928635,1500000000,1500000000
79452186278,1641106405,67634,80952186278,67634,86392635180,1500000000,1500000000
61399856384,1649361472,55717,66399856384,50917,200000000000,5000000000,5000000000
131283636096,1641584442,60862,132783636096,56062,199733043154,1500000000,1500000000
35485196192,1650406727,66742,36985196192,61942,54428604224,1500000000,1500000000
34775230518,1646936732,60838,36275230518,60838,46322516894,1500000000,1500000000
86417260477,1649374691,67634,88074266843,62834,113110390919,1657006366,1657006366
42322718410,1649316304,331133,43822718410,331133,50346192310,1500000000,1500000000
124805048280,1641593504,60850,126305048280,60850,136251430212,1500000000,1500000000
113656383617,1641569161,333714,115156383617,333714,154104912894,1500000000,1500000000
129933427659,1641563007,67646,131491085308,67646,138366488241,1557657649,1557657649
41664862958,1650369770,63200,43164862958,63200,80647530692,1500000000,1500000000
49527501203,1646913367,310858,51244969254,310858,56582162754,1717468051,1717468051
95150884360,1641549991,336885,97150884360,336885,149003110205,2000000000,2000000000
109849535055,1641593536,322967,111349535055,322967,122444783613,1500000000,1500000000
126961372754,1641538506,334318,128461372754,334318,179139229484,1500000000,1500000000
28968461566,1650331846,336845,30468461566,336845,41279630644,1500000000,1500000000
100577220715,1641123909,304638,102077220715,304638,114460001057,1500000000,1500000000
64329061240,1649371867,54921,65829061240,50121,200000000000,1500000000,1500000000
123030966862,1649374536,67634,124846520040,67634,152434050817,1815553178,1815553178
156313672619,1641519648,330559,157813672619,330559,199564291455,1500000000,1500000000
30500884409,1648265251,60862,32000884409,56062,46818579337,1500000000,1500000000
74492192658,1641165903,312930,75992192658,312930,83088077651,1500000000,1500000000
19954897147,1646893333,60838,21454897147,60838,28550860037,1500000000,1500000000
49942439831,1646886976,60926,50917559733,60926,50917559733,1500000000,975119902
67383572847,1649350776,67634,68883572847,67634,74896776642,1500000000,1500000000
92936440702,1650358693,60862,94436440702,56062,115026117664,1500000000,1500000000
28083249229,1650341481,336855,29583249229,336855,32538605689,1500000000,1500000000
73714565898,1641141628,60850,75214565898,56050,97959616397,1500000000,1500000000
89748762820,1641082197,67622,91248762820,67622,110531984124,1500000000,1500000000
87983264310,1641161679,300226,89483264310,300226,90972531857,1500000000,1500000000
51562684530,1641126588,327399,53062684530,327399,75053613699,1500000000,1500000000
335632223527,1641156284,54956,344017609151,50156,393768144713,8385385624,8385385624
108289210988,1649346828,340637,145299943007,340637,145299943007,145299943007,37010732019
71367599245,1641084505,336901,72867599245,336901,75000000000,1500000000,1500000000
100968539272,1641108394,67622,102468539272,67622,125421733750,1500000000,1500000000
59196720864,1649361921,66778,60696720864,66778,67796830134,1500000000,1500000000
33108948881,1649312877,318738,34608948881,318738,43101249245,1500000000,1500000000
30333558414,1648256138,334581,31336176635,334581,31336176635,1500000000,1002618221
45213147245,1650405103,67622,46713147245,67622,58077519389,1500000000,1500000000
45213147245,1650405103,60862,46713147245,56062,58077519389,1500000000,1500000000
30441989891,1646931875,56576,31941989891,51776,41379635683,1500000000,1500000000
63215282503,1649358633,67646,64715282503,62846,84684901478,1500000000,1500000000
33354152452,1649315316,314156,35354152452,314156,300000000000,2000000000,2000000000
155267245524,1641597103,60850,156767245524,56050,181044719005,1500000000,1500000000
18495374992,1650364787,55668,20145374992,50868,33629143206,1650000000,1650000000
23910388915,1648273473,54095,25850388915,49295,30025940704,1940000000,1940000000
32307386178,1650371655,63188,33807386178,63188,79794917118,1500000000,1500000000
48294694895,1650366747,66802,49781878972,62002,49781878972,1500000000,1487184077
102273127023,1641143950,322840,103773127023,322840,122467057430,1500000000,1500000000
38109994281,1646884507,67646,39609994281,62846,47956074085,1500000000,1500000000
42851328520,1646878617,55580,44351328520,50780,44833486160,1500000000,1500000000
48317218217,1649306825,66790,49817218217,61990,70130331129,1500000000,1500000000
48317218217,1649306825,64741,53317218217,59941,100000000000,5000000000,5000000000
45282840425,1650382804,55717,46782840425,50917,56425149327,1500000000,1500000000
116223476135,1641161966,316091,117723476135,316091,140252451491,1500000000,1500000000
50772530624,1649324910,64741,55772530624,59941,100000000000,5000000000,5000000000
18631838826,1648293490,333682,20000000000,333682,20000000000,1500000000,1368161174
72455939250,1641125945,330523,73955939250,330523,93468196647,1500000000,1500000000
16583306612,1646903821,336809,18083306612,336809,22389868990,1500000000,1500000000
51665634825,1649331378,64741,53165634825,59941,200000000000,1500000000,1500000000
51665634825,1649331378,327964,53165634825,327964,53657069229,1500000000,1500000000
49395578465,1650403721,60850,50895578465,56050,58122547994,1500000000,1500000000
157395774397,1641159060,60862,158895774397,56062,205843803516,1500000000,1500000000
35692469061,1646871154,60850,36758104295,56050,36758104295,1500000000,1065635234
141557708758,1641579679,343239,143057708758,343239,164819876937,1500000000,1500000000
151273637608,1641522107,60862,152773637608,56062,159592883000,1500000000,1500000000
39862850324,1650405436,67634,41362850324,62834,46907206285,1500000000,1500000000
31115069647,1650336977,67634,32615069647,67634,40408124323,1500000000,1500000000
56844188925,1641124851,55705,58344188925,50905,70391602926,1500000000,1500000000
21835313278,1646944316,320473,23335313278,320473,29228718054,1500000000,1500000000
76434938649,1641562114,60874,77934938649,56074,123632581175,1500000000,1500000000
22604464479,1648296514,63200,24104464479,63200,37794115734,1500000000,1500000000
59709252087,1641111765,314116,61209252087,314116,71669189247,1500000000,1500000000
140656781925,1641576088,55592,142156781925,50792,191396043338,1500000000,1500000000
34376531400,1650411408,338788,35876531400,338788,46588753530,1500000000,1500000000
20555920546,1646920464,60862,22055920546,56062,31838021334,1500000000,1500000000
59212670836,1649372807,67622,60712670836,67622,65439743613,1500000000,1500000000
55517416111,1649372463,67646,57017416111,67646,72762291008,1500000000,1500000000
68737377666,1649373034,55720,70237377666,50920,200000000000,1500000000,1500000000
243582118774,1641526899,66814,245082118774,62014,316025666799,1500000000,1500000000
47391580479,1650366291,67622,48891580479,67622,57252255557,1500000000,1500000000
27918833332,1646873867,60862,29418833332,56062,39419801537,1500000000,1500000000
41816426667,1649311184,317314,43316426667,317314,53047816350,1500000000,1500000000
121095295333,1641149698,336921,122595295333,336921,147497471436,1500000000,1500000000
37007778861,1646932136,52928,38507778861,48128,51127753452,1500000000,1500000000
99925087259,1649346874,334310,101425087259,317210,141005938947,1500000000,1500000000
57174727565,1649306166,64741,62174727565,59941,100000000000,5000000000,5000000000
42131295452,1649322129,330561,43631295452,330561,47251540003,1500000000,1500000000
71272945929,1641132337,67634,72772945929,62834,73338669099,1500000000,1500000000
18476972617,1646905701,55705,20358772617,50905,21000000000,1881800000,1881800000
32748332543,1646873490,60018,34248332543,55218,40363888575,1500000000,1500000000
17076274520,1646893176,60838,18576274520,56038,22663628313,1500000000,1500000000
26964451051,1646924837,60850,28464451051,60850,34424344100,1500000000,1500000000
32019379773,1649302483,67634,33519379773,62834,40594417477,1500000000,1500000000
123930769350,1641566536,67622,125430769350,62822,140336801535,1500000000,1500000000
249228278459,1641583516,67634,250795765177,62834,338099936421,1567486718,1567486718
57900166954,1646917782,60862,59841090435,56062,72835700526,1940923481,1940923481
48807330630,1649327419,60862,50307330630,56062,53147557094,1500000000,1500000000
23985819149,1646876187,55592,25485819149,50792,34637868105,1500000000,1500000000
26339475280,1646924833,67634,27839475280,62834,29838391289,1500000000,1500000000
26677318121,1650364701,67734,28177318121,62934,38919986103,1500000000,1500000000
27463002485,1650351544,340011,28963002485,340011,36968781694,1500000000,1500000000
88963672511,1641165569,60862,90463672511,56062,108093588398,1500000000,1500000000
36690374329,1646936972,60838,38190374329,60838,46995998173,1500000000,1500000000
40805116538,1649357738,67646,42805116538,62846,59138975984,2000000000,2000000000
35937569811,1649325624,67634,37437569811,67634,44000000000,1500000000,1500000000
61848104521,1641125844,331149,63348104521,331149,67599059375,1500000000,1500000000
20798678548,1646896198,60938,22000000000,56138,22000000000,1500000000,1201321452
20788477682,1648333452,67622,22288477682,62822,28337042649,1500000000,1500000000
24460309693,1648273263,55693,25961760677,50893,34251166015,1501450984,1501450984
47569695756,1650331382,56516,49069695756,51716,200000000000,1500000000,1500000000
49862950668,1650404534,64741,51362950668,59941,63895645622,1500000000,1500000000
123408383547,1641154429,67646,124908383547,62846,148564279348,1500000000,1500000000
122719675474,1641525169,334306,124219675474,334306,194799659188,1500000000,1500000000
193237679031,1641519038,54872,195737679031,54872,346043410790,2500000000,2500000000
49453102836,1649366005,67634,50953102836,67634,82950743793,1500000000,1500000000
19360792711,1646945052,60850,20860792711,60850,27272288347,1500000000,1500000000
31707171317,1650357275,66718,32779997173,66718,32779997173,1500000000,1072825856
103317075100,1641146018,321678,105317075100,321678,116800425055,2000000000,2000000000
53727688383,1646917137,55584,55227688383,50784,55246485443,1500000000,1500000000
28795563608,1650371370,56576,30295563608,51776,33498101138,1500000000,1500000000
48600681024,1650382733,63200,50100681024,63200,98708820394,1500000000,1500000000
90265679343,1641142220,334342,92265679343,334342,94400613926,2000000000,2000000000
43127396934,1646944018,60838,44627396934,60838,54233739118,1500000000,1500000000
225397308683,1641518323,60850,226897308683,56050,246421567784,1500000000,1500000000
75426622526,1650395560,64056,76926622526,54456,84368044364,1500000000,1500000000
63907564130,1641116552,49519,66190911807,44719,,,
46148771717,1649290237,297074,47648771717,297074,57567190003,1500000000,1500000000
59013313256,1649351155,67622,60513313256,67622,70000000000,1500000000,1500000000
50717003949,1649363072,55717,54717003949,50917,80069915675,4000000000,4000000000
35980402376,1649326876,319893,36927918748,319893,36927918748,1154727234,947516372
44426313867,1650404450,67634,45926313867,62834,63207169043,1500000000,1500000000
29350045847,1646876410,319277,30850045847,319277,38612901639,1500000000,1500000000
26611055690,1646937688,60838,28111055690,60838,32649680829,1500000000,1500000000
26001117315,1648267919,343237,28998202468,343237,,,
39591500531,1649308927,313427,41091500531,313427,60840514545,1500000000,1500000000
22460244027,1650333205,48627,23960244027,48627,27562139015,1500000000,1500000000
46670919893,1650369714,55680,48170919893,50880,50448445702,1500000000,1500000000
48833646430,1650384365,340039,50333646430,340039,60762460704,1500000000,1500000000
54911803019,1649351795,64741,56411803019,59941,58552933360,1500000000,1500000000
38026777431,1649316942,54332,39526777431,49532,53800362650,1500000000,1500000000
119291988599,1641570205,60850,120791988599,56050,129031180100,1500000000,1500000000
49728180727,1641139967,59958,51228180727,55158,78540849059,1500000000,1500000000
42323604157,1646936821,60838,43823604157,60838,44965744852,1500000000,1500000000
120624142513,1641569304,333712,122124142513,333712,155675852869,1500000000,1500000000
36150100805,1650386678,67634,37650100805,67634,56274369752,1500000000,1500000000
39105950731,1650376349,66790,40605950731,61990,44957624933,1500000000,1500000000
24823518528,1650342418,66790,26323518528,66790,28478787765,1500000000,1500000000
33512769447,1650369013,67634,35012769447,67634,47502780734,1500000000,1500000000
63887736823,1641117173,319749,65387736823,319749,66096726542,1500000000,1500000000
70715294027,1649373170,54921,72215294027,50121,200000000000,1500000000,1500000000
32515256769,1648282382,60938,34015256769,60938,35653455505,1500000000,1500000000
28414675620,1650356481,60006,29914675620,55206,38145535057,1500000000,1500000000
28414675620,1650356481,64132,29914675620,54532,38145535057,1500000000,1500000000
61493556458,1649370998,67634,62993556458,67634,82177437270,1500000000,1500000000
26826671490,1646955666,312359,28326671490,312359,33687788325,1500000000,1500000000
38174069631,1649360842,55717,40174069631,50917,41216475597,2000000000,2000000000
23487603289,1650337837,67722,24987603289,62922,28757031304,1500000000,1500000000
23487603289,1650337837,59946,24987603289,55146,25731193979,1500000000,1500000000
52250565521,1650385732,63200,53750565521,63200,97069227192,1500000000,1500000000
18620048241,1650328789,54715,20120048241,49915,25146651937,1500000000,1500000000
22064407656,1650329474,66862,23323111559,66862,23323111559,1500000000,1258703903
25444164903,1650328167,331141,26944164903,331141,33340242158,1500000000,1500000000
67049742023,1641111636,60838,68549742023,60838,81838897977,1500000000,1500000000
34830395585,1646944073,60838,36330395585,60838,53738495863,1500000000,1500000000
65967984235,1649373050,67634,67467984235,67634,82151325325,1500000000,1500000000
171803051939,1641571834,336907,173303051939,336907,181061438464,1500000000,1500000000
79416119094,1648259364,60862,80916119094,56062,98301036478,1500000000,1500000000
47139590097,1650383811,101601,49000000000,62934,,,
64718221518,1641116096,52928,66218221518,48128,80185302239,1500000000,1500000000
52777016044,1641133446,327932,54777016044,327932,220000000000,2000000000,2000000000
21600022962,1646923664,67634,23100022962,62834,23769283424,1500000000,1500000000
148313985910,1649347489,67646,149813985910,62846,195480171663,1500000000,1500000000
79315666194,1641552645,302601,81315666194,302601,95859968592,2000000000,2000000000
64991064149,1649371997,55720,66491064149,50920,200000000000,1500000000,1500000000
49082189393,1650404817,60838,50582189393,60838,53074775425,1500000000,1500000000
121060298220,1641083672,67634,122560298220,62834,123257486249,1500000000,1500000000
24869080499,1646956151,314140,26369080499,314140,26411319447,1500000000,1500000000
95818459142,1649373558,67622,97318459142,67622,119235731023,1500000000,1500000000
323768235078,1649344823,60018,325268235078,55218,380961953475,1500000000,1500000000
82698208123,1641546471,333738,84198208123,333738,122631294380,1500000000,1500000000
168445512852,1641573842,64729,169945512852,59929,199688203150,1500000000,1500000000
125065891773,1641592061,313429,126565891773,313429,128128694720,1500000000,1500000000
32843496236,1648263089,60862,34343496236,56062,42797305480,1500000000,1500000000
67785173658,1641116195,327912,69285173658,327912,80876025784,1500000000,1500000000
21162141596,1646931158,331157,23162141596,331157,40505626222,2000000000,2000000000
163863401867,1641586518,60850,165363401867,56050,218146103597,1500000000,1500000000
31714559350,1650369184,67722,33214559350,67722,33715726434,1500000000,1500000000
16934804834,1650338310,343249,18434804834,343249,30030018615,1500000000,1500000000
96153265505,1641145300,305770,97653265505,305770,118033392768,1500000000,1500000000
35444327121,1650410292,67646,36944327121,62846,52134753029,1500000000,1500000000
35444327121,1650410292,310882,36944327121,310882,47792672162,1500000000,1500000000
70383801587,1641100856,67646,72383801587,62846,89156714060,2000000000,2000000000
69600631792,1649337205,67722,71100631792,62922,91925796574,1500000000,1500000000
43441351579,1650403819,67634,45441351579,62834,53481955432,2000000000,2000000000
63397693463,1650395899,60838,64897693463,56038,85253977475,1500000000,1500000000
464657727467,1641156746,67634,468517617869,67634,516937142298,3859890402,3859890402
84786111516,1641094465,333678,86286111516,333678,103885531616,1500000000,1500000000
70569376929,1641104222,67646,72169876929,62846,84875697021,1600500000,1600500000
24872288994,1646882882,331181,25000000000,331181,25000000000,500000000,127711006
40437931062,1649366953,49469,41937931062,44669,47202693345,1500000000,1500000000
126341436027,1641537878,316636,127841436027,316636,171534274433,1500000000,1500000000
19787472348,1646897101,66838,21287472348,62038,25923828700,1500000000,1500000000
113536794655,1641532423,314047,115036794655,314047,140999743458,1500000000,1500000000
158283958333,1641523290,327393,160283958333,327393,192999733428,2000000000,2000000000
123890951377,1641087747,67622,125390951377,67622,167028269763,1500000000,1500000000
38074560611,1646943919,60838,39574560611,60838,40202329308,1500000000,1500000000
50428582859,1649324247,53252,51928582859,48452,53067575538,1500000000,1500000000
83187835416,1641547317,60018,84687835416,60018,111949512007,1500000000,1500000000
55844331978,1646932854,67646,57344331978,62846,84824320232,1500000000,1500000000
117146321606,1641543567,319785,118646321606,319785,132792779075,1500000000,1500000000
39541990716,1648278557,67634,41041990716,67634,52950022824,1500000000,1500000000
31068856601,1650345413,67622,32568856601,67622,43412174053,1500000000,1500000000
108313822502,1641165440,67634,110313822502,67634,118096764313,2000000000,2000000000
177927598819,1641148380,50000,179427598819,50000,203503004535,1500000000,1500000000
37492169448,1650412457,60838,38992169448,60838,49147290622,1500000000,1500000000
37502393277,1646943947,60838,39002393277,60838,49790718040,1500000000,1500000000
36480897951,1650405143,60838,37980897951,60838,58077519389,1500000000,1500000000
56511632240,1641103324,60850,58011632240,60850,81821547135,1500000000,1500000000
35773191513,1649326816,67634,37273191513,62834,51581910157,1500000000,1500000000
31503448742,1648311975,60850,33003448742,56050,51074545962,1500000000,1500000000
43950462086,1650362841,59946,45450462086,55146,54489953873,1500000000,1500000000
43950462086,1650362841,67634,45950462086,62834,59457340954,2000000000,2000000000
83853877299,1650358526,60850,85353877299,60850,102682596485,1500000000,1500000000
81472943567,1641165047,60862,82972943567,56062,106551623500,1500000000,1500000000
144852828796,1649374438,55693,146405313796,50893,158791465904,1552485000,1552485000
48645594220,1649327586,160850,53645594220,60850,77000000000,5000000000,5000000000
49571399771,1650405507,55717,51071399771,50917,57553472527,1500000000,1500000000
59778860176,1649290115,60838,61778860176,60838,89319620073,2000000000,2000000000
47112765373,1649314432,324216,48612765373,324216,59262190672,1500000000,1500000000
93657669012,1641550019,334358,95657669012,334358,143115801274,2000000000,2000000000
48792945459,1648281000,67710,50292945459,67710,63414237942,1500000000,1500000000
21050120808,1648284966,305990,22293027843,305990,22293027843,1500000000,1242907035
34253777417,1650343158,59982,35753777417,55182,36126786038,1500000000,1500000000
30060371150,1650342659,64717,31560371150,59917,46456007340,1500000000,1500000000
125342375647,1641160330,60862,126842375647,56062,151675035842,1500000000,1500000000
52375910605,1646933841,60850,53875910605,56050,66149721029,1500000000,1500000000
151209420585,1641570795,54872,152709420585,54872,164135114515,1500000000,1500000000
25158533492,1648332894,314098,26658533492,314098,37714391034,1500000000,1500000000
22545769798,1646921145,49483,24045769798,44683,27907228478,1500000000,1500000000
161400517527,1641563054,60850,162900517527,60850,184202841143,1500000000,1500000000
20355432621,1648269335,67634,21855432621,67634,26240460075,1500000000,1500000000
32402500295,1650365924,49607,33902500295,44807,43295030045,1500000000,1500000000
37415130385,1650401755,67634,38915130385,62834,50658128284,1500000000,1500000000
106284536714,1641151341,64705,108284536714,64705,120096598718,2000000000,2000000000
80701959785,1649356105,64741,85701959785,59941,200000000000,5000000000,5000000000
44185950512,1650384725,66766,45685950512,66766,53530221212,1500000000,1500000000
57244777255,1650412094,67634,58744777255,62834,74904745947,1500000000,1500000000
80327237805,1641083212,314047,81827237805,314047,93990808226,1500000000,1500000000
22792556836,1646945158,60850,24292556836,60850,30241221788,1500000000,1500000000
28406277945,1646931845,60838,29906277945,56038,31639235377,1500000000,1500000000
24682411652,1650364115,59946,26182411652,55146,37451834698,1500000000,1500000000
20771955339,1646895539,55580,22271955339,55580,27670143839,1500000000,1500000000
30649562211,1646936896,60838,32149562211,60838,48229790768,1500000000,1500000000
45695964961,1649293662,295327,47195964961,295327,50903828877,1500000000,1500000000
51151794890,1649372746,327974,56151794890,327974,61000000000,5000000000,5000000000
35290030014,1649300604,324788,36790030014,324788,54490490843,1500000000,1500000000
43949769321,1650391020,55705,45449769321,50905,51333388185,1500000000,1500000000
169417387698,1641529666,60862,170917387698,56062,235883716112,1500000000,1500000000
22108926388,1650339143,316169,23608926388,316169,27328345070,1500000000,1500000000
22599580489,1650352835,316536,24099580489,316536,26610888977,1500000000,1500000000
60699933790,1650396025,67634,62199933790,62834,89678552954,1500000000,1500000000
21295559099,1646944387,67646,22795559099,62846,24279568412,1500000000,1500000000
41973956229,1646944046,60838,43473956229,60838,55409246168,1500000000,1500000000
75211314544,1641562349,349544,76711314544,349544,103090472833,1500000000,1500000000
201581466790,1641157840,66706,203482044437,66706,236040433385,1900577647,1900577647
32809946918,1646879294,54921,34309946918,50121,390000000000,1500000000,1500000000
26028640870,1646876635,55592,27528640870,50792,32022319982,1500000000,1500000000
53359329950,1649370543,63200,54859329950,63200,125037950316,1500000000,1500000000
222741539596,1641568831,67646,224241539596,62846,241749715934,1500000000,1500000000
39122773255,1650357747,55684,40622773255,50884,51169281268,1500000000,1500000000
22787001142,1650333241,67634,24287001142,62834,29575305034,1500000000,1500000000
36878717260,1650367484,67722,38378717260,67722,49106371544,1500000000,1500000000
28916999895,1646911539,55644,31416999895,55644,60817615758,2500000000,2500000000
55013005788,1646914550,55584,56513005788,50784,67474944169,1500000000,1500000000
34796525107,1650407134,60862,36296525107,56062,52732058823,1500000000,1500000000
24919744663,1646937684,60838,26419744663,60838,34024708403,1500000000,1500000000
69895060220,1641553174,64741,71895060220,59941,94312343620,2000000000,2000000000
28787309249,1650332427,63200,30287309249,63200,57577053790,1500000000,1500000000
61363549050,1641112626,54727,62863549050,49927,77510983332,1500000000,1500000000
91758077121,1641100339,60850,93258077121,56050,108138220841,1500000000,1500000000
25373503712,1646900565,334344,26873503712,334344,28636369315,1500000000,1500000000
19757340789,1646897030,60938,20257340789,56138,22000000000,500000000,500000000
49506550425,1646882631,60850,51006550425,56050,57319934328,1500000000,1500000000
108335898513,1641552408,55705,109835898513,50905,123774155757,1500000000,1500000000
36679269189,1650404724,60850,38179269189,60850,53895776949,1500000000,1500000000
50150064480,1650402876,49495,51650064480,49495,78814922399,1500000000,1500000000
43342601147,1646878834,331157,44842601147,331157,59674600483,1500000000,1500000000
53453530032,1649353818,49583,54953530032,49583,68980673549,1500000000,1500000000
103717859239,1641545916,329265,105217859239,329265,137195588529,1500000000,1500000000
96775047555,1641548242,60850,98275047555,56050,129273644743,1500000000,1500000000
78006035043,1649369529,314128,79506035043,314128,200000000000,1500000000,1500000000
118770666112,1641543120,317250,120270666112,317250,152914363468,1500000000,1500000000
33778514634,1650368218,60850,35278514634,60850,43854357213,1500000000,1500000000
82404290959,1641088400,67646,83904290959,67646,98688469889,1500000000,1500000000
58995316903,1641133134,54848,60495316903,54848,81151204523,1500000000,1500000000
155715172399,1641150477,60862,157215172399,56062,164845266720,1500000000,1500000000
28135829344,1646945398,60850,29635829344,60850,29986789234,1500000000,1500000000
107424712781,1641542053,67646,108924712781,62846,137311179488,1500000000,1500000000
81518289366,1641544495,54783,83018289366,49983,101283561320,1500000000,1500000000
168290180819,1641532186,331161,169790180819,331161,208777454659,1500000000,1500000000
103780294927,1641595164,55620,105280294927,50820,144161086844,1500000000,1500000000
41537059494,1650401714,329426,43037059494,329426,52126551475,1500000000,1500000000
17205612708,1650333005,333714,18705612708,333714,25909151130,1500000000,1500000000
41996742564,1646929066,323086,43496742564,323086,56536142887,1500000000,1500000000
35536041048,1649334325,323564,37036041048,323564,42791071129,1500000000,1500000000
23166645704,1648304951,337502,24666645704,337502,29432932208,1500000000,1500000000
38171467037,1650402135,340035,39671467037,340035,57777753217,1500000000,1500000000
21942954248,1650352473,60950,23442954248,56150,29310388277,1500000000,1500000000
25190641003,1646937985,60838,26384237970,60838,26384237970,1500000000,1193596967
25810328742,1650337960,48603,27310328742,43803,33970989638,1500000000,1500000000
68229017791,1641085947,49519,69729017791,44719,89521709446,1500000000,1500000000
108665416180,1641145496,60862,110165416180,56062,118581663261,1500000000,1500000000
110705661353,1641534489,67634,112205661353,62834,148495586458,1500000000,1500000000
159659897537,1641588740,296537,161159897537,296537,208971958330,1500000000,1500000000
61185805653,1648260607,329950,62685805653,329950,62886668882,1500000000,1500000000
45914834735,1650405035,64741,47414834735,64741,55875959704,1500000000,1500000000
45914834735,1650405035,60850,47414834735,60850,55875959704,1500000000,1500000000
45914834735,1650405035,60838,47414834735,60838,55875959704,1500000000,1500000000
18570972114,1650333023,311132,20070972114,311132,23755808183,1500000000,1500000000
47521465604,1649356848,67622,49021465604,62822,51003637528,1500000000,1500000000
36681734800,1648255889,67646,38181734800,62846,51239848505,1500000000,1500000000
30874094749,1648265886,67634,32374094749,67634,45605849642,1500000000,1500000000
26673370470,1650373160,326099,28173370470,326099,60000000000,1500000000,1500000000
67492985684,1641135830,54727,68992985684,49927,86940909023,1500000000,1500000000
47093859865,1646877402,59982,48593859865,59982,57123440423,1500000000,1500000000
25107922526,1646889051,60862,26300068810,56062,26300068810,1500000000,1192146284
36336457759,1649366456,333708,37836457759,333708,64706954617,1500000000,1500000000
166584361654,1641516919,54861,169084361654,54861,359165247242,2500000000,2500000000
24101530515,1648326698,55717,25601530515,50917,30955437030,1500000000,1500000000
73946411829,1650395764,66862,75446411829,66862,77291441305,1500000000,1500000000
22789619250,1646910439,60938,24289619250,56138,30328931350,1500000000,1500000000
50442796339,1649320936,343223,51942796339,343223,52022828238,1500000000,1500000000
32070222951,1646945314,67634,33570222951,67634,42042080745,1500000000,1500000000
84369901713,1649349315,319764,86369901713,319764,102406432125,2000000000,2000000000
39778304178,1650389968,55705,41278304178,50905,58018414998,1500000000,1500000000
44342139903,1650410461,55680,45842139903,50880,51459914453,1500000000,1500000000
19808330564,1650364948,85687,21308330564,85687,27398869528,1500000000,1500000000
102925141619,1641160682,316711,104425141619,316711,119351663360,1500000000,1500000000
23351987634,1646896056,67634,24851987634,67634,29984422717,1500000000,1500000000
45043910452,1649366677,55717,48043910452,50917,59552466395,3000000000,3000000000
74165355681,1641095357,67634,75665355681,62834,99571826717,1500000000,1500000000
19667751517,1648268746,55648,22167751517,55648,44362385336,2500000000,2500000000
33851086833,1648268386,316588,35351086833,316588,39566047465,1500000000,1500000000
45690259244,1650394333,54320,47190259244,49520,63648216297,1500000000,1500000000
45690259244,1650394333,55705,47190259244,50905,66026542549,1500000000,1500000000
54585756158,1641103174,314073,56085756158,314073,60000000000,1500000000,1500000000
113326758094,1641088913,52556,114826758094,52556,136490162208,1500000000,1500000000
24530481460,1646925116,56492,26030481460,56492,28320784218,1500000000,1500000000
15975514829,1646908234,67646,17475514829,62846,26554275802,1500000000,1500000000
24829113988,1648273495,66766,26329113988,61966,34551871418,1500000000,1500000000
43446827031,1650404565,67622,44946827031,67622,63895645622,1500000000,1500000000
63342664408,1641101314,67622,64842664408,67622,76714568198,1500000000,1500000000
48741499317,1641124491,310283,50241499317,310283,66014885198,1500000000,1500000000
39118954018,1646936790,60838,40618954018,60838,44969038148,1500000000,1500000000
30961863446,1646943820,60838,32461863446,60838,46464457320,1500000000,1500000000
137242039319,1641523132,330481,138742039319,330481,189692178389,1500000000,1500000000
140597142163,1641576593,67634,142097142163,67634,171065228937,1500000000,1500000000
27451360450,1646950789,60850,28489876836,56050,30000000000,1038516386,1038516386
33379675536,1650331007,63200,34879675536,63200,64025735832,1500000000,1500000000
49403957220,1649320298,55672,50903957220,50872,56394718760,1500000000,1500000000
47539188518,1649317754,48663,300000000000,43863,300000000000,300000000000,252460811482
157125910741,1641575638,333684,158625910741,333684,161050559550,1500000000,1500000000
27097189017,1650343054,55681,28597189017,55681,39448271907,1500000000,1500000000
149388453550,1641159783,327968,150888453550,327968,162569852894,1500000000,1500000000
30687689450,1646930463,60838,32187689450,56038,42506720483,1500000000,1500000000
83653730260,1641560558,313403,85653730260,313403,114735818847,2000000000,2000000000
31991941435,1646929412,63200,34491941435,63200,71706266770,2500000000,2500000000
56788805848,1649358079,67634,58288805848,67634,74404010774,1500000000,1500000000
73932160283,1649341297,66754,75432160283,66754,103205565019,1500000000,1500000000
39721968966,1650389008,60938,41721968966,60938,55414006913,2000000000,2000000000
87442954607,1641096576,336853,88942954607,336853,101318507064,1500000000,1500000000
82202376559,1641103984,300785,83702376559,300785,88295159584,1500000000,1500000000
82202376559,1641103984,67634,83702376559,67634,88295159584,1500000000,1500000000
58903686597,1641097151,327990,60000000000,327990,60000000000,1410000000,1096313403
31039658909,1649319940,60838,32539658909,60838,47677496659,1500000000,1500000000
36334475559,1648267759,323606,37834475559,323606,41661065260,1500000000,1500000000
97063784911,1641082004,67634,98563784911,67634,103171195769,1500000000,1500000000
84725996474,1641081951,60862,86225996474,56062,118149770925,1500000000,1500000000
96092489305,1641130368,334370,97592489305,334370,154769876530,1500000000,1500000000
133235721979,1641589387,67622,134735721979,67622,170201106130,1500000000,1500000000
68175195238,1641555604,55582,71175195238,50780,133000000000,3000000000,3000000000
173667172321,1641558274,60862,175167172321,56062,256042377565,1500000000,1500000000
35840858413,1650408295,67622,37340858413,67622,48820786148,1500000000,1500000000
29785526732,1646881138,67634,31285526732,62834,38977056319,1500000000,1500000000
30412504449,1649323826,60850,31912504449,60850,46000000000,1500000000,1500000000
107943109020,1649374580,67634,109704195603,62834,144895945436,1761086583,1761086583
96145083157,1649370105,319782,98145083157,319782,110894686160,2000000000,2000000000
40093224520,1649360885,55717,41593224520,50917,49338647559,1500000000,1500000000
47868654741,1649308543,67634,49368654741,67634,64090162065,1500000000,1500000000
23760897013,1648269271,60862,25260897013,56062,30635973850,1500000000,1500000000
95614107413,1650358214,59970,97114107413,55170,107747705767,1500000000,1500000000
25660340385,1650335675,334306,27160340385,334306,34089480449,1500000000,1500000000
34709637847,1650385315,66766,36709637847,66766,57589010696,2000000000,2000000000
118787210834,1643468072,347005,120287210834,347005,151583165435,1500000000,1500000000
72917923637,1643458900,329289,74417923637,329289,76928377475,1500000000,1500000000
98262867648,1643861496,337524,99462867648,337524,100000000000,1200000000,1200000000
91438971063,1643860001,67646,92938971063,62846,121541861927,1500000000,1500000000
72661952622,1643437044,320499,74161952622,320499,76000000000,1500000000,1500000000
114679718176,1643415489,337472,116179718176,337472,152933530318,1500000000,1500000000
113187121472,1643488519,60150,115187121472,55350,148648535096,2000000000,2000000000
71750805787,1643891677,313949,73250805787,313949,86553384990,1500000000,1500000000
71750805787,1643891677,319735,73250805787,319735,101176481505,1500000000,1500000000
74097482528,1643897808,54322,75597482528,54322,77000000000,1500000000,1500000000
103428489038,1643449750,346418,104928489038,346418,109141892053,1500000000,1500000000
58371155588,1643896894,334318,59871155588,317218,65835578682,1500000000,1500000000
136624120984,1643469555,55717,138124120984,50917,140923592737,1500000000,1500000000
71163677741,1643435476,54824,72663677741,50024,94771573439,1500000000,1500000000
103319817577,1643859555,336873,104819817577,336873,141246836774,1500000000,1500000000
87675494626,1643487251,60126,89675494626,55326,108844566567,2000000000,2000000000
88537480209,1643868803,340017,90037480209,340017,120755465295,1500000000,1500000000
118629351911,1643428676,327391,120129351911,327391,172275549462,1500000000,1500000000
90239966149,1643862436,322889,91739966149,322889,114415151533,1500000000,1500000000
86319705924,1643891875,312058,87819705924,312058,103528561680,1500000000,1500000000
78973353328,1643893169,334346,80473353328,334346,109182579948,1500000000,1500000000
80158798840,1643459869,333668,81658798840,333668,111858177073,1500000000,1500000000
135164600070,1643485295,310133,136664600070,310133,148310975027,1500000000,1500000000
178917507928,1643908358,343179,180417507928,343179,228718524657,1500000000,1500000000
118395764784,1643868441,322945,119969168368,322945,124919554812,1573403584,1573403584
114793759181,1643443607,55580,116000000000,55580,116000000000,1506614078,1206240819
125383382765,1643429812,56516,126883382765,51716,144108637024,1500000000,1500000000
119587277534,1643474472,327145,121587277534,327145,164704643065,2000000000,2000000000
131559496100,1643422651,55705,133059496100,50905,153752503273,1500000000,1500000000
148227490605,1643923052,55632,150727490605,55632,328175362046,2500000000,2500000000
164513985217,1643923666,55608,166013985217,50808,190315599020,1500000000,1500000000
84416512407,1643857826,54332,85916512407,49532,113978721118,1500000000,1500000000
80071914546,1643894517,343201,81571914546,343201,98798813187,1500000000,1500000000
77525468555,1643886183,60862,79025468555,56062,104419415318,1500000000,1500000000
71576582359,1643888565,48615,73076582359,43815,87994296805,1500000000,1500000000
53991186697,1643887216,62151,55491186697,57351,69362724652,1500000000,1500000000
81444233977,1643862838,326816,82944233977,326816,100354150579,1500000000,1500000000
88215417086,1643849033,336851,89625417086,336851,90610778242,1410000000,1410000000
99306335525,1643905250,334270,100806335525,334270,154635224100,1500000000,1500000000
157071678944,1643914320,317166,158571678944,317166,163484717120,1500000000,1500000000
89313393081,1643892736,67634,90813393081,62834,116105711488,1500000000,1500000000
128366173118,1643848308,49483,129866173118,44683,175637447344,1500000000,1500000000
79559684435,1643878381,314110,81059684435,314110,86529298558,1500000000,1500000000
100149275493,1643861261,336895,101174240963,336895,101174240963,1200000000,1024965470
97000448498,1643448508,56717,98500448498,51917,131279499248,1500000000,1500000000
113590060197,1643495120,55804,115090060197,51004,121800663557,1500000000,1500000000
51557787795,1643893757,323072,53057787795,323072,74683982447,1500000000,1500000000
99403837766,1643855932,67622,100903837766,67622,133573928440,1500000000,1500000000
104073134003,1643427007,55636,106573134003,55636,223635698244,2500000000,2500000000
85357938497,1643901408,337470,86857938497,337470,121189661589,1500000000,1500000000
76645774627,1643872426,331955,78145774627,331955,86908664623,1500000000,1500000000
113007233400,1643929081,54908,114007233400,50108,117000000000,1000000000,1000000000
94785107258,1643457079,343207,96285107258,343207,104026119142,1500000000,1500000000
112014090726,1643435271,300000,113424090726,300000,121647805425,1410000000,1410000000
84961875439,1643876901,337474,86461875439,337474,116425058782,1500000000,1500000000
67980894578,1643881503,55705,69480894578,50905,93537450093,1500000000,1500000000
218224384486,1643929930,67646,219994970106,62846,244650626720,1770585620,1770585620
74616914382,1643444334,60862,76116914382,56062,91586276055,1500000000,1500000000
96231221759,1643457485,67634,97731221759,62834,104138330068,1500000000,1500000000
74937797393,1643872004,323020,76937797393,323020,101387530250,2000000000,2000000000
174474699751,1643919960,60850,175974699751,60850,228320624114,1500000000,1500000000
81390784347,1643472669,60862,82890784347,56062,118029298838,1500000000,1500000000
129433896832,1643472169,334302,130933896832,334302,131798181427,1500000000,1500000000
90244592015,1643869713,60862,91744592015,56062,112010590947,1500000000,1500000000
215029489541,1643922356,67646,216529489541,62846,317995507665,1500000000,1500000000
88644959916,1643438346,67646,90144959916,62846,99999972817,1500000000,1500000000
76587540405,1643895080,60850,78087540405,56050,89695747233,1500000000,1500000000
106486233559,1643846646,54296,108486233559,54296,138167890623,2000000000,2000000000
122196976607,1643416394,67622,123696976607,67622,180137588228,1500000000,1500000000
72907874626,1643863054,346334,74407874626,346334,90000000000,1500000000,1500000000
70414981482,1643891707,320479,71914981482,320479,91188507234,1500000000,1500000000
79969934694,1643884368,322430,81469934694,322430,109428984548,1500000000,1500000000
112202730153,1643485177,55717,113702730153,50917,126183770157,1500000000,1500000000
106467735662,1643927319,55636,108967735662,55636,216066760430,2500000000,2500000000
67885040878,1643458869,324986,69385040878,324986,85121454257,1500000000,1500000000
84263470657,1643461629,55592,85763470657,50792,104684648949,1500000000,1500000000
118383859630,1643447097,66826,119883859630,62026,120724596897,1500000000,1500000000
66759781132,1643498567,67646,68259781132,62846,91495089483,1500000000,1500000000
75595827751,1643862822,327074,77095827751,327074,100354150579,1500000000,1500000000
126305163407,1643422140,320515,127805163407,320515,167252712975,1500000000,1500000000
101129317465,1643427662,55636,103629317465,55636,208575663860,2500000000,2500000000
75294584094,1643893198,55705,76794584094,50905,95921819638,1500000000,1500000000
89927847361,1643882019,326274,91427847361,326274,97601925944,1500000000,1500000000
89927847361,1643882019,54896,91427847361,50096,97601925944,1500000000,1500000000
106495964482,1643479640,60838,107995964482,60838,108817210172,1500000000,1500000000
106339052965,1643851904,67646,107839052965,62846,116506759329,1500000000,1500000000
59493276622,1643896878,337470,60993276622,337470,74382789638,1500000000,1500000000
79022137095,1643433616,66778,80522137095,61978,113064080808,1500000000,1500000000
105197320343,1643864097,346326,106697320343,346326,116482905749,1500000000,1500000000
125091555625,1641905152,59970,126591555625,55170,143790667805,1500000000,1500000000
125351059587,1641940744,67634,126851059587,62834,191774609575,1500000000,1500000000
109696268283,1641904833,318502,111000000000,318502,111000000000,1500000000,1303731717
155837004971,1641919660,67634,157337004971,62834,172076796930,1500000000,1500000000
52717304716,1645326890,329244,54217304716,329244,74134585702,1500000000,1500000000
54372274938,1649439843,60950,57000000000,56150,,,
181969176504,1641887248,54812,183469176504,54812,193824066697,1500000000,1500000000
125393089297,1641909069,60850,126893089297,56050,143061090037,1500000000,1500000000
125393089297,1641909069,336883,126893089297,336883,127334268890,1500000000,1500000000
53443849234,1645371454,56592,54943849234,51792,89950466070,1500000000,1500000000
101343150101,1648831993,67646,102843150101,62846,110726612845,1500000000,1500000000
45292325526,1649441073,60838,46792325526,60838,63543463248,1500000000,1500000000
205800216008,1641935335,55592,207300216008,55592,214604292673,1500000000,1500000000
54793229053,1648839949,55720,56293229053,50920,71636012027,1500000000,1500000000
41610905456,1649414249,340073,42517226064,340073,42517226064,1500000000,906320608
266497520171,1641859516,60850,267997520171,60850,330197363904,1500000000,1500000000
47649080633,1645365123,54760,49849080633,49960,66000000000,2200000000,2200000000
36922527569,1649392822,67634,38422527569,62834,49715796313,1500000000,1500000000
36922527569,1649392822,55717,38922527569,50917,53977174002,2000000000,2000000000
186588333710,1641930610,54825,188088333710,50025,267580387132,1500000000,1500000000
206325884253,1641923838,54969,207825884253,50169,254018877067,1500000000,1500000000
48276311231,1648814621,316662,49776311231,316662,50109017192,1500000000,1500000000
48538513450,1646782666,331169,50038513450,331169,72885892665,1500000000,1500000000
28373489058,1646770663,328002,30144074678,328002,37412359572,1770585620,1770585620
37629697392,1649392866,67722,39129697392,62922,44126661705,1500000000,1500000000
77400489681,1649380137,65530,78900489681,60730,97383894640,1500000000,1500000000
158270055466,1641933106,67658,159770055466,62858,183778861133,1500000000,1500000000
165020306033,1641941578,54872,167520306033,54872,338337155636,2500000000,2500000000
200175411985,1641934851,55608,201675411985,50808,230159492264,1500000000,1500000000
223623230982,1641928850,67646,225123230982,62846,329796070517,1500000000,1500000000
45453833479,1645391755,319670,46953833479,319670,52005219390,1500000000,1500000000
24178431567,1646714082,67634,25678431567,62834,27746016480,1500000000,1500000000
19170723905,1646730206,60850,20670723905,60850,21753402050,1500000000,1500000000
133831293529,1641861931,54969,135331293529,50169,182704037399,1500000000,1500000000
164531250218,1641931178,60838,166031250218,60838,195902714759,1500000000,1500000000
18060243499,1646717993,67658,45000000000,62858,,,
47352820669,1649389211,60862,49352820669,56062,67036606713,2000000000,2000000000
225710022206,1641930566,60018,227210022206,55218,314893075065,1500000000,1500000000
73921112380,1649444319,49583,75421112380,44783,105286511298,1500000000,1500000000
37534435863,1649406143,67634,39034435863,62834,50691825823,1500000000,1500000000
31970541068,1649402938,49507,33470541068,49507,42696822572,1500000000,1500000000
81886847900,1649439148,60862,83386847900,56062,94184104929,1500000000,1500000000
211384134340,1641869256,53524,213384134340,48724,293463936983,2000000000,2000000000
34415095580,1649418043,60938,35915095580,60938,46221260379,1500000000,1500000000
216477219107,1641867726,54969,217977219107,50169,275794032899,1500000000,1500000000
46876597445,1646778536,60838,47912510392,56038,47933877897,1035912947,1035912947
58443122407,1646775778,67634,59943122407,67634,75343387128,1500000000,1500000000
20069210286,1646726753,304630,21569210286,304630,24967471374,1500000000,1500000000
93229933786,1649378571,66742,94729933786,66742,134381314579,1500000000,1500000000
76941754579,1649382839,60862,78441754579,56062,97620257292,1500000000,1500000000
156829299668,1641893729,330026,158329299668,330026,181942462835,1500000000,1500000000
106753447517,1649376255,63200,108253447517,63200,192732865738,1500000000,1500000000
33134060755,1646749224,60850,34634060755,60850,38317154655,1500000000,1500000000
59524302048,1649430892,67634,61024302048,62834,75113830318,1500000000,1500000000
124740615791,1648827792,60850,126240615791,56050,127940775518,1500000000,1500000000
43888188588,1649398266,60850,45388188588,56050,48851172508,1500000000,1500000000
180171161318,1641919811,60850,181671161318,56050,194714504175,1500000000,1500000000
166763272610,1648832839,66814,168263272610,62014,218039560769,1500000000,1500000000
21116451653,1646733169,334336,22616451653,334336,33323520300,1500000000,1500000000
35944342479,1649394271,55717,37594342479,50917,47910740416,1650000000,1650000000
35704731018,1649387286,67634,37204731018,67634,47847742478,1500000000,1500000000
54712367476,1649380671,49469,56212367476,44669,64750152079,1500000000,1500000000
30577930760,1649399524,65530,32077930760,60730,48658953789,1500000000,1500000000
98358046811,1649439232,60950,100358046811,56150,108452902270,2000000000,2000000000
49973431373,1649425851,63200,51473431373,63200,106277847810,1500000000,1500000000
141335526527,1641865094,60862,149059649550,56062,,,
34228176829,1649423507,316580,35728176829,316580,52522617784,1500000000,1500000000
31911491027,1649399642,332414,33411491027,332414,45224242452,1500000000,1500000000
36537289791,1649447822,67722,38037289791,62922,61820631077,1500000000,1500000000
34287908308,1649392760,55717,35787908308,50917,48458229875,1500000000,1500000000
42332535838,1649423811,49507,43832535838,44707,65836710650,1500000000,1500000000
172574795859,1641924294,55620,174074795859,50820,216644552415,1500000000,1500000000
71272999856,1649443216,60838,72772999856,56038,100311812693,1500000000,1500000000
52108831562,1649405688,67634,53608831562,62834,73741360854,1500000000,1500000000
82301972498,1648822179,67634,84301972498,62834,97447230911,2000000000,2000000000
21425973406,1646743132,67646,22925973406,62846,28969831992,1500000000,1500000000
23318592142,1646734662,330527,24818592142,330527,27397796173,1500000000,1500000000
40956372518,1646747905,60850,42456372518,60850,52638530374,1500000000,1500000000
25503845919,1646749005,60850,27003845919,60850,32529026542,1500000000,1500000000
24669913560,1646730600,307676,26169913560,307676,30462517192,1500000000,1500000000
59959505775,1649424430,295289,61459505775,295289,82455661415,1500000000,1500000000
47311404012,1649457737,55668,48811404012,50868,64968844738,1500000000,1500000000
47311404012,1649457737,67722,48811404012,62922,64968844738,1500000000,1500000000
49582888738,1649389466,327363,51082888738,238689,65456947845,1500000000,1500000000
49582888738,1649389466,327363,51082888738,327363,72876154039,1500000000,1500000000
209188857145,1641918203,340081,210688857145,340081,280407598632,1500000000,1500000000
28884473932,1646764021,60862,30384473932,56062,31102585854,1500000000,1500000000
32171033737,1646768261,60850,33671033737,56050,38458844039,1500000000,1500000000
106395579159,1649378222,55717,114384444139,50917,,,
42586874502,1649388340,60838,44086874502,56038,48819863743,1500000000,1500000000
45069255278,1645360258,322850,47069255278,322850,72652430674,2000000000,2000000000
28211720534,1648817547,327411,29711720534,327411,33500046040,1500000000,1500000000
33152871255,1646765935,67646,35152871255,62846,100000000000,2000000000,2000000000
186273118241,1641917470,55592,188273118241,50792,285032938090,2000000000,2000000000
234110406424,1641930027,60850,235610406424,60850,252278871254,1500000000,1500000000
59925422319,1648776777,324814,61425422319,324814,67239455318,1500000000,1500000000
40069505738,1646712627,67646,41569505738,62846,47729025383,1500000000,1500000000
39827603013,1646757090,55580,41327603013,50780,59777934312,1500000000,1500000000
31274848902,1646752707,64056,32774848902,59256,42949236950,1500000000,1500000000
96524803007,1649382825,67646,97620257292,62846,97620257292,1500000000,1095454285
76675608014,1649420500,59982,77689746165,55182,77689746165,1500000000,1014138151
207205713048,1641924255,60850,208705713048,56050,224549916912,1500000000,1500000000
139009347715,1641877076,67634,140509347715,62834,225343952777,1500000000,1500000000
40326436271,1646708163,328008,41505999360,328008,41505999360,1500000000,1179563089
37744863783,1649453831,55592,39244863783,50792,51000000000,1500000000,1500000000
27988666224,1648781343,66778,29276466224,66778,32000000000,1287800000,1287800000
34909940739,1649401319,315322,36409940739,315322,48276404845,1500000000,1500000000
295606016164,1641925714,52916,297106016164,48116,309826519103,1500000000,1500000000
216669322136,1641932685,60874,218169322136,56074,289606013195,1500000000,1500000000
37974364609,1649415342,62139,39474364609,57339,42022251889,1500000000,1500000000
164416334603,1649377542,55636,165916334603,50836,173915032039,1500000000,1500000000
42755596646,1649402548,64717,44255596646,64717,59982735723,1500000000,1500000000
217683520555,1641930981,60862,219183520555,56062,248736008639,1500000000,1500000000
48714940793,1645341977,332422,49714940793,332422,54786026151,1000000000,1000000000
40881983694,1648801961,311001,42381983694,311001,55409422963,1500000000,1500000000
48196822804,1646782810,67646,49696822804,62846,56726950015,1500000000,1500000000
46726733432,1649406323,64741,48049164575,59941,50710356124,1322431143,1322431143
233116217576,1641917740,60862,235116217576,56062,297105880255,2000000000,2000000000
43740368361,1645326612,333115,45240368361,333115,56342805733,1500000000,1500000000
40795525069,1648806699,49595,42295525069,44795,43457125442,1500000000,1500000000
31378907355,1646751489,64056,32878907355,59256,56527201939,1500000000,1500000000
63860709606,1649435025,48627,65360709606,48627,88463966972,1500000000,1500000000
45919651052,1649426434,67634,47419651052,67634,52107145792,1500000000,1500000000
46405801179,1649428962,55592,47905801179,50792,59667392607,1500000000,1500000000
171429773072,1641868849,60838,172929773072,60838,203032529908,1500000000,1500000000
32238585217,1649453948,60850,33413585217,56050,34220884412,1175000000,1175000000
180906348822,1641910396,54884,182406348822,50084,225960246329,1500000000,1500000000
228897458685,1641943991,63200,231397458685,63200,409463538488,2500000000,2500000000
68540330325,1645375417,332424,70040330325,332424,80149167072,1500000000,1500000000
33030345153,1648807561,67634,40000000000,62834,40000000000,40000000000,6969654847
21358440010,1646735688,52928,22858440010,48128,28343778708,1500000000,1500000000
61967458623,1649443813,60850,63467458623,56050,79745142598,1500000000,1500000000
125884444288,1641896949,67622,127384444288,67622,159260477975,1500000000,1500000000
164652387910,1641928042,327357,166152387910,327357,234057329899,1500000000,1500000000
189708271059,1641920287,55580,191208271059,50780,196312629990,1500000000,1500000000
78498765506,1648848206,60850,79998765506,56050,91682599710,1500000000,1500000000
51729995734,1648771669,66730,53229995734,66730,54425761088,1500000000,1500000000
15398583052,1646745871,64729,16898583052,59929,29816971590,1500000000,1500000000
56924536769,1649421723,60938,59000000000,56138,,,
147786182484,1641894588,340063,149286182484,340063,165329186965,1500000000,1500000000
111399120632,1641884478,67646,113339120632,62846,151948019782,1940000000,1940000000
16690138336,1646737443,54664,18190138336,49864,23000000000,1500000000,1500000000
77919846934,1649378924,60862,79419846934,56062,98281154413,1500000000,1500000000
131248230934,1641884790,55781,132814218304,50981,162403823972,1565987370,1565987370
157940490048,1641880642,60850,159440490048,60850,211105159629,1500000000,1500000000
65451534895,1645375806,54739,66951534895,49939,79442077145,1500000000,1500000000
55798148928,1645401198,323545,57298148928,323545,62312988182,1500000000,1500000000
55798148928,1645401198,332654,57298148928,332654,78734263508,1500000000,1500000000
54531466034,1648823124,55720,56031466034,50920,58327251679,1500000000,1500000000
82914924432,1648826266,312940,84414924432,312940,111244991260,1500000000,1500000000
37033360782,1648789797,48591,38533360782,48591,51660259587,1500000000,1500000000
49606352979,1646700806,60862,51106352979,56062,64015568558,1500000000,1500000000
25161162246,1646765355,60850,26661162246,60850,33794986950,1500000000,1500000000
50620098504,1649427951,320787,52120098504,320787,71190834329,1500000000,1500000000
61390265557,1649384308,64741,73390265557,59941,388000000000,12000000000,12000000000
189394675716,1641937191,54759,190894675716,54759,261029327670,1500000000,1500000000
38939850412,1648800957,55592,40439850412,55592,45239682535,1500000000,1500000000
38939850412,1648800957,309187,40439850412,292087,200000000000,1500000000,1500000000
37328348668,1649399176,55717,38828348668,50917,46725086569,1500000000,1500000000
45883154911,1649431836,328853,47383154911,328853,57451232822,1500000000,1500000000
27072648229,1646753239,60938,28572648229,56138,33529623422,1500000000,1500000000
27072648229,1646753239,64705,28572648229,59905,37639234479,1500000000,1500000000
47963005570,1649393336,67634,49463005570,67634,63757794639,1500000000,1500000000
39612043840,1649429328,60874,41112043840,56074,48026335103,1500000000,1500000000
386614379243,1641921015,54095,391614379243,49295,462180941669,5000000000,5000000000
147354851613,1641910542,313457,148854851613,313457,170607102749,1500000000,1500000000
42455662442,1649403562,64705,43955662442,59905,54543811144,1500000000,1500000000
41157734165,1649422446,49483,42657734165,44683,51273552272,1500000000,1500000000
147254631498,1641872206,55592,148754631498,50792,189133097915,1500000000,1500000000
38429702609,1648803281,67634,39929702609,67634,44604487462,1500000000,1500000000
20127287849,1646705504,67646,21627287849,62846,32674104078,1500000000,1500000000
155907462413,1641924691,54824,157407462413,50024,223876006242,1500000000,1500000000
83513517716,1646758919,67646,85013517716,62846,120241902490,1500000000,1500000000
58801547656,1649434762,66826,60301547656,66826,76179667674,1500000000,1500000000
88073545091,1649439283,49483,89573545091,44683,124447558514,1500000000,1500000000
75154124386,1649382664,56492,76654124386,51692,85007356742,1500000000,1500000000
50822588479,1649461538,55580,52313487792,55580,52313487792,1500000000,1490899313
205390463931,1641869497,49469,207390463931,44669,282077998147,2000000000,2000000000
62007838579,1645330547,329298,63507838579,329298,70406826330,1500000000,1500000000
54575353004,1649384284,64741,57075353004,59941,200000000000,2500000000,2500000000
43143048987,1646711380,328006,44643048987,328006,56022879505,1500000000,1500000000
62631220305,1646774742,67646,64131220305,62846,80271226567,1500000000,1500000000
35159694711,1649399751,63200,36659694711,63200,68483372116,1500000000,1500000000
206546241726,1641879733,67646,208046241726,62846,251268041700,1500000000,1500000000
25844192238,1646755771,60850,27029561370,60850,27029561370,1500000000,1185369132
34921116909,1649417102,66790,36921116909,61990,49099389162,2000000000,2000000000
32859052094,1649402638,67634,37000000000,62834,,,
59857194084,1649442308,60838,61357194084,60838,77509162299,1500000000,1500000000
32908449169,1649399433,60850,34408449169,56050,53860359350,1500000000,1500000000
38637316556,1649402789,67722,40637316556,67722,46323342788,2000000000,2000000000
36273017474,1649457885,317312,37773017474,317312,57231960818,1500000000,1500000000
49142418831,1649390698,55660,59142418831,50860,200000000000,10000000000,10000000000
258408841530,1641921824,64741,259908841530,59941,363304927538,1500000000,1500000000
185896529538,1641936819,55592,187396529538,50792,219027792373,1500000000,1500000000
47346190201,1646775363,327970,48846190201,327970,70327268642,1500000000,1500000000
32750355194,1649401310,315318,34250355194,315318,48276404845,1500000000,1500000000
129582243656,1641876607,60862,131082243656,56062,136237399700,1500000000,1500000000
182122149305,1641876767,60862,183622149305,56062,249899507444,1500000000,1500000000
42092290078,1646783209,64056,43287050282,59256,48906227044,1194760204,1194760204
31574192701,1646744600,60838,33074192701,60838,37264933528,1500000000,1500000000
57532071182,1649443730,60850,59032071182,56050,64092519918,1500000000,1500000000
58635916543,1649445639,67646,60135916543,62846,69146869038,1500000000,1500000000
35916063401,1648800915,67634,37416063401,67634,48199443669,1500000000,1500000000
104093519976,1649377938,67646,105593519976,62846,120010131127,1500000000,1500000000
44772612280,1649442047,303385,46272612280,303385,55620059745,1500000000,1500000000
65819357765,1649382303,67734,67319357765,62934,86228925779,1500000000,1500000000
44834938590,1648793952,60862,46334938590,56062,49180974325,1500000000,1500000000
19020384433,1646740684,67634,20520384433,62834,28046083752,1500000000,1500000000
61277717044,1649404607,64705,62777717044,59905,78565226187,1500000000,1500000000
46132614335,1649393558,60850,47632614335,56050,56114927174,1500000000,1500000000
49412732834,1649441132,67722,50912732834,62922,63307805742,1500000000,1500000000
92764266052,1648784277,310932,94264266052,310932,104600168198,1500000000,1500000000
22973375827,1646755752,60850,24473375827,60850,25224367619,1500000000,1500000000
94242814764,1646781694,56516,96242814764,51716,101832476703,2000000000,2000000000
48757195796,1649436085,60938,50257195796,56138,56329728218,1500000000,1500000000
164226242578,1641868567,326129,166226242578,326129,231414043235,2000000000,2000000000
51641784900,1648799196,54332,59641784900,49532,400000000000,8000000000,8000000000
48351207416,1646757806,60838,49851207416,56038,59667207797,1500000000,1500000000
60257978504,1649457030,67646,61757978504,62846,92896262847,1500000000,1500000000
131648870229,1641873091,55592,133148870229,50792,151636673617,1500000000,1500000000
17705163375,1646729663,55592,19205163375,50792,23889618442,1500000000,1500000000
163194318199,1641944669,59946,168000000000,59946,,,
96329817435,1648840873,54921,97829817435,50121,101664752848,1500000000,1500000000
22239181695,1646725001,67634,23239181695,62834,24795548769,1000000000,1000000000
15557694994,1646722638,67634,17057694994,62834,22025690948,1500000000,1500000000
36274448834,1649400229,54346,38274448834,49546,51915244450,2000000000,2000000000
40538821651,1649400956,54861,50538821651,50061,200000000000,10000000000,10000000000
42046550627,1649414658,64705,44046550627,64705,53393816974,2000000000,2000000000
123089350589,1641898546,67634,124589350589,62834,161331789587,1500000000,1500000000
141937132770,1641893852,67622,143437132770,62822,179509705403,1500000000,1500000000
57793088683,1649405665,63200,59293088683,63200,108094008790,1500000000,1500000000
63508390978,1649412333,314067,65008390978,314067,78866718724,1500000000,1500000000
151781906725,1641859800,60862,153281906725,56062,227070618813,1500000000,1500000000
179616645132,1641927864,67634,181116645132,67634,253857331618,1500000000,1500000000
37602059076,1645342545,326765,39102059076,326765,40581676167,1500000000,1500000000
63436965612,1646698901,60850,64936965612,56050,69524993507,1500000000,1500000000
227103287524,1641917909,67646,228603287524,62846,253842351869,1500000000,1500000000
194770977793,1641864322,49507,196163315583,44707,196163315583,1500000000,1392337790
120957391247,1641904536,55592,122457391247,50792,172551913552,1500000000,1500000000
94069255754,1645366409,55680,95569255754,50880,146883506034,1500000000,1500000000
19722283027,1646730138,67646,21222283027,62846,23434530425,1500000000,1500000000
30310389583,1649402723,67634,32310389583,67634,44580284902,2000000000,2000000000
49881522101,1649436178,55592,51381522101,50792,73380560128,1500000000,1500000000
16881284264,1646755702,60850,18381284264,60850,28634891840,1500000000,1500000000
35327421276,1649419757,64741,45327421276,59941,200000000000,10000000000,10000000000
179475527900,1641927799,60018,180975527900,55218,236846008457,1500000000,1500000000
57752226735,1648855276,293281,59252226735,293281,72636847038,1500000000,1500000000
21152328603,1646746075,67634,22652328603,67634,30262035768,1500000000,1500000000
67516107235,1649451325,60862,69016107235,56062,97430682558,1500000000,1500000000
134579596977,1641904345,55580,136079596977,50780,164389543662,1500000000,1500000000
67965196608,1648846769,336883,83000000000,336883,,,
120234240544,1641871571,54676,121734240544,49876,177461020034,1500000000,1500000000
193535822541,1641922155,55592,195035822541,50792,281000000000,1500000000,1500000000
32870996843,1645341187,332591,34370996843,332591,35000000000,1500000000,1500000000
15744196532,1646724547,60862,17244196532,56062,23789288085,1500000000,1500000000
157853491027,1641871550,67634,159353491027,67634,186967072842,1500000000,1500000000
52161131465,1649428855,331171,53661131465,331171,63488772112,1500000000,1500000000
36109064619,1649418122,67646,37609064619,62846,49419669935,1500000000,1500000000
68123955277,1649439908,66766,69623955277,61966,77949276924,1500000000,1500000000
51924757400,1649405245,49495,53424757400,49495,57097041198,1500000000,1500000000
26870273883,1646755547,60850,28370273883,60850,35449682333,1500000000,1500000000
37251485102,1649408995,67634,38751485102,62834,46021731093,1500000000,1500000000
63762751547,1649455690,67622,65262751547,67622,70169659138,1500000000,1500000000
47687078023,1649389848,59982,49187078023,59982,73568278653,1500000000,1500000000
161949701430,1641931198,67634,163449701430,67634,217160988563,1500000000,1500000000
40153136591,1645361988,332373,41653136591,332373,46828242837,1500000000,1500000000
61795963261,1648785956,329403,63295963261,329403,63947962384,1500000000,1500000000
42798380412,1649389901,55705,44298380412,50905,59189572692,1500000000,1500000000
42798380412,1649389901,60862,44298380412,56062,59189572692,1500000000,1500000000
62303589174,1649460512,317322,63803589174,317322,77607910803,1500000000,1500000000
41299935482,1649381130,60862,42809935482,56062,65761200970,1510000000,1510000000
41824311203,1648821215,49595,43324311203,44795,62690279823,1500000000,1500000000
155705681930,1649377569,326050,157205681930,326050,190655859448,1500000000,1500000000
136395756057,1641934259,67646,137895756057,62846,174668244410,1500000000,1500000000
159550182985,1641869671,333690,161050182985,333690,209627062325,1500000000,1500000000
73900797340,1645372355,54748,75400797340,49948,92627434060,1500000000,1500000000
34401223488,1648823718,335116,35901223488,335116,55953167715,1500000000,1500000000
48502704484,1646754215,327990,50002704484,310890,57992898654,1500000000,1500000000
38914055047,1649415943,63188,40414055047,63188,70682171474,1500000000,1500000000
38914055047,1649415943,67722,40854055047,67722,45178857172,1940000000,1940000000
53595959730,1649383749,67634,55095959730,67634,75476670995,1500000000,1500000000
53595959730,1649383749,67646,55095959730,62846,80493527232,1500000000,1500000000
185887952876,1641922262,67634,187387952876,67634,204602007368,1500000000,1500000000
137174495985,1641899293,67646,139174495985,62846,145089772958,2000000000,2000000000
150798570282,1641894228,60862,152298570282,56062,155380215607,1500000000,1500000000
38027160603,1645393144,329306,39527160603,329306,40000000000,1500000000,1500000000
99427134747,1645378210,332333,100927134747,332333,103719589643,1500000000,1500000000
41300357557,1649429640,334280,42568462944,334280,42568462944,1500000000,1268105387
34463906617,1649401635,55705,35963906617,50905,45301058429,1500000000,1500000000
69284293234,1649436725,67634,70784293234,67634,102694531637,1500000000,1500000000
41291177670,1649420179,64741,53291177670,59941,388000000000,12000000000,12000000000
170276646867,1641898137,332559,171776646867,332559,193066023449,1500000000,1500000000
65299532424,1649443247,54760,67000000000,54760,67000000000,3000000000,1700467576
50499131065,1649379397,67646,52009131065,62846,67108554654,1510000000,1510000000
35522743302,1646712068,67646,37022743302,62846,48348598253,1500000000,1500000000
42608519393,1649391858,60850,44108519393,56050,45393575674,1500000000,1500000000
34596038032,1649401466,54873,36096038032,50073,46854064532,1500000000,1500000000
42543412873,1649386612,67646,44043412873,62846,62490353613,1500000000,1500000000
39915741408,1649410326,60938,41415741408,60938,52219673028,1500000000,1500000000
214288049753,1641937177,54969,215788049753,50169,223073312347,1500000000,1500000000
35046794190,1646708498,60850,36546794190,56050,42237458380,1500000000,1500000000
21010047982,1646746099,64705,22510047982,59905,29891298082,1500000000,1500000000
46031786857,1649437579,67710,47531786857,58110,58983509405,1500000000,1500000000
227997539944,1641938912,316738,229497539944,316738,230338472147,1500000000,1500000000
256069518049,1641921229,60018,257575428499,55218,328688813168,1505910450,1505910450
19055642331,1646743195,67646,20555642331,62846,28107457389,1500000000,1500000000
44949680267,1649402022,67634,46449680267,67634,54103259887,1500000000,1500000000
206411015253,1641937058,64741,207911015253,59941,261130209627,1500000000,1500000000
74982327178,1648825782,48615,76482327178,43815,92348277280,1500000000,1500000000
19841790220,1646729630,67646,21341790220,67646,22230916490,1500000000,1500000000
39173917864,1649394831,63200,40673917864,63200,71146869192,1500000000,1500000000
51491422852,1649428987,67658,52991422852,62858,59507251474,1500000000,1500000000
53368341234,1649389735,55580,54868341234,50780,61404327964,1500000000,1500000000
256501297814,1641922084,55592,258001297814,50792,310722704294,1500000000,1500000000
31336670140,1646768619,60862,32836670140,56062,36593010163,1500000000,1500000000
61689918820,1649380467,314146,63189918820,297046,78281830463,1500000000,1500000000
61689918820,1649380467,317364,63189918820,300264,78281830463,1500000000,1500000000
61689918820,1649380467,317336,63189918820,317336,78281830463,1500000000,1500000000
33484497281,1649397573,56492,34984497281,51692,44464753833,1500000000,1500000000
36241763715,1649416181,55693,38241763715,50893,51259164516,2000000000,2000000000
56534231493,1649389325,67646,58034231493,62846,61702732024,1500000000,1500000000
42149136572,1648813386,67646,43649136572,62846,49359295884,1500000000,1500000000
26557365456,1646749155,60850,28057365456,60850,39243250639,1500000000,1500000000
34448572731,1649392588,67634,35948572731,67634,57212719662,1500000000,1500000000
39205821253,1649429435,67634,40705821253,62834,55035120419,1500000000,1500000000
46079441948,1649433532,67646,46655846810,62846,46655846810,1500000000,576404862
136427988303,1641906537,326731,137927988303,326731,169124717764,1500000000,1500000000
25082952813,1646728855,60850,26582952813,56050,28484388979,1500000000,1500000000
45595278322,1649386668,54933,47155278322,50133,200000000000,1560000000,1560000000
67559106899,1649443991,67646,69059106899,62846,97452108930,1500000000,1500000000
32402317130,1649396012,55596,33902317130,50796,45444241383,1500000000,1500000000
38826251116,1649395031,60850,40326251116,56050,43112999690,1500000000,1500000000
71400783290,1649379066,67634,72900783290,62834,96240914557,1500000000,1500000000
31569560049,1646752610,321666,33069560049,321666,35000000000,1500000000,1500000000
58391530497,1649432421,333708,67189864784,333708,,,
48871036589,1649458548,60862,50488003429,60862,66931792208,1616966840,1616966840
51240252124,1649389880,55828,52740252124,51028,61108847529,1500000000,1500000000
158612130404,1641898683,60850,160112130404,56050,195518789748,1500000000,1500000000
206944321012,1641924585,329431,208444321012,329431,241066944518,1500000000,1500000000
18576972570,1646719100,60938,20000000000,60938,20000000000,1500000000,1423027430
40961748495,1649392029,60938,42461748495,56138,48072555620,1500000000,1500000000
68695172059,1649435068,67646,70195172059,67646,87112623219,1500000000,1500000000
150821033512,1641874836,309698,151679738840,309698,151679738840,1500000000,858705328
52325657320,1648794428,326072,53183693728,326072,53183693728,1500000000,858036408
27197319343,1646747257,60838,28697319343,56038,31849897492,1500000000,1500000000
22889930630,1646765244,60850,24389930630,60850,29676049423,1500000000,1500000000
50248307918,1649425672,67634,51748307918,62834,60651208803,1500000000,1500000000
166973852843,1641931808,64741,168473852843,59941,213284422108,1500000000,1500000000
129309881936,1641941917,59946,150000000000,59946,,,
55271580019,1645330835,66718,56771580019,66718,85770740843,1500000000,1500000000
132399401917,1648834505,60862,133899401917,56062,156347665614,1500000000,1500000000
44897144860,1649393917,67658,46397144860,62858,57055740056,1500000000,1500000000
63152169395,1648855197,313457,64652169395,313457,96411039973,1500000000,1500000000
62868600562,1648839905,60850,64368600562,56050,78386565639,1500000000,1500000000
37242547610,1646749266,60850,38742547610,60850,42917575944,1500000000,1500000000
37242547610,1646749266,60850,38317154655,60850,38317154655,1500000000,1074607045
37242547610,1646749266,99696,70242547610,99063,1888000000000,33000000000,33000000000
150644981741,1641873224,60850,152144981741,56050,162829907640,1500000000,1500000000
48349568653,1648797660,55592,49849568653,50792,62410033799,1500000000,1500000000
15508688655,1646737586,67646,17221036426,62846,23226147976,1712347771,1712347771
31537984760,1646755358,60850,33037984760,60850,35730789650,1500000000,1500000000
40107937806,1649396505,67634,41607937806,67634,45015375677,1500000000,1500000000
52081335982,1645326851,48615,54081335982,48615,73539582827,2000000000,2000000000
47327955267,1648849284,55592,48827955267,50792,63837407633,1500000000,1500000000
57520144043,1648823055,327383,59020144043,327383,66392248824,1500000000,1500000000
198714436090,1641932949,55592,200214436090,55592,226209321614,1500000000,1500000000
51280545286,1649428629,60950,58000000000,56150,,,
37492240662,1649422775,67634,38992240662,67634,51862345573,1500000000,1500000000
51142895166,1649443693,49559,52642895166,49559,64092519918,1500000000,1500000000
19947488632,1646735106,55592,21447488632,50792,25787941510,1500000000,1500000000
59684063436,1649381510,49469,61184063436,44669,65077279484,1500000000,1500000000
164607462121,1641865343,67634,166107462121,62834,250462555915,1500000000,1500000000
215169194798,1649376812,67622,216669194798,67622,304639912229,1500000000,1500000000
53494205617,1649384442,64741,58494205617,59941,200000000000,5000000000,5000000000
34300558817,1649410695,55592,35800558817,55592,50000000000,1500000000,1500000000
16759674451,1646739925,310920,18259674451,310920,22483980505,1500000000,1500000000
49654077863,1649391438,67646,51154077863,62846,70027414328,1500000000,1500000000
67582394320,1649460503,60862,69082394320,56062,77607910803,1500000000,1500000000
56434924334,1649427989,322884,58434924334,322884,65266071967,2000000000,2000000000
60881071376,1646778103,55592,61881071376,45992,78052605961,1000000000,1000000000
49657137516,1649390678,54332,61657137516,49532,388000000000,12000000000,12000000000
71558722258,1648838474,56492,73058722258,51692,89443062818,1500000000,1500000000
26352982231,1646750032,55592,27852982231,50792,31172608400,1500000000,1500000000
58144278550,1649450424,67634,60084278550,62834,69433773304,1940000000,1940000000
56696113914,1649446949,60850,58196113914,56050,79789003625,1500000000,1500000000
168825704233,1641931983,67634,170242664808,67634,215086992495,1416960575,1416960575
16893091453,1646736323,67646,18393091453,62846,26341346537,1500000000,1500000000
30277665242,1646721591,55584,31407894374,50784,31407894374,1500000000,1130229132
23432223367,1646729184,54748,24932223367,49948,29291004044,1500000000,1500000000
39580582177,1646704115,324186,41080582177,324186,42328099143,1500000000,1500000000
60912553159,1649388017,63200,62412553159,63200,113179870430,1500000000,1500000000
48445142635,1649424050,67634,49945142635,62834,59924676615,1500000000,1500000000
34648922310,1649407480,63200,36148922310,63200,56268233148,1500000000,1500000000
152385782702,1641868814,55644,154885782702,55644,324952047852,2500000000,2500000000
103507466504,1641899846,340063,105007466504,340063,135135563259,1500000000,1500000000
183505883970,1641934470,60850,185005883970,60850,219054289332,1500000000,1500000000
95373484663,1648835150,55580,96873484663,50780,114500021758,1500000000,1500000000
42268056179,1649420162,59958,42560694617,59958,42560694617,1500000000,292638438
65689843283,1648841430,56492,67189843283,51692,75533411064,1500000000,1500000000
50310483548,1648771834,60850,51810483548,60850,65702545704,1500000000,1500000000
55113187589,1646754947,330539,56613187589,330539,57999904063,1500000000,1500000000
180456495050,1641859769,67646,181956495050,62846,233215088513,1500000000,1500000000
63432803307,1646756764,67634,64932803307,62834,80906201315,1500000000,1500000000
19031279235,1646738769,67622,20531279235,67622,20899243069,1500000000,1500000000
45748795322,1646782754,314152,47248795322,314152,78276884210,1500000000,1500000000
47732630959,1649434497,60838,49232630959,60838,58559161909,1500000000,1500000000
133527259514,1641873444,67646,135027259514,62846,158495521258,1500000000,1500000000
33799115921,1648801228,60850,35799115921,60850,46749262193,2000000000,2000000000
47923462371,1649389625,55705,49423462371,50905,69876212189,1500000000,1500000000
47923462371,1649389625,67634,49923462371,67634,68920315507,2000000000,2000000000
85096544745,1649456315,299469,86596544745,299469,100911280730,1500000000,1500000000
185150178202,1649376479,67634,186650178202,62834,227071381535,1500000000,1500000000
55820265823,1645354066,60006,57320265823,55206,60910167697,1500000000,1500000000
43336085373,1648817151,60850,45336085373,56050,52080104138,2000000000,2000000000
44182896790,1646764851,67622,45682896790,67622,58156063823,1500000000,1500000000
47795106745,1649426313,63200,49295106745,63200,86475996070,1500000000,1500000000
40575080342,1649390337,64741,42075080342,59941,57247674955,1500000000,1500000000
36683277250,1649417809,59994,38183277250,55194,55210542678,1500000000,1500000000
215444613959,1641869481,67634,216944613959,62834,231956806472,1500000000,1500000000
71585928960,1649380496,49445,73085928960,44645,78612398525,1500000000,1500000000
127583432303,1641912032,60862,129083432303,56062,178105285120,1500000000,1500000000
42666654430,1648816820,66814,44166654430,62014,52220559668,1500000000,1500000000
32405695152,1649398730,67646,33905695152,62846,45422911532,1500000000,1500000000
34967765014,1649401000,67634,36967765014,67634,48846744991,2000000000,2000000000
134493956568,1641931956,326099,136044956568,326099,141000000000,1551000000,1551000000
132002697443,1648844438,54332,134002697443,49532,160926574872,2000000000,2000000000
54135011888,1646776254,67646,55635011888,62846,72946126798,1500000000,1500000000
69949429693,1649451662,337464,71449429693,337464,78328652190,1500000000,1500000000
35664860769,1649409043,60850,37228806493,56050,37228806493,2000000000,1563945724
101273247133,1648830261,67634,102773247133,67634,131381609397,1500000000,1500000000
41868880288,1649410166,55580,43368880288,50780,51921326865,1500000000,1500000000
156330512214,1649377733,49445,157830512214,44645,172505582483,1500000000,1500000000
48088351703,1649404226,63200,49588351703,63200,94970856710,1500000000,1500000000
132379804909,1641913910,60862,133879804909,56062,173562149749,1500000000,1500000000
113554681755,1648857445,63200,115054681755,63200,181738961686,1500000000,1500000000
81750846049,1649432331,55720,83350394296,50920,200000000000,1599548247,1599548247
110403212365,1649377816,56492,111903212365,56492,156090755519,1500000000,1500000000
51942204675,1645394007,54813,53442204675,50013,69538745117,1500000000,1500000000
57905647458,1648795280,55580,59405647458,55580,60152452489,1500000000,1500000000
46434615501,1649394020,60862,47934615501,60862,53858375012,1500000000,1500000000
140992524093,1641875753,67634,142492524093,62834,158168733012,1500000000,1500000000
222642226551,1641935418,54920,224142226551,50120,257730706262,1500000000,1500000000
222642226551,1641935418,49445,224642226551,44645,268479934512,2000000000,2000000000
55583469654,1649430577,316606,57083469654,316606,57557632147,1500000000,1500000000
39885775652,1649397219,60850,41385775652,60850,50072501276,1500000000,1500000000
39838228581,1649419123,340059,41338228581,340059,56290064835,1500000000,1500000000
39838228581,1649419123,60018,41338228581,60018,58836233529,1500000000,1500000000
172338926202,1641932175,343237,173838926202,343237,197144448527,1500000000,1500000000
157022467892,1641906328,67646,158522467892,62846,179497690727,1500000000,1500000000
81068697662,1648776474,319735,82568697662,319735,92287039307,1500000000,1500000000
48508222665,1649405019,67622,50008222665,62822,64698753893,1500000000,1500000000
58517354764,1649388554,63200,60017354764,63200,94827354534,1500000000,1500000000
132112487853,1641941903,316620,133612487853,316620,150000000000,1500000000,1500000000
132112487853,1641941903,67646,133612487853,62846,153955494437,1500000000,1500000000
125538019680,1641936055,60850,127038019680,56050,203055686200,1500000000,1500000000
125009978985,1645376732,61248,126509978985,50880,139000000000,1500000000,1500000000
34139647378,1646742698,60862,35639647378,56062,38185553850,1500000000,1500000000
48294632681,1645359642,334306,49794632681,334306,66204490980,1500000000,1500000000
29542299328,1648793995,330571,31042299328,330571,35000000000,1500000000,1500000000
18789434149,1646729310,324722,20289434149,324722,26848385349,1500000000,1500000000
47889321843,1649400801,63200,49389321843,63200,97519830440,1500000000,1500000000
158955150312,1641927267,60838,160455150312,56038,240146734807,1500000000,1500000000
208774885519,1641867825,64741,210974885519,59941,333000000000,2200000000,2200000000
34189606168,1648803513,333690,35689606168,333690,38987972895,1500000000,1500000000
55538466640,1648785624,330567,57038466640,330567,70027033805,1500000000,1500000000
27248383399,1646755486,60850,28748383399,60850,35759615978,1500000000,1500000000
33414380434,1649395524,55592,35414380434,50792,46130248811,2000000000,2000000000
39164486293,1649390602,60850,40664486293,56050,52709011708,1500000000,1500000000
151161381825,1641919573,67634,152661381825,62834,254587900649,1500000000,1500000000
36656840544,1648802933,314186,38156840544,314186,56410349945,1500000000,1500000000
52790616000,1649432929,60850,54290616000,56050,57102593420,1500000000,1500000000
156845667240,1641862207,55580,158345667240,50780,188017567449,1500000000,1500000000
63910801513,1648776340,67722,65410801513,62922,81901695074,1500000000,1500000000
25205773128,1646713119,67646,26705773128,62846,42949987758,1500000000,1500000000
34329160541,1649398197,55717,35829160541,50917,40553165780,1500000000,1500000000
52539525999,1649429895,55705,54039525999,50905,64204524905,1500000000,1500000000
38580753605,1649393184,66766,40080753605,61966,48742981245,1500000000,1500000000
24059691363,1646729089,67634,25069791363,67634,37805192675,1010100000,1010100000
16698528597,1646741458,319773,18198528597,319773,20441231724,1500000000,1500000000
17224225928,1646726426,60850,18724225928,56050,26808360079,1500000000,1500000000
148858864715,1641860204,55580,150358864715,50780,178409585149,1500000000,1500000000
228255908918,1641868745,55592,229755908918,50792,322825500447,1500000000,1500000000
118532829188,1645318218,347007,120032829188,347007,179697479408,1500000000,1500000000
49461742647,1645390885,331935,50961742647,331935,69341825093,1500000000,1500000000
73183907249,1649379105,49445,74683907249,44645,90750979113,1500000000,1500000000
132001775219,1641897177,55620,133501775219,50820,193120334520,1500000000,1500000000
51369113365,1645374358,54772,52269709584,49972,52269709584,2200000000,900596219
167861228766,1641941318,54771,169361228766,49971,176996891133,1500000000,1500000000
102340624731,1645366080,59946,103840624731,55146,109922508138,1500000000,1500000000
88028237793,1648820148,307114,89528237793,307114,107214531408,1500000000,1500000000
24872840421,1646765072,67622,26872840421,67622,100000000000,2000000000,2000000000
43340658668,1649392070,67646,44840658668,62846,52702185619,1500000000,1500000000
52276106490,1649450552,334358,53776106490,334358,54424587948,1500000000,1500000000
34483589969,1648803208,67634,35983589969,62834,37000000000,1500000000,1500000000
46353421737,1648779040,55705,46739198758,50905,46739198758,1500000000,385777021
46134906003,1648795976,67646,47634906003,62846,57467615698,1500000000,1500000000
89697485183,1648836722,49495,91197485183,49495,111311476044,1500000000,1500000000
18292143126,1646717920,55693,19792143126,50893,24978960208,1500000000,1500000000
183551171650,1641937270,67622,185051171650,67622,205452533195,1500000000,1500000000
111275968721,1641900371,60862,118351388350,56062,,,
51165558276,1649389124,54908,52665558276,50108,67713949388,1500000000,1500000000
108406254012,1641915297,337514,110000000000,337514,110000000000,1650000000,1593745988
120483715815,1641885829,320372,122148066298,320372,125000000000,1664350483,1664350483
120483715815,1641885829,322949,122148066298,322949,125000000000,1664350483,1664350483
120483715815,1641885829,319895,122148066298,319895,125000000000,1664350483,1664350483
172914305686,1641935848,67622,174449396209,62822,175069578256,1535090523,1535090523
22781966780,1646743433,67646,24281966780,62846,35065826773,1500000000,1500000000
20204380998,1646722299,60862,21704380998,56062,25930023155,1500000000,1500000000
22540093115,1646705232,67634,24040093115,67634,30775005828,1500000000,1500000000
46202589412,1649389393,60838,47702589412,56038,56791728064,1500000000,1500000000
126861114362,1641900008,67634,128361114362,67634,157131416142,1500000000,1500000000
49509586759,1645389310,59994,51009586759,55194,61590320700,1500000000,1500000000
72629631445,1648776449,310297,74129631445,310297,83163411244,1500000000,1500000000
70113497892,1649439816,60838,71613497892,56038,93121753709,1500000000,1500000000
45047327062,1649420203,63933,46547327062,59133,200000000000,1500000000,1500000000
102470631796,1649378243,67646,103970631796,62846,134494473949,1500000000,1500000000
331716232523,1641921620,67646,333216232523,62846,366458697292,1500000000,1500000000
199007928853,1641920098,67634,200507928853,62834,248021637465,1500000000,1500000000
35846364191,1648814031,67646,37346364191,62846,49373579390,1500000000,1500000000
54600150124,1646782705,327375,56100150124,327375,62173141813,1500000000,1500000000
41891936010,1646749304,60850,42917575944,56050,42917575944,1500000000,1025639934
65690554256,1649424331,67634,67190554256,67634,68761076134,1500000000,1500000000
50323419957,1649421438,60850,51823419957,56050,69316502967,1500000000,1500000000
63772328782,1649379799,60850,64772328782,56050,65457846551,1000000000,1000000000
58531563147,1645374264,339440,60031563147,339440,81106447218,1500000000,1500000000
50572535518,1646756923,60850,52072535518,56050,71794338455,1500000000,1500000000
51704652218,1649391393,60850,53704652218,56050,61753909097,2000000000,2000000000
69740001159,1649383891,64729,71240001159,59929,94805989102,1500000000,1500000000
35490191280,1648803333,60850,36990191280,60850,52443944764,1500000000,1500000000
68199551823,1648823179,319371,69664332543,319371,69664332543,1500000000,1464780720
22150913850,1646716351,60862,23650913850,56062,28297730764,1500000000,1500000000
22150913850,1646716351,319909,25117874679,319909,,,
29485990694,1646706883,304542,30000000000,304542,30000000000,1500000000,514009306
20901557894,1646742464,60838,22401557894,56038,23041111410,1500000000,1500000000
28184002292,1646769342,60850,29684002292,56050,34048023699,1500000000,1500000000
17614773134,1646743566,60862,19114773134,56062,23910506592,1500000000,1500000000
33343898013,1649397432,67634,34863898013,67634,36000000000,1520000000,1520000000
58427958557,1649452094,67634,60427958557,62834,89535620860,2000000000,2000000000
264213821097,1641921869,55580,265713821097,50780,271000000000,1500000000,1500000000
231761727828,1641929281,60862,233261727828,56062,286515357983,1500000000,1500000000
144822581347,1641893965,54861,146322581347,50061,178921415963,1500000000,1500000000
40363275534,1645350297,67722,41863275534,67722,70859101229,1500000000,1500000000
138932348429,1641933057,67646,140432348429,62846,141000000000,1500000000,1500000000
145159643853,1641862214,67646,148159643853,62846,188017567449,3000000000,3000000000
186487045805,1641936594,64717,188487045805,59917,220225480312,2000000000,2000000000
97011403404,1648833793,64741,98511403404,59941,121204773394,1500000000,1500000000
31156208674,1648813662,67646,32656208674,62846,45657997610,1500000000,1500000000
26864296582,1646715744,60850,28364296582,56050,30931784907,1500000000,1500000000
42892243767,1646712536,60850,44392243767,60850,56750051330,1500000000,1500000000
56917870283,1649442115,63200,58417870283,63200,114812533206,1500000000,1500000000
156515064121,1649377611,55580,158015064121,50780,174526603734,1500000000,1500000000
58928485582,1645373195,321244,60428485582,321244,78359663150,1500000000,1500000000
78010136590,1648825879,67634,79510136590,62834,81682692370,1500000000,1500000000
21487954655,1646736619,60862,22987954655,56062,26345620740,1500000000,1500000000
21107472130,1646742292,55592,23107472130,50792,34745097018,2000000000,2000000000
51072274650,1649389330,60838,53072274650,60838,75494500941,2000000000,2000000000
41503208317,1649419666,63200,43003208317,63200,77761540910,1500000000,1500000000
50508702257,1649393951,56588,52008702257,51788,59370562559,1500000000,1500000000
73924406161,1649442511,60850,75424406161,56050,92394538772,1500000000,1500000000
37119098004,1649395647,53340,38619098004,53340,50940187712,1500000000,1500000000
37119098004,1649395647,66778,38619098004,61978,46237323587,1500000000,1500000000
37119098004,1649395647,67622,38619098004,67622,51827265212,1500000000,1500000000
135079311464,1641914297,60850,136579311464,56050,173419017767,1500000000,1500000000
176306541992,1641887948,67646,177806541992,62846,194772521263,1500000000,1500000000
164915490238,1641859722,55580,166415490238,55580,246091137909,1500000000,1500000000
164915490238,1641859722,337498,166415490238,337498,174092068244,1500000000,1500000000
196328479132,1641941782,60850,197828479132,56050,206610270834,1500000000,1500000000
127381307741,1641901952,340619,128881307741,340619,143038132725,1500000000,1500000000
28338262418,1646699665,60850,29838262418,56050,43836572278,1500000000,1500000000
36573144023,1646755411,60850,38073144023,60850,43215621869,1500000000,1500000000
51404358097,1649420671,63885,61404358097,59085,200000000000,10000000000,10000000000
44162185589,1645397421,55644,46662185589,55644,96579194100,2500000000,2500000000
36721792463,1648821544,67622,38221792463,67622,40000000000,1500000000,1500000000
35000875953,1646749464,122029,68000875953,122029,1888000000000,33000000000,33000000000
52884924725,1649389142,60862,54384924725,56062,71273961682,1500000000,1500000000
37107564870,1646751122,67634,38607564870,62834,50157332547,1500000000,1500000000
60806065260,1649456619,60838,62806065260,60838,112258297073,2000000000,2000000000
50191033477,1649421758,54759,51691033477,49959,67006128758,1500000000,1500000000
151509913820,1641877113,54860,153009913820,50060,175261684644,1500000000,1500000000
31506080369,1648810746,299574,33006080369,299574,45555209443,1500000000,1500000000
31506080369,1648810746,324226,33006080369,324226,45555209443,1500000000,1500000000
84894061298,1648835412,55720,86394061298,50920,200000000000,1500000000,1500000000
46944538330,1646754151,331129,48444538330,331129,56140410860,1500000000,1500000000
48346126616,1649433344,66766,49846126616,61966,60279596464,1500000000,1500000000
47717474861,1645358279,340611,49217474861,340611,74755003548,1500000000,1500000000
20725499145,1646725680,60850,21725499145,56050,24425325365,1000000000,1000000000
46762104117,1646704256,60850,48262104117,56050,51009302240,1500000000,1500000000
53659655790,1649445186,55680,55159655790,50880,88616611408,1500000000,1500000000
47728749130,1649381220,67646,49228749130,62846,53124919353,1500000000,1500000000
146541809482,1641897018,54897,148041809482,50097,300000000000,1500000000,1500000000
41232552653,1648802960,320998,42012542571,320998,,,
45205724618,1649422989,59946,47205724618,59946,55902879979,2000000000,2000000000
61176218280,1649437149,67634,62941416733,67634,,,
34391642973,1648801242,54921,35891642973,50121,100000000000,1500000000,1500000000
29453723724,1646749195,60850,30953723724,60850,38841323130,1500000000,1500000000
94642130945,1649444398,64729,96142130945,59929,113776841004,1500000000,1500000000
41972683142,1649386896,66778,43472683142,66778,45552281004,1500000000,1500000000
122692934449,1641905393,55592,124192934449,50792,137840825290,1500000000,1500000000
36393203724,1645332766,343825,37893203724,343825,56363398829,1500000000,1500000000
21083751197,1646742460,67634,22583751197,62834,23041111410,1500000000,1500000000
17110544839,1646726935,60926,18610544839,60926,28221107697,1500000000,1500000000
48572124616,1649431771,67622,50072124616,67622,63378395874,1500000000,1500000000
44627348983,1649393288,64056,46127348983,59256,54102238669,1500000000,1500000000
44627348983,1649393288,67622,46627348983,67622,56706328216,2000000000,2000000000
31377722303,1649403186,60862,32877722303,56062,40690359273,1500000000,1500000000
68599609454,1649445168,67646,70099609454,62846,96719448260,1500000000,1500000000
33444338596,1649406877,54332,36444338596,49532,55000000000,3000000000,3000000000
55273316506,1649426664,63200,56773316506,63200,107321549166,1500000000,1500000000
28228489467,1646714849,323697,29728489467,323697,29890747857,1500000000,1500000000
21365794985,1646719050,67646,22865794985,62846,25917342399,1500000000,1500000000
33915825498,1649395069,66754,35415825498,66754,45529105538,1500000000,1500000000
66090867890,1649439815,64705,67590867890,59905,73894862610,1500000000,1500000000
35388764987,1649404260,122939,36888764987,121945,59919285444,1500000000,1500000000
32645503049,1649401362,63200,34145503049,63200,65916877128,1500000000,1500000000
32645503049,1649401362,66742,82645503049,61942,90000000000,50000000000,50000000000
139471788141,1641915445,324806,140971788141,324806,207338714213,1500000000,1500000000
24115996296,1646765096,316704,25615996296,316704,30372901103,1500000000,1500000000
21933049487,1646742844,67634,26000000000,67634,,,
16411574744,1646717844,67658,17911574744,67658,21464835019,1500000000,1500000000
37780886018,1649392277,55717,39780886018,50917,56505786862,2000000000,2000000000
37780886018,1649392277,56516,47780886018,51716,200000000000,10000000000,10000000000
43134405814,1649405838,67634,44634405814,62834,47991181213,1500000000,1500000000
60308920606,1649430593,322884,61808920606,322884,63259705683,1500000000,1500000000
60308920606,1649430593,64741,70308920606,59941,200000000000,10000000000,10000000000
142287162853,1641884788,317242,143853150223,317242,162403823972,1565987370,1565987370
33247824435,1646753393,336863,34747824435,336863,38813529155,1500000000,1500000000
51962153724,1649441650,60938,53462153724,56138,56294711272,1500000000,1500000000
37558294814,1649398784,55717,39558294814,50917,44127403698,2000000000,2000000000
34864226813,1649396392,63200,36364226813,63200,75245802946,1500000000,1500000000
34864226813,1649396392,67634,37452527393,62834,,,
37574387111,1649420137,59958,39574387111,55158,44703122401,2000000000,2000000000
34326101643,1649399212,55705,35826101643,50905,40805060360,1500000000,1500000000
34326101643,1649399212,55717,44326101643,50917,200000000000,10000000000,10000000000
44147967789,1649438121,60862,45647967789,56062,62335479199,1500000000,1500000000
202751445628,1641863323,67634,204251445628,67634,235382878053,1500000000,1500000000
114433336572,1641907952,318669,138000000000,318669,,,
58686881102,1645394304,336841,60186881102,336841,74483481899,1500000000,1500000000
42240811335,1646754464,327994,43740811335,327994,45886925099,1500000000,1500000000
157514454072,1641935048,67646,159014454072,62846,199099476377,1500000000,1500000000
280301828343,1641921225,54095,282301828343,49295,342270218827,2000000000,2000000000
50077479483,1649452965,60862,51577479483,56062,58037501549,1500000000,1500000000
34263257379,1649399501,325142,35763257379,325142,44703811542,1500000000,1500000000
37758955510,1649403859,333495,39258955510,333495,49644675065,1500000000,1500000000
226566003117,1641939509,48627,228066003117,48627,261792566292,1500000000,1500000000
72464267247,1648840118,63200,73964267247,63200,134393637946,1500000000,1500000000
47054924989,1649441972,314146,48554924989,314146,62763595642,1500000000,1500000000
44863799637,1649419379,59958,46363799637,59958,55961175727,1500000000,1500000000
16619865522,1646737362,67646,18119865522,62846,20000000000,1500000000,1500000000
30194600511,1646749141,60850,31694600511,60850,35390959450,1500000000,1500000000
21502283826,1646738490,60862,23002283826,56062,30103692795,1500000000,1500000000
201579355972,1641932092,307746,203079355972,307746,247189229599,1500000000,1500000000
177323050505,1641926345,60838,178823050505,60838,232697728692,1500000000,1500000000
59231683245,1648788749,48603,60731683245,43803,64740299774,1500000000,1500000000
233763949862,1641868284,54676,235263949862,49876,315044338030,1500000000,1500000000
37640201755,1648821492,67646,39140201755,62846,47119900275,1500000000,1500000000
28168908057,1649399717,329455,29668908057,329455,30000000000,1500000000,1500000000
31873946945,1649409482,48747,33373946945,43947,43527938775,1500000000,1500000000
31873946945,1649409482,60926,33373946945,56126,43527938775,1500000000,1500000000
33122472027,1649394779,67634,34622472027,67634,51742742487,1500000000,1500000000
33122472027,1649394779,67622,34622472027,67622,51742742487,1500000000,1500000000
66805885393,1649382639,67646,68305885393,62846,76591198854,1500000000,1500000000
237952728832,1641921384,60850,239452728832,60850,275666728602,1500000000,1500000000
77698968180,1648822403,67646,79198968180,62846,107284348619,1500000000,1500000000
156922981650,1641925080,326137,158422981650,326137,159808453139,1500000000,1500000000
151579895387,1641862228,67622,153079895387,67622,188017567449,1500000000,1500000000
44709169516,1646772423,67634,46209169516,62834,52558921409,1500000000,1500000000
54911270532,1649436253,48627,56411270532,48627,63851902627,1500000000,1500000000
32841070913,1649411076,67634,34341070913,67634,48946979309,1500000000,1500000000
79090099539,1649456199,48651,80590099539,43851,90237730512,1500000000,1500000000
79090099539,1649456199,60862,80590099539,56062,90237730512,1500000000,1500000000
225223207818,1641879861,67622,226723207818,67622,251203032532,1500000000,1500000000
73939576976,1648846835,48615,75439576976,43815,83626696122,1500000000,1500000000
30295031721,1646755471,60850,31795031721,60850,36925929244,1500000000,1500000000
42721346731,1649406793,60838,44221346731,60838,50617590372,1500000000,1500000000
76370113239,1645367648,320415,77870113239,320415,96791702060,1500000000,1500000000
166865101418,1648843468,313403,168502922077,313403,188284947407,1637820659,1637820659
33868134313,1649422704,67634,35368134313,52314,41294822459,1500000000,1500000000
84814074671,1649456279,312419,86314074671,312419,103540484668,1500000000,1500000000
84814074671,1649456279,317334,86314074671,317334,92209440812,1500000000,1500000000
50045797193,1649441553,67622,51545797193,62822,64142825084,1500000000,1500000000
33280625265,1649401266,67634,34780625265,62834,51408613484,1500000000,1500000000
54936610760,1649389432,67646,56436610760,62846,59253236765,1500000000,1500000000
159329542579,1641936808,67622,160829542579,62822,172962880793,1500000000,1500000000
45665838370,1645388602,67646,47165838370,62846,65886804028,1500000000,1500000000
33566575118,1649414728,67646,35066575118,62846,46276248603,1500000000,1500000000
91684003299,1649384018,64741,93184003299,59941,200000000000,1500000000,1500000000
35401604641,1649393805,63200,36901604641,63200,87413181492,1500000000,1500000000
35401604641,1649393805,67646,37401604641,62846,50863121974,2000000000,2000000000
30713407498,1646747494,67658,35972014509,62858,,,
32030801972,1645363666,66790,33530801972,61990,45854679113,1500000000,1500000000
38208320784,1648812114,64056,39708320784,54456,52764173855,1500000000,1500000000
37215033580,1649417124,320489,38715033580,320489,48622783224,1500000000,1500000000
47343484996,1649398349,54354,48843484996,49554,67351112294,1500000000,1500000000
46151658153,1649389852,67646,47651658153,62846,61108847529,1500000000,1500000000
46151658153,1649389852,48675,47651658153,43875,73568278653,1500000000,1500000000
48405963212,1649431748,66790,51476906567,66790,,,
34834061166,1648801388,60850,36334061166,56050,50187705569,1500000000,1500000000
45239859586,1649433832,60850,46739859586,60850,56876947018,1500000000,1500000000
124736116971,1641906791,66742,126236116971,61942,172111799119,1500000000,1500000000
246686015423,1641921347,60862,248186015423,56062,255909898882,1500000000,1500000000
246686015423,1641921347,63200,249186015423,63200,441166765762,2500000000,2500000000
149679127411,1641872759,334350,151179127411,334350,175818281153,1500000000,1500000000
45930397738,1645360134,67646,47430397738,62846,49599583707,1500000000,1500000000
37060448161,1646754551,67634,38560448161,62834,50533592454,1500000000,1500000000
35654277625,1649405435,60850,37154277625,60850,43102994165,1500000000,1500000000
139166821836,1641910627,60862,147000000000,56062,,,
45500848951,1649422135,67622,47000848951,67622,60494689788,1500000000,1500000000
123869297658,1641903355,66730,125369297658,66730,167109592514,1500000000,1500000000
31360917043,1645335479,59982,32860917043,59982,43982268727,1500000000,1500000000
44540720920,1646783160,331149,46040720920,331149,65864045583,1500000000,1500000000
61732942158,1649445747,49571,63232942158,49571,92249535080,1500000000,1500000000
44858693939,1649428549,60862,46358693939,56062,75675027880,1500000000,1500000000
45720750264,1645326535,340649,47220750264,340649,54733550687,1500000000,1500000000
33831611058,1645363509,67634,35331611058,62834,39094351817,1500000000,1500000000
75103925639,1648841936,67646,76603925639,62846,101883147470,1500000000,1500000000
37321496052,1649401768,63200,38821496052,63200,67861026278,1500000000,1500000000
53705890370,1649400491,60862,55205890370,56062,69759437305,1500000000,1500000000
33680423368,1649418284,60850,35180423368,56050,53038951239,1500000000,1500000000
146488968905,1641940218,55592,147988968905,55592,210915623800,1500000000,1500000000
17909436963,1646732684,334358,19409436963,334358,20900964157,1500000000,1500000000
53999673612,1649449380,67622,55999673612,67622,98000000000,2000000000,2000000000
32332798426,1649421934,60850,33332798426,56050,35611491280,1000000000,1000000000
49270911773,1649423951,322838,50770911773,322838,57537290457,1500000000,1500000000
118969936753,1641905288,55592,126880784098,50792,,,
211232817607,1648843830,55693,212732817607,50893,274293161054,1500000000,1500000000
21532815103,1646717581,328032,23032815103,328032,31178231285,1500000000,1500000000
48819632102,1649391174,56504,50319632102,51704,54305920669,1500000000,1500000000
62998707953,1649379484,67646,64822307953,62846,72946171750,1823600000,1823600000
36913344087,1649402685,67646,38413344087,62846,42573815118,1500000000,1500000000
76434653650,1649379341,60862,77934653650,56062,81262707563,1500000000,1500000000
34041870284,1649419957,67634,35541870284,67634,43168146462,1500000000,1500000000
47239206831,1649423249,331199,48739206831,331199,61067235965,1500000000,1500000000
68143003807,1646781013,60874,69643003807,56074,92422828364,1500000000,1500000000
37173495355,1646747872,60862,39173495355,56062,56497923569,2000000000,2000000000
176300648008,1641923359,60838,177800648008,60838,216836492333,1500000000,1500000000
42739951008,1648774367,305934,44239951008,305934,51396583547,1500000000,1500000000
34879845689,1646707619,327982,36379845689,327982,39000000000,1500000000,1500000000
23290589160,1646716036,67646,24790589160,62846,25560184879,1500000000,1500000000
20086721251,1646736074,67646,21586721251,62846,28430030314,1500000000,1500000000
173148305120,1649376655,67722,174648305120,62922,243623597192,1500000000,1500000000
36336979043,1649398137,63200,37836979043,63200,75333324298,1500000000,1500000000
41978056766,1649429676,67646,43478056766,62846,59572056204,1500000000,1500000000
41978056766,1649429676,63200,43478056766,63200,92243916058,1500000000,1500000000
33255536721,1649401911,55717,43255536721,50917,200000000000,10000000000,10000000000
235103400613,1641925928,64741,236603400613,59941,301676547348,1500000000,1500000000
225675710298,1641868255,60862,227175710298,56062,227574691705,1500000000,1500000000
182814532674,1641870327,334292,184314532674,334292,204212975883,1500000000,1500000000
78923189555,1645378821,55624,80423189555,50824,106761461877,1500000000,1500000000
51872553459,1645397927,55584,53372553459,50784,71378921694,1500000000,1500000000
41277535719,1649393975,53252,43277535719,48452,56452710012,2000000000,2000000000
63251626763,1649404621,60078,64751626763,60078,78097146305,1500000000,1500000000
168074945613,1641942060,67646,169574945613,62846,180321751319,1500000000,1500000000
98916603529,1649376351,55717,102916603529,50917,153072907537,4000000000,4000000000
51873189698,1649427445,67622,53873189698,67622,57000000000,2000000000,2000000000
77827933620,1649385292,56516,89827933620,51716,388000000000,12000000000,12000000000
51442346905,1649432674,67646,52942346905,62846,65643092332,1500000000,1500000000
132191430940,1641877714,60862,133691430940,56062,197299485005,1500000000,1500000000
155820073910,1641861217,60850,157320073910,56050,212821409829,1500000000,1500000000
36413854397,1648794782,324856,37913854397,324856,55245588870,1500000000,1500000000
17595448384,1646718022,325653,19095448384,325653,22508144267,1500000000,1500000000
17595448384,1646718022,67646,19095448384,62846,25327623015,1500000000,1500000000
40923943771,1649387779,60850,48000000000,56050,,,
36138713723,1649399067,67646,37638713723,62846,51647425663,1500000000,1500000000
181532183011,1641890512,67646,183032183011,62846,203493684068,1500000000,1500000000
63871208307,1645328208,326115,65371208307,326115,77306103884,1500000000,1500000000
20502054143,1646765190,60850,22002054143,60850,30050908603,1500000000,1500000000
132545606290,1641894649,334290,134045606290,334290,184049780907,1500000000,1500000000
129382457423,1641865563,67622,130882457423,62822,196365558949,1500000000,1500000000
165337613328,1641932330,333690,166837613328,333690,176204388387,1500000000,1500000000
116024405574,1648828980,333746,118606298734,333746,,,
44628674064,1649441016,313395,46128674064,313395,53521900760,1500000000,1500000000
44628674064,1649441016,327988,46128674064,327988,53447378943,1500000000,1500000000
36124677448,1649433477,60838,37534677448,56038,40039937224,1410000000,1410000000
36124677448,1649433477,326099,37624677448,326099,40000000000,1500000000,1500000000
33622351020,1649409437,67634,35622351020,67634,40000000000,2000000000,2000000000
54966019391,1649449078,49495,56466019391,44695,64735396384,1500000000,1500000000
45127537218,1649452625,67658,46627537218,62858,70000000000,1500000000,1500000000
75067912568,1649380066,56492,76567912568,51692,80146446400,1500000000,1500000000
75067912568,1649380066,60838,76567912568,60838,80146446400,1500000000,1500000000
62503017155,1648795789,316564,64003017155,316564,69838939132,1500000000,1500000000
53565774383,1645355055,54712,55065774383,49912,70966508822,1500000000,1500000000
34611734514,1646753889,314092,36111734514,314092,38549415008,1500000000,1500000000
66505582291,1646773290,67622,68005582291,62822,79578172167,1500000000,1500000000
28706002756,1646710587,299414,30206002756,299414,36630271144,1500000000,1500000000
25206642107,1646755520,60850,26706642107,60850,33512193483,1500000000,1500000000
57126080857,1649425371,60862,58626080857,56062,77106909529,1500000000,1500000000
175894596173,1641896019,67634,177394596173,67634,214997665210,1500000000,1500000000
47130979922,1645365415,343221,48630979922,343221,59763090405,1500000000,1500000000
21621642095,1646755575,60850,23121642095,60850,34649997135,1500000000,1500000000
40194998614,1649391237,56492,42194998614,51692,61184134156,2000000000,2000000000
57844959214,1649430869,60850,59344959214,56050,74323500209,1500000000,1500000000
29656792688,1649397866,60850,34040827073,60850,,,
143116553154,1641873382,52916,144616553154,48116,202720659120,1500000000,1500000000
53631379086,1648842971,333744,55631379086,333744,60000000000,2000000000,2000000000
44649964235,1649398160,55717,46649964235,50917,49238072756,2000000000,2000000000
44998430011,1649419061,59970,46498430011,59970,47311817425,1500000000,1500000000
38376128993,1648781048,320473,40000000000,320473,40000000000,1815000000,1623871007
64943834585,1649449016,313467,66943834585,313467,72600617688,2000000000,2000000000
60885126837,1649436343,67634,62385126837,62834,68916307877,1500000000,1500000000
60941322192,1648845838,336895,62591322192,336895,65000000000,1650000000,1650000000
45926311850,1649426520,54322,47426311850,54322,55754042900,1500000000,1500000000
67947115966,1649383890,322924,72947115966,322924,200000000000,5000000000,5000000000
47095777824,1649380942,67646,48595777824,62846,65689021589,1500000000,1500000000
33055757839,1648801144,55696,34555757839,55696,100000000000,1500000000,1500000000
42907745255,1649402474,67634,44407745255,62834,47256633285,1500000000,1500000000
41054562031,1645338692,337412,42554562031,337412,56002747155,1500000000,1500000000
153016259000,1649377745,54921,154516259000,50121,200000000000,1500000000,1500000000
137160569213,1641877178,64056,138660569213,59256,214529099198,1500000000,1500000000
33007835296,1648813247,323670,34889635296,323670,36750077979,1881800000,1881800000
72779116224,1648838671,67622,74279116224,67622,104967537087,1500000000,1500000000
14913153895,1646735422,52940,16413153895,48140,22779253000,1500000000,1500000000
17427343455,1646731688,55692,18927343455,50892,21542315212,1500000000,1500000000
180113366391,1641941665,297076,181613366391,297076,188080592445,1500000000,1500000000
23138623435,1646716476,67634,24638623435,62834,30472206485,1500000000,1500000000
34154021618,1645361413,322931,35654021618,322931,47676217985,1500000000,1500000000
50559003114,1649405004,60862,52059003114,60862,55141308297,1500000000,1500000000
42816032806,1649399286,67634,44316032806,67634,44407627054,1500000000,1500000000
43760092047,1649453000,55580,45260092047,55580,48000000000,1500000000,1500000000
247475298498,1641921292,60850,248981208948,56050,328688813168,1505910450,1505910450
194055349886,1641941796,60862,195555349886,56062,232227981317,1500000000,1500000000
41782598015,1649406167,59958,43782598015,59958,60000000000,2000000000,2000000000
38047948402,1649400154,66742,39547948402,66742,51221544058,1500000000,1500000000
197949019477,1641922168,55620,199449019477,50820,343412390615,1500000000,1500000000
37341648868,1648802415,311612,38991648868,299612,40000000000,1650000000,1650000000
38304585978,1648802758,67722,39804585978,67722,40810339212,1500000000,1500000000
38472310775,1646766400,67634,39972310775,67634,48054467883,1500000000,1500000000
35810330506,1649414592,48615,37310330506,43815,68356638059,1500000000,1500000000
36159335150,1649409300,60850,38000000000,60850,38000000000,2000000000,1840664850
213135127434,1641930444,54860,214635127434,50060,255460619834,1500000000,1500000000
250762250716,1641921248,60850,252268161166,56050,321638269729,1505910450,1505910450
27112767560,1646749104,60850,28612767560,60850,31627069434,1500000000,1500000000
39816442556,1649402227,55580,41316442556,55580,45588675450,1500000000,1500000000
190831185294,1641861465,54872,193331185294,54872,339100514544,2500000000,2500000000
138981911542,1641913184,60838,140481911542,60838,172944375322,1500000000,1500000000
31737443958,1646750686,67646,33237443958,62846,38718947634,1500000000,1500000000
46318499557,1646783868,64056,47818499557,59256,69515045320,1500000000,1500000000
37954196660,1648774581,67646,39454196660,62846,55492106592,1500000000,1500000000
28621484736,1649429039,333710,40000000000,333710,40000000000,30000000000,11378515264
187013294086,1641928089,63188,189513294086,63188,352328121446,2500000000,2500000000
83728098340,1645372785,333157,85228098340,333157,110861845060,1500000000,1500000000
16535630815,1646739886,67622,18035630815,62822,23588234102,1500000000,1500000000
41070415589,1649427681,67646,42570415589,62846,52095754369,1500000000,1500000000
61109255035,1649379814,64044,62609255035,64044,81215410978,1500000000,1500000000
278167444630,1641859349,326765,279667444630,326765,312780144897,1500000000,1500000000
32560612491,1649412069,60938,34060612491,60938,51205118322,1500000000,1500000000
51967648676,1649387422,60850,53467648676,60850,68636618028,1500000000,1500000000
43304632868,1649435348,67722,44804632868,67722,72420381185,1500000000,1500000000
22606490865,1646765341,60850,24106490865,56050,26933413533,1500000000,1500000000
43999874843,1646710294,55612,45499874843,55612,60784096374,1500000000,1500000000
35653562749,1649398871,55717,37153562749,50917,42965810315,1500000000,1500000000
200495481775,1649377057,67634,201995481775,62834,208670743493,1500000000,1500000000
32909543882,1649411556,319799,34409543882,319799,42641664260,1500000000,1500000000
149405799078,1641872983,54849,150905799078,50049,160053146469,1500000000,1500000000
65276994125,1646756750,60862,66776994125,56062,80906201315,1500000000,1500000000
19277261695,1646722449,67634,20777261695,67634,22345979002,1500000000,1500000000
36864085393,1649438225,67622,38364085393,67622,46201061337,1500000000,1500000000
130645177080,1641865723,67622,132145177080,67622,205368940879,1500000000,1500000000
41179404569,1645396405,330519,42679404569,330519,60773777625,1500000000,1500000000
62153773424,1649420848,60850,63653773424,56050,87385586160,1500000000,1500000000
52403634679,1649437946,60838,53903634679,60838,65399872502,1500000000,1500000000
155204055295,1641896564,67646,156704055295,62846,188614057400,1500000000,1500000000
67258057800,1649385230,56516,79258057800,51716,388000000000,12000000000,12000000000
41811584417,1649419684,67622,43311584417,62822,49163463069,1500000000,1500000000
69532194508,1649424241,63200,71032194508,63200,139641030646,1500000000,1500000000
260387352787,1641943472,67646,262600584812,62846,291947398754,2213232025,2213232025
27634671161,1648817528,313516,29134671161,313516,41821095603,1500000000,1500000000
49013342640,1646759594,60862,50513342640,56062,64011726152,1500000000,1500000000
23621361579,1646717557,67634,25000000000,67634,25000000000,1520000000,1378638421
34467367693,1649401048,67722,36467367693,67722,50557765597,2000000000,2000000000
44452587596,1645358956,54712,45952587596,49912,56129215815,1500000000,1500000000
45076004116,1645358975,330015,46576004116,330015,60290782295,1500000000,1500000000
54968380635,1649390092,67634,56468380635,62834,66022478202,1500000000,1500000000
63359004289,1649430791,60850,64859004289,56050,84650009019,1500000000,1500000000
130636434434,1641861921,343199,132046434434,343199,169268927070,1410000000,1410000000
30742734871,1648805933,317140,32242734871,317140,43637584564,1500000000,1500000000
37177349650,1646751042,67658,38827349650,62858,50691314908,1650000000,1650000000
55713502119,1649452207,55592,57713502119,50792,75142224305,2000000000,2000000000
101831818757,1641905332,60850,103331818757,60850,135339845703,1500000000,1500000000
138704734043,1641909635,67646,140204734043,62846,214159164434,1500000000,1500000000
79365508473,1645327452,55596,80865508473,55596,111157293294,1500000000,1500000000
33372497495,1646755376,60850,34872497495,60850,36546291859,1500000000,1500000000
28071683257,1649417198,60926,29571683257,60926,40784245705,1500000000,1500000000
38257415295,1649422179,67622,39757415295,52302,45572629169,1500000000,1500000000
69984673773,1649442373,55681,71484673773,50881,76321492605,1500000000,1500000000
126852584421,1649443096,67646,128352584421,67646,156298899634,1500000000,1500000000
22562998162,1646716248,67646,24062998162,62846,25869119796,1500000000,1500000000
184845026610,1641902861,55580,186345026610,50780,203825763247,1500000000,1500000000
152219687660,1641940719,60862,153719687660,56062,232320849445,1500000000,1500000000
30288001712,1646708970,60938,31788001712,56138,36861085933,1500000000,1500000000
114523890906,1641901713,59982,116023890906,55182,134192065532,1500000000,1500000000
178707601933,1641942752,324804,180000000000,324804,180000000000,1650000000,1292398067
40775535860,1648815595,329241,42275535860,329241,52750604697,1500000000,1500000000
40562397786,1649396898,67646,42062397786,62846,43046932983,1500000000,1500000000
28406168789,1649394157,55717,30406168789,50917,40565085396,2000000000,2000000000
36978517435,1649423499,335604,38478517435,335604,58418505567,1500000000,1500000000
31352287418,1649403163,64705,32852287418,59905,42057142855,1500000000,1500000000
31352287418,1649403163,63200,32852287418,63200,69412032718,1500000000,1500000000
33232254483,1649398507,55717,43232254483,50917,200000000000,10000000000,10000000000
80265868725,1649382200,67646,81866368725,67646,89083846774,1600500000,1600500000
47297011404,1649389776,64705,48797011404,64705,70585343285,1500000000,1500000000
47297011404,1649389776,64741,57297011404,59941,200000000000,10000000000,10000000000
47297011404,1649389776,64741,59297011404,59941,388000000000,12000000000,12000000000
174076063539,1641928028,331119,175576063539,331119,257950063478,1500000000,1500000000
140028401686,1641906295,60838,141528401686,60838,195003635969,1500000000,1500000000
52929831223,1646700673,60838,54429831223,60838,55691965600,1500000000,1500000000
32077222615,1649398536,64705,33577222615,64705,46639980663,1500000000,1500000000
42431481475,1649392303,49483,44431481475,44683,56505786862,2000000000,2000000000
28584630309,1646746826,60862,34458047174,56062,,,
39746083128,1649397314,55492,41246083128,50692,53309139394,1500000000,1500000000
50491096879,1649440641,340035,51991096879,340035,55367764230,1500000000,1500000000
77592308127,1649376153,54861,82592308127,50061,200000000000,5000000000,5000000000
31896946517,1649395957,67634,33396946517,67634,42266177420,1500000000,1500000000
15903464384,1646734258,60850,17403464384,56050,23426968552,1500000000,1500000000
20822173104,1646727629,55592,22322173104,50792,26911989274,1500000000,1500000000
44335474031,1646782793,60862,45835474031,56062,56726950015,1500000000,1500000000
25114282660,1646717131,67646,26614282660,62846,32089184330,1500000000,1500000000
21577049376,1646725756,60862,23077049376,56062,24168465035,1500000000,1500000000
182914234096,1641906270,343121,184414234096,343121,187718475870,1500000000,1500000000
61809604461,1645374421,315272,63309604461,315272,65711391707,1500000000,1500000000
60671171915,1649436326,66766,62171171915,66766,75350470922,1500000000,1500000000
67076996153,1649456424,318698,69076996153,318698,96374046663,2000000000,2000000000
123847372037,1641910671,67646,139000000000,62846,,,
20137311112,1646720876,67634,21637311112,62834,33931953605,1500000000,1500000000
35790896820,1649409688,63200,37290896820,63200,76936373840,1500000000,1500000000
108236118713,1641903560,60018,109736118713,55218,167897529720,1500000000,1500000000
166625063581,1641877356,328793,168125063581,328793,171893217554,1500000000,1500000000
16916182897,1646724681,295916,18416182897,295916,22468091977,1500000000,1500000000
56278899527,1646709697,298757,57778899527,298757,64032188868,1500000000,1500000000
40026767151,1649422355,63200,41526767151,63200,78707793250,1500000000,1500000000
135554060989,1641876007,67634,137054060989,67634,180962561818,1500000000,1500000000
58900171935,1645387638,54795,60400171935,49995,80175880344,1500000000,1500000000
34991746028,1648800949,312391,36491746028,312391,200000000000,1500000000,1500000000
34991746028,1648800949,310985,36491746028,310985,200000000000,1500000000,1500000000
55429249920,1648849536,307068,56929249920,307068,61612552662,1500000000,1500000000
60410435120,1646710164,55660,61910435120,55660,89678981954,1500000000,1500000000
16860780135,1646746202,327988,18360780135,327988,25273500328,1500000000,1500000000
53994139314,1649426761,67634,55494139314,67634,63385385425,1500000000,1500000000
66571515923,1649389576,67646,68071515923,62846,71218534969,1500000000,1500000000
49943295938,1649386497,56516,51443295938,51716,51501041297,1500000000,1500000000
57900923980,1649383012,67634,59400923980,62834,83272735067,1500000000,1500000000
154045403542,1641865986,60838,155545403542,56038,221564862203,1500000000,1500000000
117787103328,1648844885,60838,119287103328,56038,145874903458,1500000000,1500000000
41904863466,1649388448,331175,43404863466,331175,46000000000,1500000000,1500000000
41904863466,1649388448,60850,43404863466,56050,52820540690,1500000000,1500000000
33161038964,1649416823,60826,34661038964,60826,34765771988,1500000000,1500000000
168766656361,1641864144,67646,170266656361,67646,208431250828,1500000000,1500000000
169512125185,1641878968,60018,171012125185,55218,213621377064,1500000000,1500000000
42634834461,1646764639,60862,44101603820,56062,44101603820,1500000000,1466769359
167684127703,1641880634,67634,169184127703,62834,214126589509,1500000000,1500000000
42698907789,1645346208,52916,44198907789,52916,58668735570,1500000000,1500000000
51666078631,1645360167,59934,53166078631,59934,67114853912,1500000000,1500000000
48910430427,1649402522,327962,50410430427,327962,55134681569,1500000000,1500000000
158625887393,1641894175,67646,160125887393,62846,200476565334,1500000000,1500000000
20411141036,1646755621,60850,21911141036,60850,33710196785,1500000000,1500000000
32578586267,1649418001,63200,34078586267,63200,72729545768,1500000000,1500000000
26275682309,1646747325,60850,27775682309,56050,38105789734,1500000000,1500000000
16766774080,1646728335,300753,18266774080,300753,24306490774,1500000000,1500000000
79529024584,1649456289,52372,81029024584,47572,103540484668,1500000000,1500000000
31147803176,1649401564,55592,32147803176,50792,33823294890,1000000000,1000000000
52074530399,1648799629,60850,53574530399,60850,54615279137,1500000000,1500000000
23321474231,1646733312,60874,24821474231,56074,27360460923,1500000000,1500000000
42195094305,1646703706,60862,43695094305,56062,51462877065,1500000000,1500000000
31833913210,1646746883,54332,33333913210,49532,39572558968,1500000000,1500000000
33499520191,1649401374,67634,34999520191,62834,41760548205,1500000000,1500000000
159736365012,1641871404,60862,161236365012,56062,234974641653,1500000000,1500000000
224633268139,1641929062,67622,226133268139,67622,333675933119,1500000000,1500000000
53206680944,1645324209,55612,54706680944,50812,68408784153,1500000000,1500000000
40978056748,1649425506,63200,42478056748,63200,83750473042,1500000000,1500000000
44010111612,1649386085,55580,45510111612,50780,65001351370,1500000000,1500000000
51567128818,1649429851,66826,61567128818,66826,70000000000,10000000000,10000000000
155476106740,1641918380,67646,156976106740,62846,237544726642,1500000000,1500000000
200623097003,1641929842,54824,202123097003,54824,267772987523,1500000000,1500000000
263279777692,1641921116,67634,264779777692,67634,474788113381,1500000000,1500000000
37007915009,1648809462,314116,38507915009,314116,46546670295,1500000000,1500000000
24575624450,1646723674,55592,26075624450,50792,29526741230,1500000000,1500000000
23886057148,1646755597,60850,25386057148,60850,31404381605,1500000000,1500000000
26247156011,1646714713,67634,28187156011,62834,33295876550,1940000000,1940000000
51556829221,1649442146,54791,53056829221,54791,66324738253,1500000000,1500000000
177650334362,1641923853,60862,179060334362,56062,180000000000,1410000000,1410000000
16904218108,1646734305,52904,18404218108,52904,24045805195,1500000000,1500000000
19876496592,1646736546,67646,21376496592,62846,26754587294,1500000000,1500000000
41441693042,1649427506,67622,42941693042,67622,49053687730,1500000000,1500000000
38761124933,1649406026,52940,40261124933,48140,48000000000,1500000000,1500000000
42507019767,1649390165,67634,44507019767,62834,78344663327,2000000000,2000000000
35642477914,1649419787,67634,37142477914,62834,45659276595,1500000000,1500000000
23493522537,1646713855,60850,24993522537,56050,28726034553,1500000000,1500000000
38505239105,1649423520,316608,40005239105,316608,54740241708,1500000000,1500000000
49820582505,1649404680,64705,50820582505,59905,54593669401,1000000000,1000000000
51514148147,1649458298,330533,53000000000,330533,53000000000,1500000000,1485851853
61893688532,1649460241,63200,63393688532,63200,136239866616,1500000000,1500000000
187945275276,1641931474,55592,189445275276,50792,210000000000,1500000000,1500000000
45192507212,1648797439,316772,46692507212,316772,66279580683,1500000000,1500000000
32310999879,1648804859,48615,33810999879,43815,42702425208,1500000000,1500000000
30456568489,1646753272,336841,31956568489,336841,35313624672,1500000000,1500000000
105257466133,1649377335,55660,110257466133,50860,200000000000,5000000000,5000000000
33588547603,1649396716,65530,35588547603,60730,46216545636,2000000000,2000000000
201511198681,1641895497,60862,203011198681,56062,233389022362,1500000000,1500000000
16641391089,1646740519,67622,18141391089,67622,26145131557,1500000000,1500000000
41004117348,1649398470,326086,42504117348,326086,52377628888,1500000000,1500000000
107366578856,1649378609,55705,108866578856,50905,131735270037,1500000000,1500000000
73744288323,1649443283,60838,75244288323,60838,83124415530,1500000000,1500000000
65756593556,1649381953,49457,67256593556,44657,69177407997,1500000000,1500000000
72678621824,1648825755,55720,74178621824,50920,300000000000,1500000000,1500000000
191111910527,1641869113,60850,192611910527,60850,236211444775,1500000000,1500000000
139720731992,1645366984,340635,141220731992,340635,183774932475,1500000000,1500000000
15492765058,1646738671,67622,16992765058,58022,22674703499,1500000000,1500000000
45795316951,1649440806,327387,47295316951,327387,52384821950,1500000000,1500000000
40546215502,1649404326,67634,42046215502,67634,45735956234,1500000000,1500000000
46848378179,1649398297,67734,48348378179,62934,54769122029,1500000000,1500000000
211264948750,1641917626,67646,212764948750,67646,279990378994,1500000000,1500000000
43267756015,1648791599,67646,44767756015,62846,55136160097,1500000000,1500000000
43703555949,1648799016,67634,45703555949,62834,64733658415,2000000000,2000000000
195978507919,1641862914,67646,197478507919,62846,215090589088,1500000000,1500000000
197217309972,1641920044,60850,198717309972,60850,200912698238,1500000000,1500000000
82201224598,1648855130,333746,83701224598,333746,84687398225,1500000000,1500000000
34590042324,1649395725,67634,36090042324,62834,43846680198,1500000000,1500000000
138421282987,1649377556,67622,139921282987,67622,149503730077,1500000000,1500000000
35418138039,1649422585,67634,36918138039,52314,48525245438,1500000000,1500000000
190471163350,1641940571,60862,191971163350,56062,213156132725,1500000000,1500000000
145656520949,1641886695,60850,147156520949,60850,205857903340,1500000000,1500000000
27910122987,1646746575,54261,29910122987,49461,36972314021,2000000000,2000000000
21132634221,1646737870,49483,22632634221,49483,27634692167,1500000000,1500000000
50745271091,1649381638,49445,52245271091,44645,59928400377,1500000000,1500000000
30319820480,1646747586,67622,31819820480,62822,43615124935,1500000000,1500000000
158664274398,1641869660,334380,160164274398,334380,220888303350,1500000000,1500000000
116913910688,1641910663,67634,131000000000,62834,,,
40312918245,1648779147,60838,41812918245,56038,46721119320,1500000000,1500000000
44023048615,1646754055,314065,45523048615,314065,50420811780,1500000000,1500000000
30506839560,1649392683,56516,32506839560,51716,50000000000,2000000000,2000000000
39515735121,1645346201,326818,41015735121,326818,58668735570,1500000000,1500000000
23284512802,1646716048,60862,24784512802,56062,25560184879,1500000000,1500000000
51478081005,1649428765,63200,52978081005,63200,123688029712,1500000000,1500000000
33846909633,1649392943,67622,35346909633,67622,44249784693,1500000000,1500000000
38189625237,1649393700,316644,39689625237,316644,41100030847,1500000000,1500000000
195128300213,1641944579,67646,196628300213,62846,237972902348,1500000000,1500000000
22912542071,1646742262,60874,24912542071,56074,29978802097,2000000000,2000000000
20423649096,1646755722,60850,21923649096,60850,24646022433,1500000000,1500000000
24036095861,1646755537,307676,25000000000,307676,25000000000,1000000000,963904139
49806480253,1649426746,64729,51306480253,59929,71201220723,1500000000,1500000000
35103777337,1649402310,63200,36603777337,63200,78319232884,1500000000,1500000000
201180241682,1641879302,67646,202680241682,62846,230666869897,1500000000,1500000000
234864505597,1641922773,67646,236364505597,62846,289729514657,1500000000,1500000000
56204300943,1648778199,324208,57704300943,324208,68856705384,1500000000,1500000000
113245960649,1641903620,64741,116245960649,59941,222000000000,3000000000,3000000000
35280836881,1645400019,332357,37280836881,332357,45407307609,2000000000,2000000000
73766052358,1648786790,60850,75155656317,56050,81400898003,1389603959,1389603959
25356256103,1646705243,315584,26856256103,315584,33305535138,1500000000,1500000000
25429384263,1646765346,60838,26929384263,56038,37994576763,1500000000,1500000000
42225201389,1649405139,67646,43725201389,67646,53984552224,1500000000,1500000000
309509371493,1641917296,60850,311009371493,56050,423634237260,1500000000,1500000000
229812279799,1641928425,60850,231312279799,60850,322534626278,1500000000,1500000000
65557352318,1649441245,319781,67057352318,319781,70213484562,1500000000,1500000000
48894177391,1649400849,60938,50394177391,56138,61361652304,1500000000,1500000000
150908598497,1641925097,333700,152408598497,333700,181643725330,1500000000,1500000000
56897137198,1646697706,60862,58897137198,56062,69114663199,2000000000,2000000000
40756825251,1649423771,334344,43181825251,334344,63254175283,2425000000,2425000000
66248094857,1649412682,60850,67748094857,60850,101561479913,1500000000,1500000000
76716312298,1643451379,316608,78216312298,316608,102479254649,1500000000,1500000000
106684102639,1643420543,67710,108184102639,67710,152777252912,1500000000,1500000000
328234402605,1643468840,67634,329951870656,67634,360058550162,1717468051,1717468051
68141775983,1643445815,313588,69641775983,313588,85993442264,1500000000,1500000000
84997538023,1643429192,55648,87497538023,55648,206576152680,2500000000,2500000000
107399707255,1643428271,67634,108899707255,67634,150058066317,1500000000,1500000000
137480789080,1643492210,55804,138980789080,55804,204385233244,1500000000,1500000000
95985811517,1643463627,67622,97485811517,67622,103993509713,1500000000,1500000000
95021284275,1643439109,334352,96521284275,334352,127853091358,1500000000,1500000000
65078510258,1643486876,430515,66088510258,330515,68049658473,1010000000,1010000000
65078510258,1643486876,413524,66088510258,313524,68615108853,1010000000,1010000000
89664080914,1643427286,60850,91164080914,56050,104056383914,1500000000,1500000000
116194323969,1643426446,55648,118694323969,55648,186132345796,2500000000,2500000000
95904301570,1643483932,60874,97404301570,56074,108064104557,1500000000,1500000000
89623076516,1643463755,333656,91123076516,333656,113780976953,1500000000,1500000000
116973090674,1643497280,49495,118473090674,44695,133843726683,1500000000,1500000000
94429951293,1643472933,317282,95929951293,317282,133517592217,1500000000,1500000000
88492357311,1643425309,67622,89992357311,67622,99538540903,1500000000,1500000000
88571830038,1643435292,337474,90071830038,337474,114335641809,1500000000,1500000000
101082473086,1643439041,340083,102582473086,340083,123636023819,1500000000,1500000000
93917156161,1643489281,56504,95417156161,51704,132206102782,1500000000,1500000000
121802002618,1643422619,326143,123302002618,326143,150482894935,1500000000,1500000000
97196681638,1643416855,67646,98696681638,62846,142286929025,1500000000,1500000000
111157364183,1643479335,67710,112657364183,67710,127277047687,1500000000,1500000000
140393495733,1643465085,56717,141893495733,51917,206100142544,1500000000,1500000000
89118107296,1643494979,319745,90618107296,319745,114277944483,1500000000,1500000000
103944494556,1643428824,321666,105444494556,321666,137153679053,1500000000,1500000000
119589596155,1643443580,49483,121096210233,49483,121815101091,1506614078,1506614078
74035128039,1643441752,55705,75535128039,50905,93425582625,1500000000,1500000000
94059635151,1643471920,314182,95559635151,314182,112129158854,1500000000,1500000000
70530156078,1643433866,1000000,74790609236,50893,74790609236,74790609236,4260453158
76865993406,1642424727,67634,78365993406,67634,96825416243,1500000000,1500000000
35939360055,1648719773,67622,37439360055,62822,51383957777,1500000000,1500000000
22934609667,1648351490,59970,24434609667,55170,30904812445,1500000000,1500000000
109568963023,1643075504,337528,111068963023,337528,135601750365,1500000000,1500000000
26907482074,1648387307,67722,28155376252,67722,,,
34028333639,1649482387,59982,36028333639,59982,61328575802,2000000000,2000000000
131900256557,1642379379,67634,133400256557,67634,159324583567,1500000000,1500000000
188276336563,1643130132,49519,190216336563,44719,214732513459,1940000000,1940000000
34911947921,1649470784,60862,36411947921,56062,41476747814,1500000000,1500000000
27881650445,1649545224,55705,29381650445,50905,40946182862,1500000000,1500000000
35706791325,1648731264,55592,37206791325,50792,50271002612,1500000000,1500000000
69700121327,1644776146,343352,71200121327,336883,79304548587,1500000000,1500000000
163816631734,1643132389,67646,165316631734,62846,224927081637,1500000000,1500000000
25725870466,1649501977,55680,27725870466,50880,29298303343,2000000000,2000000000
259768908804,1642448540,55705,261268908804,50905,308301564902,1500000000,1500000000
275374504871,1643140074,48627,276874504871,48627,454556306392,1500000000,1500000000
38535672114,1648719570,310377,39626183832,310377,39626183832,1500000000,1090511718
107995667742,1646240970,60850,109495667742,56050,119509459844,1500000000,1500000000
118718094072,1642399202,55717,120218094072,50917,130543141850,1500000000,1500000000
92732453801,1642422772,67646,94232453801,62846,117424963300,1500000000,1500000000
191415693451,1643140664,55592,192915693451,50792,298713612629,1500000000,1500000000
191415693451,1643140664,60066,194415693451,55266,282065689012,3000000000,3000000000
93749710870,1643115030,66742,95249710870,66742,113216106008,1500000000,1500000000
139022298534,1643136532,55592,140522298534,50792,211818535440,1500000000,1500000000
28765784739,1649545672,326828,30265784739,326828,37670872730,1500000000,1500000000
61311055220,1648769116,307142,62811055220,307142,63555195172,1500000000,1500000000
25587348904,1649510454,336873,27087348904,336873,30350952169,1500000000,1500000000
77247785671,1645233891,321210,78747785671,321210,87965503362,1500000000,1500000000
204003101788,1642451072,326810,205503101788,326810,212134416050,1500000000,1500000000
34936333532,1649490346,55717,36436333532,50917,43726928275,1500000000,1500000000
31090896130,1649513851,60850,32590896130,56050,45052315785,1500000000,1500000000
19817007129,1648367930,67646,21317007129,62846,34232777165,1500000000,1500000000
179387481849,1643143963,60862,180887481849,56062,215487372050,1500000000,1500000000
34254100426,1649516968,66778,35754100426,66778,41009491042,1500000000,1500000000
49827242040,1648751628,67634,51327242040,62834,65590641953,1500000000,1500000000
62957938844,1646256708,67646,64457938844,62846,86805845940,1500000000,1500000000
69816343872,1644719055,314859,71316343872,314859,75000000000,1500000000,1500000000
27358698739,1649504947,320507,28858698739,320507,37295581272,1500000000,1500000000
50934034192,1649520713,67722,51956102359,62922,51956102359,1500000000,1022068167
35145771368,1648727657,314170,36645771368,314170,36869320107,1500000000,1500000000
56544256865,1649532072,329229,58044256865,329229,64474110420,1500000000,1500000000
67469864086,1648761910,54921,68969864086,50121,93140617889,1500000000,1500000000
52173940073,1646265477,328012,53673940073,328012,59116578694,1500000000,1500000000
15046005737,1648353977,300250,16546005737,300250,24820408648,1500000000,1500000000
43677340221,1644724189,326742,45177340221,326742,60993114263,1500000000,1500000000
40650297740,1645269899,340029,42650297740,340029,51131681872,2000000000,2000000000
77187223643,1645298803,316580,78687223643,316580,116885941699,1500000000,1500000000
74639044948,1642419032,67646,75844036702,62846,75844036702,1500000000,1204991754
137430178420,1642459094,67634,138930178420,67634,146653893845,1500000000,1500000000
92535646200,1643126858,312111,94035646200,312111,132819336034,1500000000,1500000000
95345033008,1644779368,55620,96845033008,55620,134445291554,1500000000,1500000000
215559985248,1642445441,60862,217059985248,56062,217793141192,1500000000,1500000000
82237523142,1643089022,331133,93020017811,331133,,,
21081826207,1648369372,333708,22581826207,333708,25955112523,1500000000,1500000000
38936204446,1644754713,55608,40436204446,55608,46662877853,1500000000,1500000000
67932774674,1643100406,60862,69432774674,56062,89466760689,1500000000,1500000000
163206354462,1643131348,56516,166206354462,51716,198315529242,3000000000,3000000000
26456091203,1649492384,66766,27956091203,66766,34783073858,1500000000,1500000000
28550619745,1649509184,66730,30050619745,66730,35159199867,1500000000,1500000000
62199903974,1646254856,60874,63699903974,60874,70620362377,1500000000,1500000000
135215079596,1643128631,56516,137215079596,51716,196952346591,2000000000,2000000000
82385212921,1646232926,67634,84385212921,67634,93491640675,2000000000,2000000000
68864653950,1646232355,60850,70364653950,60850,74828861544,1500000000,1500000000
72781779616,1645289469,337476,74281779616,337476,105450442184,1500000000,1500000000
173375949372,1642458458,56516,174875949372,51716,181692574808,1500000000,1500000000
36732781923,1649473836,55717,38449770335,50917,,,
120431350510,1643153426,322947,121931350510,322947,140613792264,1500000000,1500000000
40172484314,1648718442,60850,42172484314,60850,42748295526,2000000000,2000000000
116201705192,1646241026,60850,117701705192,56050,136494584678,1500000000,1500000000
118947094327,1642404096,67646,121947094327,62846,170000000000,3000000000,3000000000
47972644348,1649483124,60862,49472644348,56062,66003995892,1500000000,1500000000
28317634524,1648686487,343827,29817634524,343827,30000000000,1500000000,1500000000
28317634524,1648686487,346382,29817634524,346382,30000000000,1500000000,1500000000
59114520758,1646253122,330503,60614520758,330503,69797621915,1500000000,1500000000
59114520758,1646253122,301424,60614520758,301424,67217556163,1500000000,1500000000
65341851470,1648420800,326234,66841851470,326234,68041843204,1500000000,1500000000
109979128118,1642402986,55636,111479128118,50836,131716237748,1500000000,1500000000
143764936433,1642448829,337462,145264936433,337462,150000000000,1500000000,1500000000
85313938150,1643092172,340003,86813938150,340003,106964833129,1500000000,1500000000
39184073640,1649483797,64741,40684073640,59941,40908622477,1500000000,1500000000
30436842625,1649484604,49607,31936842625,44807,39666977753,1500000000,1500000000
103303913480,1646240994,55592,104803913480,50792,129902899258,1500000000,1500000000
98860327147,1646237642,67622,100360327147,67622,120192286540,1500000000,1500000000
103140255806,1642398564,66790,104640255806,61990,132247385263,1500000000,1500000000
272781153568,1643141319,346410,274281153568,346410,314493255474,1500000000,1500000000
136291583448,1643128714,55592,138291583448,50792,148567796632,2000000000,2000000000
21983777864,1648358641,331173,23483777864,331173,25022589178,1500000000,1500000000
97943000912,1642417309,60850,99443000912,56050,106209563959,1500000000,1500000000
38526422856,1648732736,310281,40026422856,310281,44387304995,1500000000,1500000000
35629746726,1649486333,59982,37129746726,55182,41320449358,1500000000,1500000000
27845216182,1649548061,67634,29345216182,67634,37388010555,1500000000,1500000000
23560485511,1649511771,329457,25060485511,329457,33094439802,1500000000,1500000000
36873782361,1649515525,320455,38373782361,320455,42908917098,1500000000,1500000000
65893439552,1646260147,60850,66585267034,60850,66585267034,1500000000,691827482
31803338746,1646228348,67634,33303338746,62834,43258973492,1500000000,1500000000
37912134809,1644751393,310215,39412134809,310215,40000000000,1500000000,1500000000
111764794409,1643083429,323654,113264794409,323654,128248735779,1500000000,1500000000
29561661468,1646230622,60850,31061661468,60850,35007852738,1500000000,1500000000
29944323281,1648346651,333748,31444323281,333748,39313718464,1500000000,1500000000
44576345484,1648688496,60850,46076345484,56050,63343468114,1500000000,1500000000
58951304543,1645285994,336246,60451304543,336246,91499582494,1500000000,1500000000
36787144665,1649525683,60850,38287144665,56050,42049942457,1500000000,1500000000
112451649762,1642378068,60838,114239903270,60838,176931633111,1788253508,1788253508
97252886880,1643092504,60850,98752886880,56050,102586297034,1500000000,1500000000
97252886880,1643092504,340631,98752886880,340631,102586297034,1500000000,1500000000
97252886880,1643092504,343219,98752886880,343219,102586297034,1500000000,1500000000
40463058214,1649470366,60862,41963058214,56062,52884095308,1500000000,1500000000
116727918646,1642435850,67634,118227918646,62834,149657884304,1500000000,1500000000
75924256621,1642416480,67622,77424256621,67622,87489789435,1500000000,1500000000
86863051368,1643112080,339985,88363051368,339985,119285926222,1500000000,1500000000
20934737818,1648358777,331981,22711578618,331981,,,
31608562279,1648346136,324780,33108562279,324780,38688992943,1500000000,1500000000
78642862180,1643108931,56504,80142862180,51704,105457537023,1500000000,1500000000
49768386941,1649483214,67646,51268386941,62846,61038176947,1500000000,1500000000
95095949637,1646241298,67646,96795949637,67646,155000000000,1700000000,1700000000
120556535459,1642396777,67646,122056535459,62846,136909482209,1500000000,1500000000
26434036112,1646218803,60850,27934036112,56050,37334933735,1500000000,1500000000
20856072379,1648355562,340043,22356072379,340043,30652105805,1500000000,1500000000
52894924223,1644778446,52928,54394924223,48128,76408607080,1500000000,1500000000
136498940773,1643136703,55580,139498940773,50780,176713868387,3000000000,3000000000
36998249904,1649526990,67622,38498249904,67622,50354704688,1500000000,1500000000
21721268185,1649507878,56504,23221268185,51704,34081366873,1500000000,1500000000
36406540450,1648715787,67634,37906540450,62834,44050260430,1500000000,1500000000
24912322384,1646223383,55680,26412322384,55680,30981075349,1500000000,1500000000
24912322384,1646223383,323060,26412322384,323060,26525971509,1500000000,1500000000
36127730326,1644733032,322882,37627730326,322882,44909443418,1500000000,1500000000
35622517817,1644742422,55644,37122517817,55644,40138672494,1500000000,1500000000
155315841869,1642459497,55648,156815841869,55648,162369176248,1500000000,1500000000
46659610667,1649467382,55804,48159610667,55804,69309198380,1500000000,1500000000
24527483271,1649500595,315280,26527483271,315280,32658213605,2000000000,2000000000
28291921912,1649528725,67622,29791921912,62822,37065244073,1500000000,1500000000
52339369424,1648758385,67634,53839369424,67634,59039427852,1500000000,1500000000
68484704930,1646246791,60850,69984704930,56050,75139981873,1500000000,1500000000
61091436909,1646264354,67646,62591436909,62846,72082298308,1500000000,1500000000
50297266406,1648413862,55681,51797266406,50881,67363501263,1500000000,1500000000
178964424848,1642436103,336327,180464424848,336327,184803526645,1500000000,1500000000
95441620442,1642463964,48651,96941620442,48651,160371230010,1500000000,1500000000
36243265902,1649534036,60850,37743265902,60850,44677329053,1500000000,1500000000
31573784067,1648726720,326074,33073784067,326074,55253191347,1500000000,1500000000
42524293990,1649469973,327381,44024293990,327381,51347738389,1500000000,1500000000
31579688259,1649486271,317354,33079688259,317354,44846118658,1500000000,1500000000
59347881514,1645276956,60850,60847881514,60850,80211546733,1500000000,1500000000
129388065122,1643128156,60862,130888065122,56062,181055184972,1500000000,1500000000
34956818668,1649499889,331549,36456818668,331549,40570069188,1500000000,1500000000
50232202608,1649521592,60950,52232202608,56150,57067735795,2000000000,2000000000
60266142202,1646235931,60862,61766142202,56062,73518674815,1500000000,1500000000
43865871268,1648410888,67646,45865871268,62846,62004773486,2000000000,2000000000
48713640122,1644713379,67634,50213640122,58034,58265505833,1500000000,1500000000
161356771049,1643127883,67622,162856771049,67622,245461949815,1500000000,1500000000
79257554898,1645300928,54676,80257554898,54676,82000000000,1000000000,1000000000
46058410317,1645272723,340661,47558410317,340661,51086688094,1500000000,1500000000
14709636825,1648381053,322943,16209636825,322943,20842247800,1500000000,1500000000
237144995869,1642445609,67646,238644995869,62846,296255206152,1500000000,1500000000
151129619478,1642446530,329992,152629619478,329992,153052805063,1500000000,1500000000
76387133137,1643091303,322899,77938133137,322899,88410983338,1551000000,1551000000
160008024958,1642379578,49495,161508024958,44695,181491607888,1500000000,1500000000
415006506077,1642389097,337490,416006506077,337490,437399843671,1000000000,1000000000
415006506077,1642389097,336877,416006506077,336877,437399843671,1000000000,1000000000
74074874148,1643110379,332436,75574874148,332436,100414493078,1500000000,1500000000
34844657019,1649499804,333241,36344657019,333241,43473029822,1500000000,1500000000
34213430945,1644747982,326014,35713430945,326014,47822292153,1500000000,1500000000
41412776478,1649521487,317336,42912776478,317336,44919926302,1500000000,1500000000
32486458596,1649465303,60850,33986458596,56050,48926040975,1500000000,1500000000
110823890667,1648744016,66766,112323890667,66766,154634353269,1500000000,1500000000
51091926475,1646193280,55596,53591926475,55596,78277455092,2500000000,2500000000
29713513769,1649499364,60850,31147846497,60850,31147846497,1500000000,1434332728
79387576247,1646233013,66862,80887576247,62062,114887881152,1500000000,1500000000
54840032582,1644768180,343245,56340032582,343245,62436151424,1500000000,1500000000
28227599933,1649515041,67722,29727599933,67722,47338009985,1500000000,1500000000
43805219029,1649522892,67646,45305219029,62846,48644685202,1500000000,1500000000
53160949143,1644760031,56504,54660949143,51704,69999526777,1500000000,1500000000
73186721684,1642422806,312183,74696721684,312183,77751782260,1510000000,1510000000
92040432989,1642397502,67658,93540432989,62858,142042378703,1500000000,1500000000
87366182829,1643069930,320364,88866182829,320364,93397748014,1500000000,1500000000
26012709636,1649485374,317342,27512709636,317342,31600184034,1500000000,1500000000
36473528506,1649477778,67634,37526562412,62834,37526562412,1500000000,1053033906
131229997761,1642462002,54956,132729997761,50156,146683901682,1500000000,1500000000
106389447747,1642431932,343197,107889447747,343197,114186274874,1500000000,1500000000
119039922215,1642399216,67658,120539922215,62858,141163980342,1500000000,1500000000
124409992177,1642438238,340013,125909992177,340013,149426871557,1500000000,1500000000
39838018085,1646231014,60006,41338018085,55206,53595058710,1500000000,1500000000
93276041409,1646238060,60938,94776041409,56138,121610727935,1500000000,1500000000
62664720169,1646186749,66742,64164720169,66742,91196636854,1500000000,1500000000
34628336953,1644724246,331969,36128336953,331969,60116676780,1500000000,1500000000
101260830687,1643114100,328008,102760830687,328008,115325194392,1500000000,1500000000
28477071866,1649470748,320497,29977071866,320497,47911731314,1500000000,1500000000
30888340069,1649542483,60950,32388340069,56150,40109015167,1500000000,1500000000
30888340069,1649542483,319767,32388340069,319767,40109015167,1500000000,1500000000
25610239562,1649492597,60862,27110239562,56062,33563962102,1500000000,1500000000
20351094148,1646224956,67634,21851094148,67634,32485298379,1500000000,1500000000
42682224639,1644752150,55596,44182224639,55596,49434250035,1500000000,1500000000
27727298089,1649547634,63200,29227298089,63200,50857011550,1500000000,1500000000
38730653945,1644741987,56492,40230653945,51692,55000000000,1500000000,1500000000
120330315756,1642394419,60838,121830315756,60838,149663750468,1500000000,1500000000
113106444560,1642403558,67622,114606444560,67622,156376735129,1500000000,1500000000
125246626627,1643123805,54872,126746626627,54872,181165532013,1500000000,1500000000
69531997841,1646235653,60838,71031997841,56038,82603168784,1500000000,1500000000
33022695043,1649469319,49595,34522695043,44795,62074643027,1500000000,1500000000
68699920756,1646247973,60862,70199920756,56062,93836806740,1500000000,1500000000
37717728217,1649513468,60850,39217728217,60850,40616364764,1500000000,1500000000
51499869308,1649462785,67646,61499869308,62846,100000000000,10000000000,10000000000
36612979232,1645256816,328196,38112979232,328196,46819580184,1500000000,1500000000
115647323548,1643080950,55693,117147323548,55693,141517095269,1500000000,1500000000
42353505133,1646207221,324814,43853505133,324814,56597998780,1500000000,1500000000
90370060604,1642409771,67646,91870060604,62846,102773173128,1500000000,1500000000
86271381289,1642422574,60006,87771381289,55206,110026842768,1500000000,1500000000
33587126636,1649512388,317905,35087126636,317905,36227113849,1500000000,1500000000
30357507069,1648703604,301372,31857507069,232352,47713179367,1500000000,1500000000
30357507069,1648703604,301372,31857507069,301372,32886396242,1500000000,1500000000
91048293979,1642380154,67646,92548293979,62846,115686716407,1500000000,1500000000
152643824964,1642440100,60838,154143824964,60838,155280199774,1500000000,1500000000
124153027033,1642435594,52928,125653027033,48128,165903455942,1500000000,1500000000
99163488213,1643086074,331997,99906791355,331997,99906791355,1410000000,743303142
115217084007,1643075677,67646,116717084007,62846,138571444409,1500000000,1500000000
46655275470,1645261882,56504,48155275470,51704,49820693625,1500000000,1500000000
35104262342,1646216506,55828,36604262342,51028,50996673574,1500000000,1500000000
127776499159,1642458217,55648,130276499159,55648,256730125524,2500000000,2500000000
147799029854,1643152131,54957,149299029854,50157,155283120177,1500000000,1500000000
37324481104,1648695791,55580,38368845522,50780,38368845522,1500000000,1044364418
36021830457,1644738860,49483,37521830457,44683,49105451297,1500000000,1500000000
63299428507,1643098819,67646,64799428507,62846,65000000000,1500000000,1500000000
28577269856,1649500690,67646,30077269856,62846,37807155788,1500000000,1500000000
28577269856,1649500690,300198,31577269856,241893,166000000000,3000000000,3000000000
28577269856,1649500690,303367,31577269856,303367,300000000000,3000000000,3000000000
30802627980,1648689346,60838,32302627980,56038,37452018057,1500000000,1500000000
39243977551,1645272099,323634,40263173370,323634,40263173370,1500000000,1019195819
56960605506,1646187464,66766,58460605506,61966,69725240679,1500000000,1500000000
26195280515,1648364265,66742,27695280515,66742,29592227048,1500000000,1500000000
101262837103,1642431391,60862,101522941972,56062,101522941972,1500000000,260104869
149885587894,1642457905,335574,151385587894,335574,170713531439,1500000000,1500000000
164044051539,1643136991,340691,165544051539,340691,170288266594,1500000000,1500000000
34899863874,1649469987,316616,36399863874,316616,50011881717,1500000000,1500000000
48129277617,1648693710,67622,49629277617,67622,65093371735,1500000000,1500000000
32616275759,1648686194,66742,34116275759,61942,42155097555,1500000000,1500000000
51894319396,1645268647,311753,53894319396,311753,63916984063,2000000000,2000000000
132193559626,1642395447,326123,134193559626,326123,168536837387,2000000000,2000000000
30635623802,1648348206,60862,32135623802,56062,44555754428,1500000000,1500000000
46132137223,1648404524,340065,48072137223,340065,56452171857,1940000000,1940000000
57946012947,1644760606,67634,59446012947,62834,78263700400,1500000000,1500000000
38687511682,1649531046,316602,40187511682,316602,44486251210,1500000000,1500000000
31856359486,1649486293,300242,33356359486,300242,40974610324,1500000000,1500000000
46917325895,1645239447,54688,52506493242,49888,,,
73922213157,1644773194,55656,75422213157,50856,90386734954,1500000000,1500000000
25842010867,1644755150,54320,27342010867,49520,37679956169,1500000000,1500000000
130245600704,1642450839,336881,131745600704,336881,148861018143,1500000000,1500000000
19243236327,1649509660,67734,20743236327,62934,29110925342,1500000000,1500000000
37949736695,1649490596,60850,39449736695,60850,44203177617,1500000000,1500000000
54117009745,1648754381,48579,55617009745,43779,64605802305,1500000000,1500000000
38727770186,1645242557,320491,40227770186,320491,53802936403,1500000000,1500000000
137561191812,1642437248,55717,139061191812,50917,186756467389,1500000000,1500000000
82543889752,1643088749,317238,84043889752,317238,108298775048,1500000000,1500000000
24680093090,1649485713,317306,26180093090,317306,38028467440,1500000000,1500000000
50875762476,1645250425,66742,52375762476,61942,64531244524,1500000000,1500000000
48586008722,1645248023,316600,50000000000,316600,50000000000,2000000000,1413991278
45276801412,1645275496,538728,51864857504,338728,,,
49327615112,1646255821,60850,50827615112,56050,59410701550,1500000000,1500000000
82662787192,1646234599,55592,84162787192,50792,100127412633,1500000000,1500000000
121184553102,1642382624,337484,122684553102,337484,155745322752,1500000000,1500000000
114018293328,1643125932,333724,115518293328,333724,148805003548,1500000000,1500000000
125560427295,1642461319,54908,127060427295,54908,157730610577,1500000000,1500000000
62514075416,1643099868,60862,64014075416,56062,65000000000,1500000000,1500000000
87971428388,1643112020,329350,89471428388,329350,99180547928,1500000000,1500000000
78352904678,1645229395,317344,79852904678,317344,82831428287,1500000000,1500000000
65606850645,1646262611,55580,67106850645,55580,83856593720,1500000000,1500000000
98978738188,1642415089,60862,100388738188,56062,113956775464,1410000000,1410000000
35804526511,1649471882,312389,37304526511,312389,39616606533,1500000000,1500000000
83686685931,1646234222,67634,85686685931,67634,91829525610,2000000000,2000000000
47638521489,1644748480,314473,49638521489,314473,67018457861,2000000000,2000000000
108332056002,1642386760,340637,109832056002,340637,134830022529,1500000000,1500000000
77207274749,1643100978,343175,78707274749,343175,107152204989,1500000000,1500000000
157343677705,1643133179,340057,158843677705,340057,162340661585,1500000000,1500000000
168963481020,1643129294,67634,170613481020,62834,211121161093,1650000000,1650000000
29675906025,1649544450,336827,31000000000,336827,31000000000,1500000000,1324093975
31698556347,1646215317,335565,33198556347,335565,35767501387,1500000000,1500000000
106239319079,1646236286,60850,107739319079,60850,110720200143,1500000000,1500000000
46637581479,1649514568,317336,48137581479,317336,150000000000,1500000000,1500000000
47348224038,1646248611,55592,48848224038,50792,67298362824,1500000000,1500000000
52154064287,1644778516,67622,53654064287,67622,82108735269,1500000000,1500000000
47371400849,1644743276,67634,48871400849,62834,60822195293,1500000000,1500000000
79752962793,1642414823,52916,81252962793,48116,118675606913,1500000000,1500000000
197221795434,1643140588,55592,199221795434,50792,294486779214,2000000000,2000000000
31256055350,1649499765,326964,32756055350,326964,46856321503,1500000000,1500000000
41309365931,1648759620,327379,42809365931,327379,43924774180,1500000000,1500000000
44420993747,1645266258,323690,45920993747,323690,64634783638,1500000000,1500000000
180719987838,1642446151,64729,182219987838,59929,212217608374,1500000000,1500000000
134423194490,1642395384,55693,135923194490,50893,144818729769,1500000000,1500000000
127994096706,1642381187,67634,129494096706,62834,185527077543,1500000000,1500000000
132628005529,1643116147,316626,134038005529,316626,169272061292,1410000000,1410000000
134959839349,1643074174,337514,136459839349,337514,144694454818,1500000000,1500000000
71758786596,1645236486,336897,73258786596,336897,81353833374,1500000000,1500000000
118926307769,1642452174,320398,120426307769,320398,139844806037,1500000000,1500000000
162994723308,1643123945,323658,164494723308,323658,175445400820,1500000000,1500000000
33068787047,1648697533,66742,34568787047,66742,35395704503,1500000000,1500000000
67332321348,1642421675,312181,67591000000,312181,67591000000,1110000000,258678652
136900117694,1643133214,55592,138310117694,50792,151431568615,1410000000,1410000000
104495399601,1643092510,59970,105995399601,55170,123066108600,1500000000,1500000000
154629004899,1643137290,55592,155954404899,50792,172038224326,1325400000,1325400000
61728157692,1646239800,67634,63728157692,67634,72238748963,2000000000,2000000000
34355209840,1644758095,316518,35855209840,316518,50871419058,1500000000,1500000000
119851840178,1643153441,334336,121351840178,334336,140613792264,1500000000,1500000000
47695480068,1648716622,330535,48612137670,330535,48612137670,1500000000,916657602
64738723114,1646233059,67634,66738723114,67634,116589313436,2000000000,2000000000
95917449008,1643075742,60850,97417449008,60850,130156680569,1500000000,1500000000
58283195967,1645247803,350153,59783195967,350153,69893117772,1500000000,1500000000
31246913070,1648347073,334312,32896913070,334312,36219731624,1650000000,1650000000
62436401698,1644775724,334266,63936401698,334266,80934148844,1500000000,1500000000
80212830812,1643112370,55592,81712830812,50792,101515467418,1500000000,1500000000
30866507175,1644729281,328805,32366507175,328805,38117096078,1500000000,1500000000
57598726645,1644711243,326072,59098726645,326072,79521992892,1500000000,1500000000
99431707306,1642406308,53524,100931707306,48724,104268730014,1500000000,1500000000
37565907576,1649523410,67622,41000000000,67622,,,
39056366762,1649534161,49595,40556366762,44795,48202526054,1500000000,1500000000
44540643298,1648696137,328016,46040643298,328016,53404178542,1500000000,1500000000
77621018939,1646233282,63200,80121018939,63200,141126250184,2500000000,2500000000
77621018939,1646233282,57594,84000000000,57594,84000000000,84000000000,6378981061
74658117947,1646234115,67646,76158117947,62846,111000000000,1500000000,1500000000
139997281937,1642459132,56516,141497281937,51716,173725198917,1500000000,1500000000
119005571906,1643078313,323660,120505571906,306560,141540889312,1500000000,1500000000
119005571906,1643078313,323666,120505571906,323666,150679436093,1500000000,1500000000
27652195837,1649488412,66754,29152195837,61954,29187634889,1500000000,1500000000
29942934647,1649529694,67646,31442934647,62846,42670723917,1500000000,1500000000
35762982234,1649535947,340033,37262982234,340033,64132591738,1500000000,1500000000
49747371459,1645278645,55705,51247371459,50905,68525857202,1500000000,1500000000
26695218592,1646217856,314065,28195218592,314065,33821782477,1500000000,1500000000
33688603329,1644755535,319779,35188603329,319779,45914826485,1500000000,1500000000
40143882970,1644732660,331937,41143882970,331937,43642595759,1000000000,1000000000
22835605148,1649499957,317342,24835605148,317342,33709830733,2000000000,2000000000
29571555363,1644744871,67634,31071555363,62834,46266590758,1500000000,1500000000
99314720801,1642403989,60850,102314720801,56050,167000000000,3000000000,3000000000
140537996892,1643069478,325639,142037996892,325639,163323444780,1500000000,1500000000
38248588456,1649465970,60838,39748588456,60838,47385923499,1500000000,1500000000
40204350237,1649514672,325018,41204350237,325018,45175476094,1000000000,1000000000
60096674415,1646249878,64056,61506674415,59256,73795310275,1410000000,1410000000
93064335829,1646233885,67646,95064335829,62846,104737977779,2000000000,2000000000
47625695844,1648414414,320491,49125695844,320491,50140776042,1500000000,1500000000
24488826425,1649493094,67646,25988826425,62846,34388637002,1500000000,1500000000
22034344768,1649494886,60850,23534344768,56050,36817584485,1500000000,1500000000
38786240870,1648411684,54724,40286240870,54724,51314936703,1500000000,1500000000
98453025634,1643150973,323676,99953025634,323676,111882335233,1500000000,1500000000
40744491440,1648730611,55828,42244491440,51028,55620088400,1500000000,1500000000
55104850199,1646246869,307148,56604850199,307148,70135664260,1500000000,1500000000
97913575360,1642408896,60838,99413575360,60838,110300238118,1500000000,1500000000
18037114026,1649543700,55720,19537114026,50920,200000000000,1500000000,1500000000
83682067554,1648741308,54724,84529737900,54724,84529737900,1500000000,847670346
42144851734,1645257477,55680,44253458688,50880,,,
41014116875,1649462448,60862,42514116875,56062,49439835093,1500000000,1500000000
40002452148,1648408716,60862,41502452148,56062,50553868904,1500000000,1500000000
37946638989,1648344479,337456,39446638989,337456,47009924115,1500000000,1500000000
65090884799,1642415761,56504,66590884799,51704,67000000000,1500000000,1500000000
81213805575,1642411009,60850,82713805575,56050,123382877278,1500000000,1500000000
92737312156,1643106954,343873,93757251422,343873,93757251422,1500000000,1019939266
35942219045,1648724328,54332,37442219045,49532,44188442945,1500000000,1500000000
30004840915,1646214840,63200,32504840915,63200,59953065290,2500000000,2500000000
48156750939,1648407360,317244,49656750939,317244,61822269757,1500000000,1500000000
330865497282,1643139824,66778,332365497282,61978,391295230028,1500000000,1500000000
23546012739,1649494075,67722,25046012739,67722,35762713957,1500000000,1500000000
28251336900,1649478393,316597,29751336900,316597,47988045417,1500000000,1500000000
31531508950,1646203284,313556,33031508950,313556,41145098963,1500000000,1500000000
100517355217,1642461067,67634,102017355217,62834,134986530730,1500000000,1500000000
106467813346,1643113932,66754,107967813346,66754,133943651834,1500000000,1500000000
54870602043,1646239769,67622,56470602043,67622,88000000000,1600000000,1600000000
81343886210,1643110211,340681,82843886210,340681,94025843782,1500000000,1500000000
35493782642,1649470679,323600,36993782642,323600,48418073388,1500000000,1500000000
67184926823,1649467999,67634,68684926823,62834,72146418706,1500000000,1500000000
60836328848,1648755767,337478,62336328848,337478,69105646659,1500000000,1500000000
37126249599,1648724485,55705,38626249599,50905,52123459940,1500000000,1500000000
30777845890,1648346299,60838,32277845890,60838,36311488385,1500000000,1500000000
72168035974,1642424114,60862,73668035974,56062,79630017942,1500000000,1500000000
21885714373,1649496059,317234,23885714373,317234,34365086750,2000000000,2000000000
70151059828,1648742476,55717,71651059828,50917,107795795950,1500000000,1500000000
44838607254,1648759455,60926,46338607254,60926,62430780787,1500000000,1500000000
42830354176,1646210507,59994,44330354176,55194,49145211195,1500000000,1500000000
130382962789,1642394364,60850,131882962789,56050,205885876885,1500000000,1500000000
34162542093,1649490521,67634,35662542093,67634,49940075742,1500000000,1500000000
39059802701,1649542544,67634,40110425087,67634,40110425087,1500000000,1050622386
72209357891,1645233169,310973,73709357891,310973,85125514367,1500000000,1500000000
46917425835,1646255943,60838,48417425835,60838,62136037748,1500000000,1500000000
93749352893,1646237783,60850,95249352893,56050,116974006547,1500000000,1500000000
32420321561,1648400321,55705,34420321561,50905,36824603653,2000000000,2000000000
18968134436,1648394804,320495,20468134436,320495,24405120738,1500000000,1500000000
19489880632,1648355097,316596,20989880632,316596,26948011759,1500000000,1500000000
99494162251,1643069207,336835,100994162251,336835,145409952925,1500000000,1500000000
133358207770,1643073163,322907,134858207770,322907,168755933314,1500000000,1500000000
112055220123,1643121547,55648,114555220123,55648,257477502960,2500000000,2500000000
48637667521,1645247736,332446,50137667521,332446,54545171385,1500000000,1500000000
58625000067,1648420033,316624,67000000000,316624,,,
64673903827,1644775033,55692,66173903827,50892,78914886025,1500000000,1500000000
87878874244,1642416926,67634,89378874244,67634,103830791298,1500000000,1500000000
45554728076,1649477537,60850,47554728076,56050,56033715601,2000000000,2000000000
28971539812,1649493319,330352,30471539812,330352,31859547172,1500000000,1500000000
31047288535,1649484324,60926,32547288535,60926,41314372314,1500000000,1500000000
69665389835,1645305974,55680,71165389835,50880,73000137687,1500000000,1500000000
18689056670,1648365608,67634,20189056670,67634,24206590649,1500000000,1500000000
32979750677,1644738970,67622,34479750677,62822,41297801804,1500000000,1500000000
65606212963,1644784103,54956,67106212963,50156,101763557818,1500000000,1500000000
147116080299,1642446547,67622,149116080299,67622,214599089163,2000000000,2000000000
132636540469,1642393051,340621,134136540469,340621,211245165060,1500000000,1500000000
55076232902,1648757757,60850,56576232902,56050,76677603695,1500000000,1500000000
55914354798,1646245195,60850,57414354798,56050,75735062334,1500000000,1500000000
93934022653,1642430490,55705,95434022653,50905,116424750285,1500000000,1500000000
120025946221,1643081547,48663,121525946221,43863,134358043187,1500000000,1500000000
115208944045,1643147164,336905,116708944045,336905,161498504584,1500000000,1500000000
163446885162,1643123695,316666,164946885162,316666,185166286592,1500000000,1500000000
181826706912,1643140820,54909,183326706912,50109,300000000000,1500000000,1500000000
26095052607,1649533190,333726,26100000000,333726,26100000000,26100000000,4947393
81334483050,1646234342,67646,82834483050,62846,107815758985,1500000000,1500000000
118344305606,1642378904,60862,119844305606,56062,146991785235,1500000000,1500000000
46521643151,1646262314,67634,48021643151,67634,59660131453,1500000000,1500000000
111954779300,1642438509,55624,113454779300,50824,148956802489,1500000000,1500000000
73733175528,1643109238,332568,75233175528,332568,112419971623,1500000000,1500000000
35047958116,1644747796,319761,36547958116,319761,40000000000,1500000000,1500000000
216897160090,1643140611,322945,218397160090,322945,226427272583,1500000000,1500000000
94718052073,1643087177,333714,96218052073,333714,135855353129,1500000000,1500000000
28943735035,1649478108,67646,30443735035,62846,38094688554,1500000000,1500000000
28079301938,1649542836,60850,29579301938,56050,35494474810,1500000000,1500000000
32421130746,1644736900,320431,33921130746,320431,35468213503,1500000000,1500000000
41341474668,1649484767,60950,42841474668,60950,46424700065,1500000000,1500000000
55930119821,1645242374,54700,57430119821,49900,75214140165,1500000000,1500000000
46766853032,1645275788,336307,48266853032,336307,48352692974,1500000000,1500000000
32346207629,1645273006,346917,33846207629,346917,41879845263,1500000000,1500000000
81959290630,1642423715,66766,83459290630,66766,139515461475,1500000000,1500000000
72607187297,1645315166,333179,74107187297,333179,75563779834,1500000000,1500000000
39050811339,1649521913,66778,40550811339,61978,47672324324,1500000000,1500000000
33364766579,1649470039,307730,34864766579,307730,50359968523,1500000000,1500000000
35866305892,1648691344,313401,37366305892,313401,43507050568,1500000000,1500000000
35866305892,1648691344,328018,37366305892,328018,43311879887,1500000000,1500000000
90772208702,1646239257,67634,92272208702,67634,129273372035,1500000000,1500000000
50901213668,1646253605,60862,52401213668,56062,64610501838,1500000000,1500000000
25446443506,1649492391,67646,26946443506,62846,30897766883,1500000000,1500000000
36963698987,1649541700,59994,38463698987,55194,46942080875,1500000000,1500000000
95912681459,1642434803,67646,98912681459,67646,136270755090,3000000000,3000000000
261816531695,1643072711,321833,263336993811,321833,280843022402,1520462116,1520462116
23930840275,1649478706,319807,34958560925,319807,,,
54162643141,1646255996,60874,56162643141,56074,66590516029,2000000000,2000000000
31301367955,1649516937,54332,32801367955,49532,46134013942,1500000000,1500000000
69787121701,1648741327,55580,71787121701,55580,104146443059,2000000000,2000000000
52915335540,1644717313,317334,54608955540,317334,72767567970,1693620000,1693620000
23638147471,1649503991,332426,24696923117,248286,24696923117,1500000000,1058775646
53430891860,1645312163,66778,54930891860,66778,69984454235,1500000000,1500000000
32722935246,1644742069,333177,34222935246,333177,46603339363,1500000000,1500000000
40728921442,1649515934,66778,42228921442,61978,56103718175,1500000000,1500000000
33461824448,1649478974,63188,34961824448,63188,74375745036,1500000000,1500000000
32488725233,1649529958,64044,33988725233,59244,41861345268,1500000000,1500000000
32488725233,1649529958,317234,33988725233,317234,37529746038,1500000000,1500000000
57806230185,1648420843,305950,59306230185,305950,76480128755,1500000000,1500000000
152058931503,1643129645,55592,153468931503,50792,196626999508,1410000000,1410000000
16282407098,1648381302,67646,17295779823,67646,19156039043,1013372725,1013372725
127443316006,1643151981,60850,128943316006,56050,164884827872,1500000000,1500000000
25419832559,1649478795,55680,27419832559,50880,35299093678,2000000000,2000000000
97067701114,1642459934,67634,99067701114,67634,148523174490,2000000000,2000000000
165604427389,1643131273,60862,167104427389,56062,216618016310,1500000000,1500000000
60947761247,1646257229,55580,62447761247,50780,82255712873,1500000000,1500000000
16059040123,1648367629,340031,17559040123,340031,24685139724,1500000000,1500000000
25477858479,1648352478,333716,26977858479,333716,31270621732,1500000000,1500000000
102194536279,1643085547,323005,103694536279,323005,115085439414,1500000000,1500000000
30145204455,1649506069,326238,31645204455,326238,36962145977,1500000000,1500000000
97900636313,1643126422,67658,99400636313,62858,121349539339,1500000000,1500000000
48110996455,1648764369,67634,49610996455,62834,54588103590,1500000000,1500000000
78981937051,1642425480,67646,80481937051,62846,95611024015,1500000000,1500000000
78981937051,1642425480,60862,80053999428,56062,80053999428,1500000000,1072062377
159970455836,1643130596,55592,161470455836,50792,173037282525,1500000000,1500000000
30092484167,1649499908,332557,31592484167,332557,40341971314,1500000000,1500000000
103194933288,1648741897,60850,104694933288,56050,131050454249,1500000000,1500000000
43397865243,1645247515,55680,44897865243,50880,53178272495,1500000000,1500000000
16214950463,1648381797,319805,17714950463,319805,22443806930,1500000000,1500000000
59039948065,1646183327,67634,60539948065,67634,74597274324,1500000000,1500000000
94407567875,1646240935,67634,95907567875,62834,120951678720,1500000000,1500000000
116477738558,1642397548,60874,117977738558,56074,130926640988,1500000000,1500000000
75541532052,1643109024,346408,77041532052,346408,105759437229,1500000000,1500000000
39975587580,1649532374,323652,41475587580,323652,52264277492,1500000000,1500000000
86555465330,1643089822,52904,88055465330,52904,91044356835,1500000000,1500000000
51116269421,1649524514,67634,53116269421,67634,61349834739,2000000000,2000000000
65864142384,1646235696,60862,67364142384,56062,88414997302,1500000000,1500000000
97268208307,1642420226,54261,98768208307,49461,121420876610,1500000000,1500000000
86324990670,1643118541,343203,87824990670,343203,116988984603,1500000000,1500000000
33578423857,1649499758,328354,35578423857,328354,43930612318,2000000000,2000000000
27706409346,1649473916,67646,28369966667,62846,,,
37298410709,1649483544,337456,38798410709,337456,50297372142,1500000000,1500000000
30376382750,1648730813,66742,31876382750,61942,37156609718,1500000000,1500000000
30376382750,1648730813,67634,31876382750,62834,44676075428,1500000000,1500000000
65699271323,1645244085,54724,67109271323,49924,68459228892,1410000000,1410000000
292307808469,1642448304,328827,293807808469,328827,316196283963,1500000000,1500000000
135565605247,1642438777,59982,137065605247,55182,137263008829,1500000000,1500000000
72051351340,1644762029,60838,73551351340,60838,74001269409,1500000000,1500000000
95280482412,1643095044,67646,96780482412,67646,114314009632,1500000000,1500000000
163275080596,1643128515,55592,164775080596,50792,209273430618,1500000000,1500000000
42619914931,1646232145,67622,44119914931,67622,46770232924,1500000000,1500000000
65709346857,1644780015,67634,67209346857,67634,75617764812,1500000000,1500000000
110793226720,1642398677,54872,113293226720,54872,227581566500,2500000000,2500000000
147368885848,1643147978,334334,148868885848,334334,152280615448,1500000000,1500000000
147368885848,1643147978,336921,148868885848,336921,152280615448,1500000000,1500000000
144047567407,1643120773,319759,145547567407,319759,171523731123,1500000000,1500000000
39787742361,1645262904,329487,41787742361,329487,50453052006,2000000000,2000000000
35523170613,1648734103,67634,37023170613,62834,38000000000,1500000000,1500000000
32945069856,1648722350,328020,34445069856,328020,34638257269,1500000000,1500000000
52562793979,1648425425,66742,54062793979,61942,59479671840,1500000000,1500000000
35641275688,1649472049,60850,36715002422,60850,36715002422,1500000000,1073726734
61128209835,1645293325,55608,62628209835,50808,78467271158,1500000000,1500000000
89940061521,1642420799,60862,91440061521,56062,96054159034,1500000000,1500000000
91756821151,1643074937,343205,93256821151,343205,138772342359,1500000000,1500000000
64547178760,1648761688,307682,66047178760,307682,87577288379,1500000000,1500000000
148669842290,1643132556,67646,150169842290,62846,221664992235,1500000000,1500000000
40267530334,1648423374,55580,41767530334,50780,49637244283,1500000000,1500000000
139255486473,1642453006,67634,140755486473,62834,188259707005,1500000000,1500000000
225616522465,1642454621,60862,226616522465,56062,228864310080,1000000000,1000000000
92913877394,1643105408,343217,94413877394,343217,123868727168,1500000000,1500000000
28726805368,1646220056,60850,30226805368,56050,37212001289,1500000000,1500000000
160303597893,1643133363,60862,161803597893,56062,179615490070,1500000000,1500000000
134089269733,1643134051,340631,135589269733,340631,174728504325,1500000000,1500000000
37072897583,1649516624,330354,38572897583,330354,43842126712,1500000000,1500000000
36708738799,1649465930,67646,38708738799,62846,48100506135,2000000000,2000000000
28660694309,1649500664,64729,30660694309,59929,39759442019,2000000000,2000000000
31787110820,1649529875,49583,33287110820,44783,50000000000,1500000000,1500000000
35850040021,1648713389,343845,37350040021,343845,40896020824,1500000000,1500000000
83063432794,1642416905,67646,84110811515,62846,102806129169,1047378721,1047378721
42521448588,1649469652,55840,44021448588,51040,47417894565,1500000000,1500000000
38589627944,1645256850,55668,41335002889,55668,,,
43410957426,1645268282,314017,44910957426,314017,62292271167,1500000000,1500000000
73021897242,1645282971,54332,74521897242,49532,122742115973,1500000000,1500000000
53058344137,1645235243,54712,54558344137,49912,86633941255,1500000000,1500000000
42775080015,1645252395,331344,44275080015,331344,76364856193,1500000000,1500000000
136742675867,1642444858,74349,138242675867,74349,160620586568,1500000000,1500000000
29383448193,1649479858,314063,30883448193,314063,31986815785,1500000000,1500000000
28057618446,1648724110,200000,29557618446,200000,37074761144,1500000000,1500000000
34365512314,1645264742,67634,35865512314,62834,46581942845,1500000000,1500000000
39832276627,1649480743,49595,41332276627,49595,46646346604,1500000000,1500000000
49403490513,1648758142,54748,50903490513,49948,59761067220,1500000000,1500000000
116868446960,1642436729,55684,118368446960,50884,130858250124,1500000000,1500000000
24634264143,1649507349,321907,26134264143,321907,31590400845,1500000000,1500000000
27869495489,1649471631,316612,30869495489,316612,45000000000,3000000000,3000000000
108254092078,1642460151,55684,109754092078,50884,126202947970,1500000000,1500000000
108254092078,1642460151,337538,109754092078,337538,149636939779,1500000000,1500000000
26125605743,1649505575,59946,27625605743,55146,32834997277,1500000000,1500000000
38448553642,1649536725,64741,39948553642,59941,57547448528,1500000000,1500000000
76507332747,1646233515,60862,78224800798,56062,82151971887,1717468051,1717468051
19516341061,1648350560,55693,21016341061,50893,23187905173,1500000000,1500000000
18656326918,1648353950,317350,20156326918,317350,23972248217,1500000000,1500000000
128877786841,1642384363,67646,130377786841,62846,187545811603,1500000000,1500000000
111080427591,1642380468,67634,112580427591,62834,138697351724,1500000000,1500000000
139117695448,1642463903,55592,140617695448,50792,180118752993,1500000000,1500000000
47656243388,1648697254,55717,49156243388,46117,59489525524,1500000000,1500000000
130056008908,1642399307,60874,131556008908,56074,146012734678,1500000000,1500000000
97417088796,1642421200,60838,98917088796,60838,122566385975,1500000000,1500000000
96128804813,1643088361,328216,97628804813,328216,132190842642,1500000000,1500000000
38098346161,1649517440,60838,39508346161,56038,41777465059,1410000000,1410000000
126288277539,1643126494,60874,127788277539,56074,150944567128,1500000000,1500000000
37044346414,1648732289,67634,38544346414,62834,54799764453,1500000000,1500000000
76142706242,1642420425,60850,77642706242,56050,77904399057,1500000000,1500000000
167080864810,1643127665,55580,170080864810,55580,190353190448,3000000000,3000000000
28816582309,1649478135,60850,30816582309,56050,35446444883,2000000000,2000000000
103213595556,1648737170,67634,104713595556,67634,121383977654,1500000000,1500000000
65361990117,1648761881,60850,66861990117,56050,79112688247,1500000000,1500000000
103956756846,1645279621,72592,105456756846,67792,126366712067,1500000000,1500000000
58509528955,1646244003,67634,60009528955,62834,85899312674,1500000000,1500000000
19895800354,1648362454,60850,21395800354,56050,26317795677,1500000000,1500000000
75104539417,1642424690,55668,76604539417,50868,88117487053,1500000000,1500000000
95126085231,1643116617,346358,96626085231,346358,116624242335,1500000000,1500000000
25447464533,1646218884,67634,26947464533,67634,35157651605,1500000000,1500000000
237770890103,1643140641,78906,239270890103,78906,299407904900,1500000000,1500000000
50918075815,1645243803,338346,52418075815,338346,58078733098,1500000000,1500000000
107330589204,1645230740,329962,108830589204,329962,117744909025,1500000000,1500000000
17081425994,1648354235,334324,18581425994,334324,24766161174,1500000000,1500000000
42079373363,1649522609,67634,43579373363,67634,49840691989,1500000000,1500000000
22065004403,1648353873,55580,23565004403,50780,35104622289,1500000000,1500000000
42413676669,1644751392,55608,43913676669,55608,63428052743,1500000000,1500000000
73620501634,1642424957,328018,75120501634,328018,93607014470,1500000000,1500000000
130687201453,1643120478,343223,132187201453,343223,148390396230,1500000000,1500000000
130687201453,1643120478,322989,132687201453,322989,154766012080,2000000000,2000000000
39907316574,1648694683,60850,41407316574,56050,45971429078,1500000000,1500000000
42460286749,1645258175,320441,43960286749,320441,51752233070,1500000000,1500000000
144832794152,1642432548,316588,146332794152,316588,206456223654,1500000000,1500000000
161705741071,1642446169,55693,163205741071,50893,228208417300,1500000000,1500000000
84547403693,1643107080,24000,86047403693,24000,94373625463,1500000000,1500000000
65888378877,1645235173,67634,67388378877,62834,77590191842,1500000000,1500000000
46670984911,1648398045,325667,48000000000,325667,48000000000,1500000000,1329015089
30853359096,1649529527,60850,32353359096,56050,34147598142,1500000000,1500000000
86682578391,1646179627,327982,88182578391,327982,133505770319,1500000000,1500000000
61398111806,1644770125,331163,62898111806,331163,70000000000,1500000000,1500000000
80818943525,1642431786,337532,82318943525,337532,99000000000,1500000000,1500000000
125123493626,1643125663,67622,126623493626,67622,131045783249,1500000000,1500000000
37705189046,1648386427,328841,39205189046,328841,49141666869,1500000000,1500000000
81883730011,1642424574,331171,83383730011,331171,115005451578,1500000000,1500000000
250394604379,1643141189,60862,251894604379,56062,380855687905,1500000000,1500000000
97769095910,1645279510,54736,99269095910,49936,123603039837,1500000000,1500000000
38794525017,1645278226,67634,40294525017,67634,52940285892,1500000000,1500000000
159203785485,1642458131,326084,160178799642,326084,160178799642,1500000000,975014157
165770321902,1643148005,328819,167270321902,328819,171108494498,1500000000,1500000000
31194166018,1648731451,64132,32694166018,54532,51899288305,1500000000,1500000000
131869859020,1642455652,60862,133195259020,56062,133796933385,1325400000,1325400000
123992763310,1642440320,323664,125492763310,323664,141538021885,1500000000,1500000000
60144885653,1645244302,54700,61644885653,49900,69787251635,1500000000,1500000000
15475263899,1648366354,314069,16975263899,314069,25416404527,1500000000,1500000000
129458755824,1643069466,343233,130958755824,343233,173739321225,1500000000,1500000000
62447610774,1643114251,67634,63721046208,67634,63721046208,1500000000,1273435434
79469092462,1643090900,337494,80969092462,337494,115684977037,1500000000,1500000000
81646725073,1643088718,340057,83146725073,340057,92222761990,1500000000,1500000000
25167369347,1649510307,330330,26667369347,330330,36018942257,1500000000,1500000000
25167369347,1649510307,312167,26667369347,312167,36018942257,1500000000,1500000000
77688769869,1646247323,67634,79188769869,62834,104348272284,1500000000,1500000000
62402455343,1646259726,60862,63902455343,56062,75254785898,1500000000,1500000000
34384166418,1648347411,67646,36384166418,62846,41732895681,2000000000,2000000000
104041778471,1642429238,55636,106541778471,55636,202334926314,2500000000,2500000000
102488200502,1643090340,333676,103988200502,333676,163124843553,1500000000,1500000000
37475871675,1645274808,55656,38975871675,55656,47152700022,1500000000,1500000000
38036793409,1649472126,320479,39536793409,320479,47418661079,1500000000,1500000000
65878345990,1645244236,335727,67378345990,335727,68951939352,1500000000,1500000000
26476586329,1646231688,60862,27976586329,56062,35932680683,1500000000,1500000000
40511912476,1644763790,326135,42011912476,326135,49558020965,1500000000,1500000000
38768526496,1649548622,322939,40268526496,322939,44525299850,1500000000,1500000000
45417599468,1649469716,67634,46917599468,62834,54651810735,1500000000,1500000000
36411685727,1645265177,67646,37911685727,62846,64642072209,1500000000,1500000000
62958840163,1644790969,331111,64458840163,331111,92296732593,1500000000,1500000000
39118050773,1649483411,55592,40618050773,55592,44967241822,1500000000,1500000000
24233467096,1649497771,67622,25733467096,67622,29761047128,1500000000,1500000000
119940113821,1643147052,60838,121440113821,56038,130794628590,1500000000,1500000000
201103889601,1643071552,334306,202769833610,334306,271567550672,1665944009,1665944009
32046476327,1649519941,54676,33546476327,49876,47621126380,1500000000,1500000000
110470877095,1646237679,66790,111970877095,66790,134446874127,1500000000,1500000000
76982422798,1642418831,67634,78482422798,67634,87526086048,1500000000,1500000000
32210977769,1649512085,60950,33710977769,56150,37865449342,1500000000,1500000000
27980173450,1649474087,67634,29480173450,67634,30000000000,1500000000,1500000000
17561422625,1648365291,323640,19061422625,323640,21012824783,1500000000,1500000000
34624839019,1644746642,340059,36124839019,340059,49037352825,1500000000,1500000000
34624839019,1644746642,334344,36124839019,334344,50960221170,1500000000,1500000000
75230538989,1643118210,326749,76730538989,326749,98652614252,1500000000,1500000000
46775769748,1649541762,66754,48275769748,61954,48441839473,1500000000,1500000000
71774235325,1644776178,67634,73274235325,62834,95235974664,1500000000,1500000000
88815845523,1642444220,67634,90315845523,67634,103599596273,1500000000,1500000000
108552270962,1643150899,323557,110052270962,323557,156831301584,1500000000,1500000000
71702021342,1648741383,55580,73702021342,50780,108794716633,2000000000,2000000000
55109411791,1648757947,55680,56609411791,50880,71277919924,1500000000,1500000000
77846899438,1645281587,54760,80000000000,49960,80000000000,2211000000,2153100562
21830412354,1648377204,317330,23330412354,317330,27531054069,1500000000,1500000000
17728150269,1648380231,326984,19228150269,326984,23945021329,1500000000,1500000000
117537326468,1642433435,330563,119537326468,330563,130000000000,2000000000,2000000000
38364791510,1648729688,54700,39864791510,49900,54767422233,1500000000,1500000000
20987923354,1648363964,67646,22487923354,62846,28449288945,1500000000,1500000000
61186195158,1646253525,60850,62686195158,56050,66647144165,1500000000,1500000000
36736188737,1648691742,67646,37786943199,62846,37786943199,1500000000,1050754462
55517140007,1648745915,67646,57017140007,62846,73581653000,1500000000,1500000000
36236450937,1645261213,332579,37736450937,332579,49362153285,1500000000,1500000000
63969194654,1645300130,343977,65469194654,343977,80895433970,1500000000,1500000000
74032670462,1646233965,60862,75532670462,56062,124741588977,1500000000,1500000000
113844016012,1642459284,67646,115344016012,62846,140848189640,1500000000,1500000000
35371966080,1645263275,55680,36871966080,50880,45944002199,1500000000,1500000000
46226462238,1645246539,54748,47726462238,49948,58630963163,1500000000,1500000000
46226462238,1645246539,328196,48226462238,328196,68832951265,2000000000,2000000000
27281357443,1648348109,67646,28781357443,62846,37580749994,1500000000,1500000000
47632284125,1644764013,55681,49132284125,50881,61994613378,1500000000,1500000000
106396102514,1642436837,55693,107896102514,50893,128277289993,1500000000,1500000000
135556788618,1643119998,60838,136818396202,60838,136818396202,1500000000,1261607584
32111909067,1649504553,60078,33611909067,55278,37107601078,1500000000,1500000000
66106193783,1645310660,320422,67756193783,320422,82248409959,1650000000,1650000000
37670325631,1645255950,67634,39170325631,67634,47000000000,1500000000,1500000000
30004865745,1646226993,319341,31504865745,319341,39201141623,1500000000,1500000000
32624470626,1646228561,60850,34124470626,56050,50017800298,1500000000,1500000000
25351569785,1648384609,314089,26851569785,314089,34779049063,1500000000,1500000000
80425945389,1642416970,54861,82925945389,54861,183377839158,2500000000,2500000000
40262622252,1649542282,63200,41762622252,63200,83719451368,1500000000,1500000000
26190033908,1648707580,321678,28190033908,321678,38293620111,2000000000,2000000000
95778115163,1643075855,323102,97278115163,323102,115216373060,1500000000,1500000000
40773116116,1649526455,329259,42273116116,329259,52533580907,1500000000,1500000000
159814500118,1642391474,67646,161614955517,62846,,,
172677045313,1642387892,67646,174177045313,62846,214603622338,1500000000,1500000000
180358107350,1642454729,59970,181858107350,55170,188849909160,1500000000,1500000000
81878732560,1643126531,60862,83378732560,56062,117707839523,1500000000,1500000000
87622849237,1643109802,67634,89122849237,62834,110621545137,1500000000,1500000000
33729833857,1648728734,54849,35229833857,50049,54004855228,1500000000,1500000000
82580089178,1643106758,55705,84080089178,50905,97564573447,1500000000,1500000000
62958748446,1643114334,66766,64458748446,66766,83226617555,1500000000,1500000000
48572774390,1649548485,200000,48874316117,200000,48874316117,1000000000,301541727
29110612426,1649485562,64132,30610612426,54532,33849885003,1500000000,1500000000
28904316543,1648717603,56705,30404316543,47105,40678504799,1500000000,1500000000
35547675571,1646229138,331153,37047675571,331153,50029035793,1500000000,1500000000
133475090984,1642436322,55705,134975090984,50905,154114514108,1500000000,1500000000
83283387291,1646234012,60862,85283387291,56062,102208720839,2000000000,2000000000
18855873362,1648350819,323793,20355873362,323793,25879283115,1500000000,1500000000
31544607348,1644757612,54308,33044607348,54308,35543014622,1500000000,1500000000
28340075885,1649542801,63200,29840075885,63200,52529621298,1500000000,1500000000
55459025008,1648759932,60962,56959025008,56162,58260270185,1500000000,1500000000
43703930824,1645253787,67622,51000000000,67622,,,
59757447585,1646244410,60850,81757447585,60850,2500000000000,22000000000,22000000000
59116834394,1646182591,316195,60616834394,316195,68492356423,1500000000,1500000000
84184174033,1642422626,343813,85684174033,343813,103831964987,1500000000,1500000000
85133730771,1642408723,67622,86633730771,67622,95887681750,1500000000,1500000000
73703388668,1643103159,346358,77754553464,346358,,,
65933759195,1645297197,59994,67433759195,59994,79910819884,1500000000,1500000000
159246002535,1642454107,60862,160746002535,56062,223347802167,1500000000,1500000000
19289917208,1648385794,320493,20789917208,320493,27293929947,1500000000,1500000000
16381920687,1648367300,320447,17881920687,320447,22930672188,1500000000,1500000000
70623166826,1642417943,328214,72123166826,251414,99490224219,1500000000,1500000000
70623166826,1642417943,328214,72123166826,328214,87149668474,1500000000,1500000000
129849271059,1643148851,67634,131349271059,62834,195422964804,1500000000,1500000000
226965800586,1643071530,67634,228631744595,62834,291387817581,1665944009,1665944009
42619120824,1646228069,55592,44119120824,50792,44831712284,1500000000,1500000000
77243590532,1645283548,54808,78743590532,50008,100581282188,1500000000,1500000000
106693041203,1643069583,337468,108193041203,337468,172922034642,1500000000,1500000000
83482248657,1643105088,60862,84982248657,56062,95959735463,1500000000,1500000000
85227472819,1642431875,55636,87727472819,55636,180130272484,2500000000,2500000000
95091353550,1642411672,323573,96591353550,323573,99089897830,1500000000,1500000000
58748451732,1649463418,49483,60248451732,49483,69325254742,1500000000,1500000000
94370751869,1642400561,60850,95870751869,56050,124931881817,1500000000,1500000000
54169263192,1643109342,326068,55669263192,326068,86648083000,1500000000,1500000000
88450242270,1643093173,336855,90100242270,336855,123532452418,1650000000,1650000000
73640279777,1643095724,339977,75140279777,339977,106817981393,1500000000,1500000000
103543154015,1646239335,60862,105043154015,56062,119056661224,1500000000,1500000000
96145570957,1642423599,64729,97645570957,59929,113387446160,1500000000,1500000000
113755512728,1642397415,337482,115255512728,337482,132136227437,1500000000,1500000000
34794767293,1648691835,56480,36294767293,51680,47041408200,1500000000,1500000000
67270604316,1646235666,60862,69270604316,56062,93143286433,2000000000,2000000000
12819251246,1648380328,64741,14819251246,59941,25000000000,2000000000,2000000000
32894929842,1649524569,319781,34394929842,319781,35000000000,1500000000,1500000000
33736324549,1649546063,66754,35236324549,61954,40788277172,1500000000,1500000000
100135840924,1645283245,336893,101635840924,336893,121286815202,1500000000,1500000000
37216011946,1648421835,337490,40000000000,337490,40000000000,3000000000,2783988054
37457633055,1648424921,66730,38957633055,66730,51979861127,1500000000,1500000000
136822528640,1642396457,67634,138322528640,62834,167205274454,1500000000,1500000000
27332953441,1649472546,316544,28832953441,316544,41351218093,1500000000,1500000000
17465218941,1648385377,67710,28927728013,67710,,,
112357825339,1642382606,343179,113857825339,343179,172525449618,1500000000,1500000000
124946180177,1642400231,67634,126147030969,62834,126147030969,1500000000,1200850792
105536136764,1643114012,336897,107036136764,336897,144937025869,1500000000,1500000000
35888081153,1648691857,54332,37388081153,49532,50708491490,1500000000,1500000000
166530167986,1643130001,328833,167940167986,328833,184023245373,1410000000,1410000000
112840716446,1643075303,67646,114340716446,62846,129492261024,1500000000,1500000000
41717767353,1649469762,67634,43217767353,67634,63932889145,1500000000,1500000000
98847848006,1643089182,67622,100347848006,67622,112587458790,1500000000,1500000000
38053857464,1649478493,333708,40053857464,333708,47733577424,2000000000,2000000000
29107599986,1649505810,54676,30532528714,54676,30532528714,1500000000,1424928728
81374885720,1646179223,54921,83374885720,50121,200000000000,2000000000,2000000000
92203412964,1642424190,59994,93703412964,55194,114315529962,1500000000,1500000000
99606731365,1642424311,338736,101106731365,338736,128421621893,1500000000,1500000000
92344350778,1643126970,56516,93844350778,51716,105386209804,1500000000,1500000000
45318004064,1649514636,329245,46818004064,329245,56206845118,1500000000,1500000000
40581958213,1646203652,67634,42081958213,67634,44386989864,1500000000,1500000000
24848581121,1644736838,55693,26348581121,50893,28000000000,1500000000,1500000000
76287939162,1643105938,340633,77787939162,340633,88447836820,1500000000,1500000000
46772289966,1644744005,56516,48272289966,51716,53562289270,1500000000,1500000000
51891470530,1645247559,55680,53391470530,50880,62520981747,1500000000,1500000000
38692814665,1649514970,55580,40192814665,55580,48280963854,1500000000,1500000000
31254423814,1649533052,60938,32754423814,56138,44778898107,1500000000,1500000000
43376255430,1649526049,67634,44876255430,62834,61302076465,1500000000,1500000000
190198477871,1643144271,326880,191698477871,326880,251371665702,1500000000,1500000000
22762206537,1648720325,60938,24039858130,56138,24039858130,1410000000,1277651593
40124794706,1644734601,67634,43034794706,62834,59303863947,2910000000,2910000000
37360491516,1648409447,60862,38860491516,56062,44532867098,1500000000,1500000000
182824914931,1643132478,337476,184324914931,337476,198400337042,1500000000,1500000000
23484872932,1649503918,332426,24696923117,332426,24696923117,1500000000,1212050185
23058896484,1649500235,64032,24558896484,59232,30515517582,1500000000,1500000000
43622188072,1648733298,300244,44585489944,300244,44585489944,1500000000,963301872
28758628458,1648691135,67622,30258628458,67622,41112360369,1500000000,1500000000
60217810435,1645247837,67634,61717810435,67634,75695354738,1500000000,1500000000
72224734082,1646243344,60862,73724734082,56062,76565896673,1500000000,1500000000
68302298512,1646246238,60838,69802298512,56038,95375441088,1500000000,1500000000
138065151665,1643128868,60030,139565151665,55230,151653192915,1500000000,1500000000
48238439054,1649463322,67634,49738439054,67634,68716204812,1500000000,1500000000
75831471141,1645231039,320503,77331471141,320503,88945041115,1500000000,1500000000
70561940665,1646256928,60838,72061940665,56038,72868252989,1500000000,1500000000
33697054838,1646225964,54700,35197054838,49900,47349929872,1500000000,1500000000
58138193893,1646239678,67646,59638193893,62846,82603698765,1500000000,1500000000
75856087713,1643100381,343213,77356087713,343213,79699731149,1500000000,1500000000
38063656907,1649521861,64032,39563656907,64032,53735335290,1500000000,1500000000
75955531319,1645293605,334328,77455531319,334328,86936024360,1500000000,1500000000
59612311452,1646238199,67634,61112311452,67634,80894938404,1500000000,1500000000
17638182078,1648381322,67634,19138182078,62834,21853008873,1500000000,1500000000
56492184103,1644775670,66742,57992184103,61942,65414862122,1500000000,1500000000
87993628421,1642415039,326077,89493628421,326077,125998645424,1500000000,1500000000
69597836514,1642420701,60862,72000000000,56062,,,
69597836514,1642420701,67646,72000000000,62846,,,
69597836514,1642420701,49519,72000000000,44719,,,
90800711602,1643090877,340061,92300711602,340061,124703976897,1500000000,1500000000
39233213970,1649536714,67634,40733213970,62834,52816244892,1500000000,1500000000
41855472722,1644748695,331069,43355472722,331069,53620587150,1500000000,1500000000
162276580773,1642442865,67646,163776580773,62846,178928957294,1500000000,1500000000
82695646252,1643069836,328765,84195646252,328765,104715077775,1500000000,1500000000
113169246843,1643150567,55804,114669246843,51004,141176445832,1500000000,1500000000
78019530994,1646264919,55592,79519530994,50792,108450396360,1500000000,1500000000
20455371632,1648364080,333744,21955371632,333744,24816313322,1500000000,1500000000
16419042753,1648382830,317324,17919042753,317324,22841181282,1500000000,1500000000
117848299667,1642458875,55648,120348299667,55648,273641312104,2500000000,2500000000
120623550095,1642402912,56480,122123550095,56480,169846984050,1500000000,1500000000
132918765356,1642443307,356666,134418765356,356666,179157203227,1500000000,1500000000
96329673306,1642407214,60838,97829673306,60838,168283651153,1500000000,1500000000
166888530479,1643148822,332456,168388530479,332456,189300704222,1500000000,1500000000
32721670636,1649464264,55705,34221670636,50905,41092119708,1500000000,1500000000
30919454092,1649494420,60862,32419454092,56062,45551542509,1500000000,1500000000
58392568043,1646246713,331159,59892568043,331159,83799360695,1500000000,1500000000
50539235445,1648688389,67622,51422282045,67622,51422282045,1500000000,883046600
30818884682,1649526672,330555,32318884682,330555,43241876442,1500000000,1500000000
33755766587,1649518778,60862,35255766587,56062,53376498692,1500000000,1500000000
25860002406,1649511992,60862,27360002406,56062,33595942454,1500000000,1500000000
30361362303,1649466552,303417,31861362303,303417,43022534609,1500000000,1500000000
30361362303,1649466552,314077,31861362303,314077,43022534609,1500000000,1500000000
105869393434,1646237192,67658,107369393434,62858,141077451655,1500000000,1500000000
38131841407,1648401029,55705,39631841407,50905,40475401779,1500000000,1500000000
90228178376,1642413560,64729,91728178376,59929,110624870857,1500000000,1500000000
36401315357,1649516238,49607,37901315357,44807,40056452059,1500000000,1500000000
31800136778,1646229155,328002,33300136778,328002,45911352100,1500000000,1500000000
38559668720,1646256227,60850,40059668720,60850,54112065203,1500000000,1500000000
43634170862,1648397658,307732,45634170862,307732,57836020178,2000000000,2000000000
84723913613,1642414039,340635,86223913613,340635,108816517858,1500000000,1500000000
123034583666,1643082562,340671,124534583666,340671,134187798219,1500000000,1500000000
32022915022,1649488173,60006,34022915022,55206,40312872372,2000000000,2000000000
63749734339,1645294517,67634,65249734339,62834,74612411084,1500000000,1500000000
62907333525,1645243309,323636,64407333525,323636,73062743412,1500000000,1500000000
155469764677,1642450077,66814,156969764677,66814,157263167560,1500000000,1500000000
87738583599,1643106792,67646,89238583599,62846,97564573447,1500000000,1500000000
37160597445,1645256394,59970,38660597445,55170,61946428947,1500000000,1500000000
66674864234,1646250321,60862,68174864234,56062,93996604937,1500000000,1500000000
202334556522,1643140704,55592,203834556522,50792,240359375132,1500000000,1500000000
83933631717,1643101006,334268,85433631717,334268,107152204989,1500000000,1500000000
26831379323,1648722691,67646,28331379323,62846,34037661090,1500000000,1500000000
18139322430,1648361485,323652,19639322430,323652,27182622467,1500000000,1500000000
107809339367,1642460183,322969,109309339367,322969,126202947970,1500000000,1500000000
28386134331,1649478533,60926,29886134331,60926,38425953582,1500000000,1500000000
35546172543,1649535746,330002,37046172543,330002,48350448002,1500000000,1500000000
34409498956,1649499896,67646,35909498956,62846,40570069188,1500000000,1500000000
83020768477,1643106901,318625,84520768477,318625,104931966157,1500000000,1500000000
72218152359,1643102895,66766,73718152359,66766,93446757558,1500000000,1500000000
32174211072,1649545091,327600,33674211072,327600,42537461439,1500000000,1500000000
110552407345,1646237320,59934,112052407345,55134,134466088734,1500000000,1500000000
70671308505,1646234968,55592,72171308505,50792,84170506875,1500000000,1500000000
21390836947,1648389699,317300,22890836947,317300,28184600360,1500000000,1500000000
143641966401,1642456412,67646,145141966401,62846,154784359360,1500000000,1500000000
60693727642,1648761563,64741,62193727642,59941,83248295609,1500000000,1500000000
37478937238,1644737680,326100,38978937238,326100,50719591240,1500000000,1500000000
111175361442,1642399441,60042,112675361442,55242,184372733609,1500000000,1500000000
180596122395,1643151625,55828,182096122395,51028,212291535240,1500000000,1500000000
27520582171,1649504734,331155,29560813822,331155,,,
21128703260,1649501880,317340,22628703260,317340,32600825825,1500000000,1500000000
61951773620,1646240047,64056,63451773620,59256,96573172569,1500000000,1500000000
19364121742,1648372581,312314,20864121742,312314,29350504047,1500000000,1500000000
79124195206,1643109698,56504,80624195206,51704,99118351420,1500000000,1500000000
81308313863,1642436545,340625,82808313863,340625,83528123454,1500000000,1500000000
159532731533,1643120812,319767,161032731533,319767,171523731123,1500000000,1500000000
154541031638,1642463054,59970,156041031638,59970,188170610019,1500000000,1500000000
34667194659,1645251788,54748,36167194659,49948,39691379060,1500000000,1500000000
83306887867,1643097271,340639,84806887867,340639,101544801938,1500000000,1500000000
125280468886,1643126024,319807,126780468886,319807,155690551644,1500000000,1500000000
125280468886,1643126024,60078,126780468886,60078,141900600640,1500000000,1500000000
125280468886,1643126024,327970,126780468886,327970,150948488552,1500000000,1500000000
34253146441,1645250044,55592,36253146441,55592,86023725606,2000000000,2000000000
96188132689,1642427105,340651,97688132689,340651,98082094408,1500000000,1500000000
28305159600,1649500699,300198,31305159600,241893,150000000000,3000000000,3000000000
39974301340,1648770978,66718,41474301340,66718,53463874017,1500000000,1500000000
125619699062,1642437805,60850,127119699062,56050,152051249800,1500000000,1500000000
79092582607,1646236172,60850,80742582607,56050,106516479692,1650000000,1650000000
79092582607,1646236172,55592,81092582607,50792,111217138879,2000000000,2000000000
161537889067,1642449871,49483,163037889067,44683,212400154109,1500000000,1500000000
181554200576,1643145038,56492,183288806479,56492,235077324905,1734605903,1734605903
181554200576,1643145038,55693,183397760894,55693,318364127404,1843560318,1843560318
48473850336,1649525976,60862,49973850336,56062,64639057964,1500000000,1500000000
32814861525,1646231908,67634,34314861525,62834,37961045944,1500000000,1500000000
146004947701,1642457455,333702,147504947701,333702,163780207098,1500000000,1500000000
84561763134,1643127006,60862,86061763134,56062,105386209804,1500000000,1500000000
84561763134,1643127006,55580,86061763134,50780,105386209804,1500000000,1500000000
154379500354,1643137248,60850,155879500354,56050,204058622322,1500000000,1500000000
106935524199,1643098025,340061,108435524199,340061,143831773295,1500000000,1500000000
40164883405,1648770912,321088,41664883405,321088,57689898688,1500000000,1500000000
26964847093,1648690743,55717,28964847093,50917,36556210830,2000000000,2000000000
39672135040,1648685364,327447,41172135040,327447,45572199079,1500000000,1500000000
87660188424,1646235441,67646,89160188424,62846,128081080502,1500000000,1500000000
110798235049,1643128661,55592,112298235049,50792,179766686912,1500000000,1500000000
25645752003,1649510099,66766,27145752003,61966,30170772734,1500000000,1500000000
22954875797,1649502585,340059,24954875797,340059,28526131675,2000000000,2000000000
69935018415,1648743484,66754,71435018415,66754,88203152928,1500000000,1500000000
25315667171,1648394971,60850,26815667171,56050,33909424982,1500000000,1500000000
105933853437,1642440398,67646,107433853437,62846,135510964127,1500000000,1500000000
216709529653,1642389435,320386,218209529653,320386,250000000000,1500000000,1500000000
90151567836,1646235327,67646,91651567836,62846,102683076810,1500000000,1500000000
18816088255,1648390357,66766,20316088255,61966,31178255098,1500000000,1500000000
43211525103,1649462830,67646,44211525103,62846,47134900600,1000000000,1000000000
37264915022,1649548637,308984,38764915022,308984,48410335099,1500000000,1500000000
37264915022,1649548637,55705,38764915022,50905,49960658120,1500000000,1500000000
37264915022,1649548637,60850,38764915022,56050,44525299850,1500000000,1500000000
66267012826,1646239908,67634,67767012826,67634,88296471297,1500000000,1500000000
53079736059,1648412479,320521,54579736059,320521,68302600772,1500000000,1500000000
31290223755,1644732009,54332,34290223755,49532,222000000000,3000000000,3000000000
111375802003,1642429167,340023,112875802003,340023,159025820807,1500000000,1500000000
137274099443,1643130526,336875,138825099443,336875,170000000000,1551000000,1551000000
39894778934,1648770971,307758,41394778934,307758,54915159899,1500000000,1500000000
44254071791,1645250733,55592,45754071791,50792,46511565203,1500000000,1500000000
133966321194,1642460541,333177,135466321194,333177,150358559673,1500000000,1500000000
87494564147,1643118096,323537,89494564147,323537,119778119413,2000000000,2000000000
54260203793,1649463359,60862,55760203793,60862,61798048818,1500000000,1500000000
52315856904,1646252610,55592,53815856904,50792,66311243188,1500000000,1500000000
123182835883,1642378216,60862,124814926577,56062,144743749852,1632090694,1632090694
42338381629,1645268604,331985,44338381629,331985,53976662698,2000000000,2000000000
102102633053,1643085558,323585,103602633053,323585,132776757778,1500000000,1500000000
67327948708,1643108693,328865,68827948708,328865,82929351844,1500000000,1500000000
44257376407,1648693075,67634,45757376407,67634,51138467809,1500000000,1500000000
108480581428,1643116276,327994,109980581428,327994,120919593720,1500000000,1500000000
68633223342,1643101704,340673,70133223342,340673,81385897444,1500000000,1500000000
31428940220,1649544675,63200,32928940220,63200,71798491904,1500000000,1500000000
31428940220,1649544675,67646,32928940220,62846,47827678255,1500000000,1500000000
31103319534,1649491975,60950,32603319534,56150,44273996938,1500000000,1500000000
36216186339,1646232094,67634,37716186339,62834,52264318495,1500000000,1500000000
36216186339,1646232094,67622,37716186339,67622,52264318495,1500000000,1500000000
45688706610,1644724488,317172,47188706610,317172,61199129440,1500000000,1500000000
34692436567,1649487530,6721975,41000000000,62846,,,
37657797396,1649537202,54759,39157797396,49959,46910993787,1500000000,1500000000
34885305826,1645272074,317312,36385305826,317312,40263173370,1500000000,1500000000
55994183928,1645233418,54664,57494183928,49864,76000000000,1500000000,1500000000
73771500566,1646246470,55592,75271500566,50792,103314683070,1500000000,1500000000
96997209641,1646242605,67622,98497209641,62822,119289578165,1500000000,1500000000
94721836970,1643096836,343225,96221836970,343225,99376123528,1500000000,1500000000
144048335429,1643137208,54921,145548335429,50121,300000000000,1500000000,1500000000
230745722992,1642454605,64729,232245722992,59929,312527436492,1500000000,1500000000
106504625827,1643117387,328008,108004625827,328008,111000000000,1500000000,1500000000
49620318034,1646206199,346959,51120318034,346959,63222837000,1500000000,1500000000
25052531326,1648395218,66778,26552531326,61978,27930193073,1500000000,1500000000
22492580306,1649496969,317316,24492580306,317316,155000000000,2000000000,2000000000
82990970179,1648755511,67634,84490970179,62834,91747966482,1500000000,1500000000
29333341652,1649547878,55720,30833341652,50920,200000000000,1500000000,1500000000
25996746945,1648722902,319915,27496746945,319915,36505510793,1500000000,1500000000
79662696335,1646253238,60850,81162696335,56050,82811671583,1500000000,1500000000
160614955517,1642391260,60862,175003483494,56062,,,
81925258134,1642421426,59958,83425258134,59958,85573647472,1500000000,1500000000
74491281119,1648754702,54832,75991281119,50032,96296776480,1500000000,1500000000
59874220893,1645311446,64741,61374220893,59941,64712045183,1500000000,1500000000
91182036252,1642415388,60862,92682036252,56062,116191429558,1500000000,1500000000
24349663247,1649525160,49483,25849663247,44683,31707126415,1500000000,1500000000
66446648978,1646183440,60862,67101540543,56062,67101540543,1500000000,654891565
38819018538,1645237093,326038,40000000000,326038,40000000000,1410000000,1180981462
88663534796,1642420313,343811,90163534796,343811,103434253479,1500000000,1500000000
65316105205,1646257937,67646,67316105205,62846,81265422949,2000000000,2000000000
137291800390,1643120648,339977,138791800390,339977,163244716155,1500000000,1500000000
42263740960,1649536414,67646,43763740960,62846,52405506243,1500000000,1500000000
25799089898,1649490862,55680,27799089898,50880,40070865425,2000000000,2000000000
84798292003,1645291560,343233,86298292003,343233,120338754318,1500000000,1500000000
74546055956,1646239969,60862,76046055956,56062,94678989410,1500000000,1500000000
226629853721,1643145603,54908,228129853721,50108,275783168442,1500000000,1500000000
90617808681,1646236300,60926,92117808681,60926,110720200143,1500000000,1500000000
62668889856,1644452593,331484,64078889856,331484,72736888121,1410000000,1410000000
45632889548,1644472779,336893,47132889548,336893,52206290545,1500000000,1500000000
53037851213,1644460721,334671,54537851213,334671,67773472837,1500000000,1500000000
52859819843,1644474741,331518,54359819843,331518,68987917813,1500000000,1500000000
64354508509,1644467496,340027,65854508509,340027,67976243142,1500000000,1500000000
75063942943,1644462983,331504,76563942943,331504,81000000000,1500000000,1500000000
51516701370,1644474899,54284,53016701370,54284,53280366997,1500000000,1500000000
51516701370,1644474899,312912,53016701370,312912,53280366997,1500000000,1500000000
40996018391,1644473065,49519,42496018391,44719,56015358308,1500000000,1500000000
65019884518,1644455707,67646,67019884518,62846,90882946401,2000000000,2000000000
67901968068,1644467860,56504,69401968068,51704,76949526712,1500000000,1500000000
103643099108,1644462367,54296,105143099108,54296,120383347298,1500000000,1500000000
44736857355,1644469883,54332,46236857355,49532,73351815024,1500000000,1500000000
51689865020,1644478052,54320,53189865020,49520,73065437063,1500000000,1500000000
62617589386,1644472287,336887,64117589386,336887,81665685988,1500000000,1500000000
63794081789,1644469667,60850,65294081789,56050,80929580214,1500000000,1500000000
37618011591,1644477614,320390,39118011591,320390,48099511152,1500000000,1500000000
61451505450,1644457047,54308,62951505450,54308,89851180288,1500000000,1500000000
50523408626,1644472823,337506,52023408626,337506,52206290545,1500000000,1500000000
62836308808,1644470710,54332,64336308808,49532,70579366012,1500000000,1500000000
51848035973,1644455751,54332,53348035973,49532,70704062408,1500000000,1500000000
82563368311,1644453579,60850,84063368311,56050,109664862994,1500000000,1500000000
77103232609,1644452563,337530,78603232609,337530,90263022734,1500000000,1500000000
73492594914,1644469494,337526,74992594914,337526,81694847155,1500000000,1500000000
80223967570,1644465942,54332,81774967570,49532,94590008048,1551000000,1551000000
55510474746,1644466933,56468,57010474746,56468,65054071873,1500000000,1500000000
55510474746,1644466933,323569,57010474746,323569,80673560157,1500000000,1500000000
52662529493,1644457636,343169,54162529493,343169,79772564500,1500000000,1500000000
62923087318,1644457846,54332,64423087318,49532,77533845604,1500000000,1500000000
57745984948,1644459328,54322,59245984948,54322,64000000000,1500000000,1500000000
80266826830,1644459269,332549,81766826830,332549,95001889202,1500000000,1500000000
131233801889,1644463747,54332,132733801889,49532,158973670240,1500000000,1500000000
47993943747,1644474666,315267,49493943747,315267,54829000423,1500000000,1500000000
69534876554,1644452837,55717,71034876554,50917,86140501863,1500000000,1500000000
74108416831,1644463192,54332,75608416831,49532,101962877188,1500000000,1500000000
56889343738,1644469644,60030,58389343738,55230,71235325498,1500000000,1500000000
39686037518,1644470033,331526,41186037518,331526,46000000000,1500000000,1500000000
67589757862,1641053944,67634,69089757862,67634,83417980275,1500000000,1500000000
71370956889,1641048535,67634,73370956889,62834,90213894528,2000000000,2000000000
55163796420,1643634150,331165,56663796420,331165,75294228289,1500000000,1500000000
88529913388,1641025877,52928,90027786630,48128,90027786630,1500000000,1497873242
72940034585,1641057044,330539,74440034585,330539,87653887256,1500000000,1500000000
85476686727,1641009634,314160,86976686727,314160,87354726657,1500000000,1500000000
65418408821,1643631835,67646,66918408821,62846,78886818178,1500000000,1500000000
48165424551,1648500457,66778,49665424551,61978,76499505328,1500000000,1500000000
25340547677,1648013046,333716,26840547677,333716,30108451787,1500000000,1500000000
74525427081,1648507781,55592,78025427081,50792,97703441782,3500000000,3500000000
61137292054,1648075451,322973,62637292054,322973,69340991165,1500000000,1500000000
44876547147,1648505699,52916,46376547147,52916,65609353067,1500000000,1500000000
42328459431,1648055931,55693,43828459431,50893,69189111602,1500000000,1500000000
38038320611,1648047153,60850,39538320611,56050,53462785690,1500000000,1500000000
87337778431,1641013303,59958,88837778431,55158,107982723366,1500000000,1500000000
59430695627,1641038214,67646,60930695627,62846,77148947750,1500000000,1500000000
27187650750,1648434185,67646,27500000000,62846,27500000000,1650000000,312349250
19600433615,1648012780,67646,20000000000,62846,20000000000,1500000000,399566385
162962495936,1643644431,310269,164462495936,310269,164552905392,1500000000,1500000000
75764682767,1641053560,333708,77264682767,333708,84958048126,1500000000,1500000000
20739293176,1648465133,328338,22239293176,328338,27404907122,1500000000,1500000000
26985320925,1647999362,307076,28485320925,307076,29915255340,1500000000,1500000000
56599267100,1648053044,67646,58099267100,67646,72610681080,1500000000,1500000000
66737181392,1648478306,60850,68237181392,56050,85908638562,1500000000,1500000000
43431204263,1648008410,333692,44931204263,333692,53783724710,1500000000,1500000000
31063893088,1648064885,67634,32563893088,67634,45756242782,1500000000,1500000000
60130344568,1641051195,60850,61630344568,60850,69457630757,1500000000,1500000000
76699589114,1641060338,49519,78199589114,44719,102234686441,1500000000,1500000000
102754240715,1643590909,52916,104254240715,52916,119976548513,1500000000,1500000000
54032125142,1648079397,67646,55532125142,67646,74886737027,1500000000,1500000000
69552206815,1641004453,67634,71052206815,62834,96686136106,1500000000,1500000000
46694475449,1648511520,334276,48194475449,334276,66900000052,1500000000,1500000000
49585832518,1648511467,323644,51085832518,323644,68891466584,1500000000,1500000000
50548855161,1643631639,317332,52000000000,317332,52000000000,1500000000,1451144839
144952068165,1643649407,330557,146602068165,241883,171039468878,1650000000,1650000000
70426739482,1641005070,67646,71926739482,62846,95667293867,1500000000,1500000000
70668224409,1648052256,63200,72168224409,63200,141304327948,1500000000,1500000000
40477181701,1648055292,67634,41977181701,67634,43166252320,1500000000,1500000000
29855905797,1648047537,321624,31355905797,321624,33155491359,1500000000,1500000000
21424138575,1648039715,317320,22834138575,317320,25245731240,1410000000,1410000000
26022737965,1648033253,342691,27522737965,342691,27911455679,1500000000,1500000000
34582547203,1648054904,327175,36082547203,327175,42888186743,1500000000,1500000000
34582547203,1648054904,54095,36082547203,49295,42888186743,1500000000,1500000000
48997431509,1641021288,327321,50000000000,327321,50000000000,1500000000,1002568491
25664575766,1648027542,67634,27164575766,62834,41216544307,1500000000,1500000000
101153468426,1641071601,313435,102653468426,313435,104330169176,1500000000,1500000000
144541195759,1643668950,60838,146041195759,60838,168849839939,1500000000,1500000000
66770314598,1641059695,67622,68270314598,67622,78433015721,1500000000,1500000000
18489319650,1648031191,318810,19989319650,318810,24555237912,1500000000,1500000000
37212447421,1648009774,67634,38712447421,67634,41113436300,1500000000,1500000000
60530109829,1643617658,307004,62530109829,307004,97913114580,2000000000,2000000000
65109213150,1641025246,60850,66609213150,56050,79160617694,1500000000,1500000000
38269013379,1648050008,60850,39769013379,56050,50930992510,1500000000,1500000000
35938451148,1648440480,346927,36360240917,346927,36360240917,1500000000,421789769
67246043233,1648075505,305893,68746043233,305893,80585862005,1500000000,1500000000
46985840330,1648050425,67634,58000000000,67634,,,
76887480078,1641028145,52928,78387480078,48128,82311044234,1500000000,1500000000
31281149051,1648444882,334316,33281149051,334316,48552107825,2000000000,2000000000
29496003640,1648003465,60926,30996003640,60926,40353072178,1500000000,1500000000
87968989654,1641063926,323632,89468989654,323632,121021954382,1500000000,1500000000
48375338206,1648511567,322430,49875338206,322430,63478895537,1500000000,1500000000
69738728695,1648507517,60114,89263078505,55314,,,
46083571764,1648506777,48723,52848596667,48723,,,
89600124996,1641071026,60850,91100124996,60850,93991013459,1500000000,1500000000
82137250638,1643617946,56504,83637250638,51704,122332734227,1500000000,1500000000
45543479385,1648069506,55580,47043479385,50780,56638967854,1500000000,1500000000
49331385250,1648049949,67710,50831385250,67710,59642819324,1500000000,1500000000
36959893633,1648077011,319673,38459893633,319673,59891429452,1500000000,1500000000
60051842163,1643612311,49495,61551842163,49495,86825788200,1500000000,1500000000
59510250467,1648497778,334314,61010250467,334314,76671869995,1500000000,1500000000
28293783464,1648007737,60850,29793783464,60850,45089873033,1500000000,1500000000
38074674364,1648057438,59982,39574674364,55182,55054601968,1500000000,1500000000
74545495480,1648482929,67646,76045495480,62846,86155511295,1500000000,1500000000
142091093728,1648481028,67646,144091093728,62846,166208308740,2000000000,2000000000
16934818261,1648021015,52904,18434818261,52904,27304035473,1500000000,1500000000
26607040919,1648460350,67622,28107040919,67622,32287022244,1500000000,1500000000
61381752642,1641023025,322480,62881752642,322480,65702664752,1500000000,1500000000
66011303124,1641004231,316536,67511303124,316536,84000000000,1500000000,1500000000
62732887057,1641040171,67646,64232887057,62846,73299326600,1500000000,1500000000
23052758750,1648041335,60838,24552758750,56038,30587977195,1500000000,1500000000
27310597219,1648064980,67646,28810597219,62846,42974319205,1500000000,1500000000
38707265238,1648061058,60850,40207265238,56050,51133209215,1500000000,1500000000
49615099277,1641035499,67634,51115099277,67634,61686320492,1500000000,1500000000
59498804776,1641030513,55705,60998804776,50905,61000000000,1500000000,1500000000
26704703626,1648452491,67634,28204703626,62834,35128707398,1500000000,1500000000
49133248015,1648078359,326016,50633248015,326016,60000000000,1500000000,1500000000
23048117353,1648013979,67646,24548117353,62846,32449429475,1500000000,1500000000
51570974923,1641041700,314180,53070974923,314180,62522386522,1500000000,1500000000
104050861819,1643596439,52928,105550861819,48128,134587220449,1500000000,1500000000
44064033369,1648510887,339987,45564033369,339987,49910951516,1500000000,1500000000
91206348037,1643591350,64741,92706348037,59941,100000000000,1500000000,1500000000
124108276867,1643667726,60862,131000000000,56062,,,
55675434521,1643632722,55580,57175434521,50780,67001409223,1500000000,1500000000
49252927409,1648078574,60850,50752927409,56050,70777917308,1500000000,1500000000
67500450085,1648073178,67634,69000450085,67634,114636872924,1500000000,1500000000
60888217646,1648490360,60862,63505835778,56062,,,
186668821954,1643655355,65530,188168821954,60730,205223041915,1500000000,1500000000
45803635370,1648509772,326824,47303635370,326824,67166348919,1500000000,1500000000
154073137032,1643658575,54095,155573137032,49295,184457633442,1500000000,1500000000
57087989439,1641041973,60838,58587989439,60838,64728736247,1500000000,1500000000
51550525851,1648074319,55580,53166491540,50780,73278740524,1615965689,1615965689
86704299232,1641025768,67646,88204299232,62846,105243545861,1500000000,1500000000
34993716817,1648050018,331157,36493716817,331157,48210644924,1500000000,1500000000
20515179367,1648014940,55693,22015179367,50893,27294377174,1500000000,1500000000
186760528809,1643662059,49495,188260528809,44695,212326133639,1500000000,1500000000
30382524544,1647997261,67634,31882524544,62834,37829035934,1500000000,1500000000
16198800809,1648025202,67634,17698800809,67634,18788867760,1500000000,1500000000
148704829407,1643646006,49495,150204829407,44695,152796340027,1500000000,1500000000
22087431549,1648016154,60838,23587431549,60838,28010925179,1500000000,1500000000
49589200841,1648060918,59958,51089200841,59958,68849166973,1500000000,1500000000
43708484087,1648506898,303345,45208484087,303345,53171389484,1500000000,1500000000
41073370771,1648053521,67634,55000000000,67634,,,
56532602962,1641017689,60862,58032602962,56062,84238575623,1500000000,1500000000
99363404906,1641076796,67646,100883404906,62846,102100000000,1520000000,1520000000
55547009435,1641038795,55681,57047009435,50881,78990685278,1500000000,1500000000
162378051747,1648484883,340057,163878051747,340057,216254338769,1500000000,1500000000
35460973494,1648433542,331139,36960973494,331139,48001171399,1500000000,1500000000
94856455407,1641076884,49495,96356455407,49495,118322887476,1500000000,1500000000
91774389444,1641063494,67634,93274389444,62834,121103215436,1500000000,1500000000
19554921028,1648452877,320475,21054921028,320475,29211274637,1500000000,1500000000
99434375945,1643616587,320589,100934375945,314120,120193266815,1500000000,1500000000
59729331188,1648066291,60850,61139331188,56050,63494635375,1410000000,1410000000
68369775711,1643602212,316574,69869775711,316574,89322024682,1500000000,1500000000
50038371909,1648075214,343348,51538371909,343348,59176220434,1500000000,1500000000
63095363145,1648053898,55720,64595363145,50920,300000000000,1500000000,1500000000
63095363145,1648053898,322490,64595363145,322490,70212720552,1500000000,1500000000
92793131470,1641078207,67634,93834781871,67634,93834781871,1500000000,1041650401
56714444351,1641027041,60862,58214444351,56062,74991474318,1500000000,1500000000
56008806738,1641033884,67646,57508806738,62846,59000000000,1500000000,1500000000
25455683562,1648468674,56504,26955683562,51704,32413826653,1500000000,1500000000
117054328493,1643642572,56516,118554328493,51716,162820296545,1500000000,1500000000
22576896080,1648039492,67634,24076896080,62834,30169198408,1500000000,1500000000
48287520030,1648050728,67634,49787520030,67634,51505851937,1500000000,1500000000
46329442960,1648076948,63200,47829442960,63200,94068399952,1500000000,1500000000
66846553919,1641011196,331155,67100000000,331155,67100000000,2200000000,253446081
75752764625,1641021532,67634,77252764625,67634,88882664778,1500000000,1500000000
66394423118,1648509313,66898,87501075446,62098,,,
17383872509,1648465731,322903,18883872509,322903,24260136814,1500000000,1500000000
45541459673,1648048127,67634,47041459673,62834,66421133063,1500000000,1500000000
108235331612,1648058137,60850,110060677612,56050,147287334250,1825346000,1825346000
90489489649,1641076744,60850,92009489649,60850,102100000000,1520000000,1520000000
60137495996,1648497744,60850,61637495996,56050,71669319665,1500000000,1500000000
61209307795,1643622559,327385,62619307795,327385,70815876644,1410000000,1410000000
85921181713,1641009147,60850,87421181713,56050,95604089736,1500000000,1500000000
19879225945,1648451056,322462,20979225945,322462,21000000000,1100000000,1100000000
51229258680,1641045086,64717,52729258680,59917,58937928143,1500000000,1500000000
82782223138,1641012694,307690,84282223138,307690,102108924569,1500000000,1500000000
174856890889,1643670221,67646,175011511890,62846,175011511890,1500000000,154621001
19780480857,1648036874,60850,21280480857,56050,27274456870,1500000000,1500000000
61907560447,1641041042,60850,63407560447,60850,67748785767,1500000000,1500000000
112579714813,1643673047,60862,114079714813,56062,162762728753,1500000000,1500000000
60059447353,1648076781,66730,61559447353,66730,70605723530,1500000000,1500000000
23959074871,1648025851,67634,25459074871,67634,28513751594,1500000000,1500000000
45680644325,1648427779,331165,47180644325,331165,58129767033,1500000000,1500000000
45254454332,1648067075,67646,47254454332,62846,69863458892,2000000000,2000000000
25325466814,1647995686,310303,25825466814,310303,28000000000,500000000,500000000
96923768951,1641065173,314046,98423768951,314046,110646785720,1500000000,1500000000
34173586725,1648471572,67634,36173586725,67634,52315380435,2000000000,2000000000
49878998175,1648060852,325078,51378998175,325078,64771533147,1500000000,1500000000
72685821073,1648052110,60862,74185821073,56062,91446180573,1500000000,1500000000
72685821073,1648052110,56492,74185821073,51692,91446180573,1500000000,1500000000
70121833245,1641004684,321602,71621833245,321602,85202509836,1500000000,1500000000
78565305628,1641026866,64741,80065305628,59941,92276681534,1500000000,1500000000
70242525636,1641017516,67646,71742525636,62846,72000000000,1500000000,1500000000
18585489930,1648454997,60862,20085489930,56062,28050699899,1500000000,1500000000
58756373964,1641031409,60862,60000000000,56062,60000000000,1500000000,1243626036
86561202652,1641076633,67634,88061202652,67634,96652258372,1500000000,1500000000
29963562755,1648441457,316530,31463562755,316530,39040287762,1500000000,1500000000
44582649311,1648067489,60838,46082649311,56038,51041222729,1500000000,1500000000
66394777221,1648071413,67634,78000000000,67634,,,
65883195822,1641034540,54884,67383195822,50084,86354630109,1500000000,1500000000
56850066924,1648510327,311021,58350066924,311021,65396577780,1500000000,1500000000
89183971036,1641057562,60862,90683971036,56062,97082990118,1500000000,1500000000
77700438287,1641058284,318484,79200438287,318484,92331498651,1500000000,1500000000
23759235406,1648445029,340055,25759235406,340055,34872416171,2000000000,2000000000
28680994300,1648426673,310949,29680994300,310949,35000000000,1000000000,1000000000
80565745886,1648051795,54921,82065745886,50121,300000000000,1500000000,1500000000
50563456502,1648079266,63200,52063456502,63200,73315609102,1500000000,1500000000
29434740717,1648468056,55720,30934740717,50920,41729081602,1500000000,1500000000
37959301169,1648053414,67646,39459301169,62846,50406718859,1500000000,1500000000
23487981548,1648013176,317334,25487981548,317334,43393007853,2000000000,2000000000
112240388811,1648051906,55592,113740388811,50792,137997261612,1500000000,1500000000
66531535116,1641017020,67658,68031535116,62858,92554329382,1500000000,1500000000
57634731046,1648425669,336917,59134731046,336917,64641434718,1500000000,1500000000
110547520509,1643650590,330557,112047520509,241883,122548957953,1500000000,1500000000
62279211786,1648508622,48771,74222520413,43971,,,
61642256290,1643637289,333710,63142256290,333710,83786013708,1500000000,1500000000
63143376684,1641066676,299408,64643376684,299408,85624749622,1500000000,1500000000
65402106382,1641023220,66766,66902106382,61966,76291552263,1500000000,1500000000
34688715631,1648467459,55717,36188715631,50917,45929522697,1500000000,1500000000
113932115127,1641073574,330527,115872115127,330527,123482648154,1940000000,1940000000
21197408922,1648023647,67634,22697408922,62834,28064869590,1500000000,1500000000
18440298531,1648024931,67634,19940298531,67634,33018859613,1500000000,1500000000
72060663593,1641005082,327373,73560663593,327373,86012087379,1500000000,1500000000
39601652925,1641039445,314100,40793271108,314100,42000000000,1191618183,1191618183
91967134054,1641079954,66826,93467134054,62026,109057090676,1500000000,1500000000
95566316138,1641055717,327355,97066316138,327355,104658697979,1500000000,1500000000
63755763851,1641059757,67634,65255763851,62834,86351943395,1500000000,1500000000
81751737269,1641001772,54739,83251737269,49939,103404135550,1500000000,1500000000
99554500410,1641056544,67634,101054500410,67634,108402830552,1500000000,1500000000
79181829006,1641008535,67634,80681829006,58034,97270586354,1500000000,1500000000
17413537918,1648457264,67622,18913537918,67622,31028331377,1500000000,1500000000
38259259577,1648049696,67622,39759259577,67622,48306784410,1500000000,1500000000
16459956563,1648019411,313568,17959956563,313568,22000000000,1500000000,1500000000
34332102096,1648064741,55705,35832102096,50905,39972540522,1500000000,1500000000
82332387146,1641015095,52928,83832387146,48128,104106480731,1500000000,1500000000
38939615088,1648003676,60850,40439615088,60850,48147137385,1500000000,1500000000
62864680764,1648056288,67646,64364680764,62846,77401229433,1500000000,1500000000
48228826047,1648057357,60850,49728826047,60850,60708677457,1500000000,1500000000
83791465210,1641016026,307668,85291465210,307668,94879442914,1500000000,1500000000
83791465210,1641016026,310203,85291465210,310203,94879442914,1500000000,1500000000
19339411672,1648451320,340067,20839411672,340067,30362839237,1500000000,1500000000
70351386132,1643635641,67634,71851386132,62834,74161387878,1500000000,1500000000
55892938278,1643631656,64717,57892938278,64717,75471572018,2000000000,2000000000
20846446122,1648022905,60838,22346446122,60838,27011595042,1500000000,1500000000
31128881577,1648463024,60126,32628881577,60126,40437450454,1500000000,1500000000
16307131794,1648014903,52916,17807131794,48116,26245538033,1500000000,1500000000
48690246428,1641043140,60850,50190246428,60850,68654865569,1500000000,1500000000
67233382601,1641058402,307732,75080423232,307732,,,
71527076536,1643599769,302539,73027076536,302539,99968344932,1500000000,1500000000
46339662356,1648046014,67634,48279662356,67634,56423497398,1940000000,1940000000
106475322893,1641079221,316815,107975322893,316815,123127947009,1500000000,1500000000
238780398294,1643648324,55648,241280398294,55648,498833369594,2500000000,2500000000
44360847542,1648055769,56492,45860847542,51692,61630164207,1500000000,1500000000
79908642058,1641064147,54739,81408642058,49939,119843228782,1500000000,1500000000
159463275273,1643649427,326702,160963275273,297002,161000000000,1500000000,1500000000
31100219761,1648059205,67634,32600219761,67634,40202787362,1500000000,1500000000
67642298595,1641014027,60850,69142298595,56050,69983773365,1500000000,1500000000
34204054592,1648054723,67634,35704054592,62834,43657089625,1500000000,1500000000
71912337750,1641026797,290705,73412337750,290705,73615926630,1500000000,1500000000
142020895216,1643649997,332566,143520895216,332566,160087673719,1500000000,1500000000
17571886632,1648038292,331131,19071886632,331131,26676081483,1500000000,1500000000
81147985125,1643611215,319291,82647985125,319291,86000000000,1500000000,1500000000
52951708779,1648507382,56504,54833508779,51704,76606351947,1881800000,1881800000
16960053817,1648454659,60850,18460053817,56050,21967777770,1500000000,1500000000
82759236044,1641056367,60838,84259236044,60838,93653607538,1500000000,1500000000
62862076616,1641049664,60838,64362076616,60838,68622568121,1500000000,1500000000
26644927863,1648461118,322927,28144927863,322927,36772191920,1500000000,1500000000
71956944458,1648052101,60850,73456944458,56050,81418362557,1500000000,1500000000
93682656963,1641077721,60862,95000000000,56062,95000000000,1500000000,1317343037
53034861371,1648065472,67622,54860207371,67622,73937703213,1825346000,1825346000
105721323150,1641070529,67634,110000000000,62834,,,
17187781611,1648036531,60838,18687781611,56038,20467691337,1500000000,1500000000
26871492732,1648059825,67634,28371492732,67634,45000000000,1500000000,1500000000
32058185698,1648433608,319755,33374185698,319755,40092448512,1316000000,1316000000
74137102828,1648052127,60850,75637102828,56050,92357276342,1500000000,1500000000
46024990124,1648511576,60862,47524990124,56062,61969172758,1500000000,1500000000
42128951509,1648506863,60090,53417281853,60090,,,
15567423046,1648032436,319927,17067423046,319927,20210958177,1500000000,1500000000
55570402311,1648056756,67634,57070402311,67634,71805398498,1500000000,1500000000
57489287398,1648478144,54332,58989287398,49532,59012841819,1500000000,1500000000
53513770524,1648498515,326832,55013770524,326832,60703028695,1500000000,1500000000
17992511500,1648025477,60838,19492511500,56038,26844921898,1500000000,1500000000
31909024968,1648067853,67622,33409024968,67622,40577448822,1500000000,1500000000
53093353344,1641045679,66742,55017057211,61942,,,
38594579025,1648428297,320477,40094579025,320477,44384661658,1500000000,1500000000
119675397603,1643664416,49519,121175397603,44719,133783184302,1500000000,1500000000
51640044414,1648060903,67646,53140044414,62846,65000000000,1500000000,1500000000
99132215728,1648483521,323070,100632215728,323070,121042475160,1500000000,1500000000
51097550510,1641029027,334322,52597550510,334322,61214008472,1500000000,1500000000
51097550510,1641029027,54310,52597550510,54310,56000000000,1500000000,1500000000
118290370256,1643655982,327165,120290370256,327165,183986216277,2000000000,2000000000
41300795101,1648050580,67634,42800795101,67634,44993158713,1500000000,1500000000
59253754625,1641023553,335499,60753754625,335499,63999147426,1500000000,1500000000
56526870437,1648062685,67634,58026870437,62834,65448222455,1500000000,1500000000
45640832741,1648053597,67646,47640832741,62846,53274784626,2000000000,2000000000
49663931726,1641044963,60938,51163931726,60938,55789833203,1500000000,1500000000
62329756155,1643623985,296250,63829756155,296250,99651446243,1500000000,1500000000
36429839343,1647993645,310269,37929839343,310269,38619438245,1500000000,1500000000
41128384499,1648510941,303359,42628384499,303359,51749579725,1500000000,1500000000
19208986656,1648454578,330493,20242120510,330493,,,
79778632797,1641069690,64729,81278632797,59929,96929123627,1500000000,1500000000
30031885446,1648438760,67634,31041885446,67634,41358668897,1010000000,1010000000
28212742931,1648047688,60838,29712742931,60838,37022493494,1500000000,1500000000
73902504607,1643630100,320410,75402504607,320410,94002072984,1500000000,1500000000
115559204945,1643588459,52928,116969204945,48128,135000000000,1410000000,1410000000
88822042376,1641060705,328026,90322042376,328026,98898013602,1500000000,1500000000
38402969102,1648505777,66862,66480460824,66862,,,
49087136427,1648078391,322854,51087136427,305754,100000000000,2000000000,2000000000
25982242538,1648431942,340041,27482242538,340041,27596034613,1500000000,1500000000
41018393742,1648500480,49495,42518393742,44695,44000000000,1500000000,1500000000
24731061322,1648468653,330485,26231061322,330485,43984867442,1500000000,1500000000
87720627142,1641061541,66766,89220627142,61966,113145299622,1500000000,1500000000
20422620298,1648023698,67634,21922620298,67634,30280481247,1500000000,1500000000
86909117278,1641071031,67646,88909117278,62846,130029826752,2000000000,2000000000
88990447597,1641065144,64044,90490447597,59244,110478759854,1500000000,1500000000
63251029805,1641023607,314041,64751029805,314041,81488870177,1500000000,1500000000
36382872797,1648068143,67622,37882872797,67622,49815795854,1500000000,1500000000
30830142511,1648011732,67646,32330142511,62846,37865227495,1500000000,1500000000
46962122089,1648053074,60838,51937072234,60838,,,
56580135290,1641027267,324252,58080135290,324252,63343630614,1500000000,1500000000
97717365119,1643604128,316165,99217365119,316165,123119682407,1500000000,1500000000
16562896292,1648019826,55592,18062896292,50792,19393308259,1500000000,1500000000
57372690646,1641017118,317240,58872690646,317240,60633461726,1500000000,1500000000
20261808590,1648040077,67634,21761808590,67634,21867106668,1500000000,1500000000
79698627947,1641060768,331159,81198627947,331159,88089158381,1500000000,1500000000
58928878766,1641023436,54703,60428878766,54703,90826226158,1500000000,1500000000
115117598007,1643664039,325671,116617598007,325671,132439789342,1500000000,1500000000
115117598007,1643664039,333720,116617598007,333720,132439789342,1500000000,1500000000
108645380434,1643603423,320326,110145380434,320326,133841724079,1500000000,1500000000
73328309766,1643593622,67646,74828309766,62846,108498153597,1500000000,1500000000
51825179944,1641034817,67634,53325179944,67634,65727594233,1500000000,1500000000
51233772406,1648053757,63200,52733772406,63200,107849507896,1500000000,1500000000
53819649154,1641019305,320344,55319649154,320344,81444418499,1500000000,1500000000
90568919018,1641074886,64741,92068919018,59941,112902732436,1500000000,1500000000
65976970151,1641017159,320485,67476970151,320485,86046830050,1500000000,1500000000
43235217045,1648434675,67634,44735217045,67634,55267505400,1500000000,1500000000
17256068071,1648455402,322998,18461054215,322998,19904338537,1204986144,1204986144
126868651828,1643649925,60862,128368651828,56062,160175277125,1500000000,1500000000
42176333442,1648055270,67646,43676333442,62846,48367859620,1500000000,1500000000
56764594708,1641038306,60862,58264594708,56062,62052481245,1500000000,1500000000
43903556191,1648044599,67634,50000000000,62834,,,
60548399942,1641054936,324812,62048399942,324812,76521699869,1500000000,1500000000
53771176519,1648070052,60838,55271176519,60838,65203723299,1500000000,1500000000
71967632111,1641018191,48639,73000000000,48639,,,
72250445692,1641053521,60850,73750445692,56050,92696482982,1500000000,1500000000
90381570871,1641074359,55592,91881570871,50792,111590294007,1500000000,1500000000
127395398142,1643652939,55828,128895398142,51028,153365829554,1500000000,1500000000
66295179897,1648482908,328334,66643892459,328334,66643892459,1603309754,348712562
102091415779,1648058020,60838,103973215779,56038,152702076583,1881800000,1881800000
17844495744,1648018283,67634,19344495744,67634,24640387319,1500000000,1500000000
19883786240,1648025263,60862,21383786240,56062,22873784822,1500000000,1500000000
37430340152,1648011315,313435,38930340152,313435,47301164562,1500000000,1500000000
32427338368,1648059269,67646,33927338368,62846,44981632652,1500000000,1500000000
58202262134,1641037704,349526,59653600160,349526,59653600160,1500000000,1451338026
33089256139,1648437961,55693,34100773077,50893,34100773077,1500000000,1011516938
57137591929,1641027360,321668,58637591929,321668,59915230995,1500000000,1500000000
77148223398,1648482883,52904,78648223398,52904,100879626960,1500000000,1500000000
28255469587,1648016554,324780,29755469587,324780,40000000000,1500000000,1500000000
58408613924,1641032482,60850,59908613924,60850,66443706446,1500000000,1500000000
108453969159,1641007925,67622,109953969159,62822,138816025196,1500000000,1500000000
45068199589,1648506617,320390,46568199589,320390,62561838422,1500000000,1500000000
111016387141,1643643149,60850,112516387141,60850,135474980125,1500000000,1500000000
30902811287,1648470113,317360,32402811287,317360,43611654939,1500000000,1500000000
36102078456,1648064671,60850,37602078456,60850,47920529820,1500000000,1500000000
31166917909,1648045497,60874,32666917909,56074,36775518194,1500000000,1500000000
51453607352,1648055592,67622,52319748730,67622,52319748730,1500000000,866141378
51453607352,1648055592,60838,52319748730,56038,52319748730,1500000000,866141378
34622423161,1648072652,55693,34901860765,50893,34901860765,1410000000,279437604
70096430139,1641018046,55681,71596430139,50881,88088283443,1500000000,1500000000
70076302180,1641051754,60850,71576302180,56050,73407326412,1500000000,1500000000
33850581502,1648054207,330573,35350581502,330573,42003196084,1500000000,1500000000
29973490558,1648470361,55624,31473490558,55624,42454121314,1500000000,1500000000
95240381797,1643634785,322893,96740381797,322893,112800445640,1500000000,1500000000
81661165196,1641003484,310390,83161165196,310390,100033014663,1500000000,1500000000
16658818382,1648455775,319829,18158818382,319829,30894139507,1500000000,1500000000
71664047893,1641066900,60850,73664047893,60850,92361962662,2000000000,2000000000
50895710784,1641043231,67646,52395710784,62846,67498059417,1500000000,1500000000
65839143521,1643634337,337460,67339143521,337460,80637778017,1500000000,1500000000
39711359502,1648045755,60838,41211359502,60838,45123487367,1500000000,1500000000
53352155126,1641035594,54909,54852155126,50109,59439579224,1500000000,1500000000
77094676939,1641015808,52916,78594676939,48116,97764065040,1500000000,1500000000
42898595117,1648505855,323626,44398595117,323626,45081860495,1500000000,1500000000
18047579310,1648019607,67646,19547579310,62846,28404142097,1500000000,1500000000
26103799001,1648040749,67634,27603799001,67634,34799423473,1500000000,1500000000
139564211342,1643643198,60862,140270483927,56062,140270483927,1500000000,706272585
57103093133,1648075305,326170,58603093133,326170,72603039190,1500000000,1500000000
35031201012,1648061478,60850,36531201012,60850,45095960499,1500000000,1500000000
118743557256,1648490042,67634,120243557256,67634,139073549435,1500000000,1500000000
131320165437,1643645923,331169,132820165437,331169,137940046892,1500000000,1500000000
23219086059,1648024182,334312,24719086059,334312,27504931437,1500000000,1500000000
102849964798,1643601989,343213,104349964798,343213,155525685388,1500000000,1500000000
31627787310,1648003372,335533,33627787310,335533,44271449846,2000000000,2000000000
34153076462,1648061185,67622,35653076462,67622,43781336355,1500000000,1500000000
34405503232,1648061695,67646,35905503232,62846,42017176397,1500000000,1500000000
67203599716,1641026279,64729,68703599716,64729,78566359846,1500000000,1500000000
49300916580,1648076119,67634,50400916580,67634,52000000000,1100000000,1100000000
64286936179,1648497808,317224,65786936179,317224,82061623667,1500000000,1500000000
28286697780,1648067348,60850,29786697780,60850,38833442264,1500000000,1500000000
28199394107,1648467337,317326,29699394107,317326,36725300253,1500000000,1500000000
53721350881,1648057096,64705,55221350881,59905,56260580497,1500000000,1500000000
71775890383,1641058261,321008,73275890383,321008,92331498651,1500000000,1500000000
30809739029,1648039141,67622,32309739029,62822,36943506949,1500000000,1500000000
30468014080,1648043981,60862,31968014080,56062,40192041908,1500000000,1500000000
84799241402,1648500329,60850,86799241402,60850,126338857398,2000000000,2000000000
39004478282,1648434646,60850,40504478282,56050,60317048139,1500000000,1500000000
69511903935,1641022718,314140,70000000000,314140,70000000000,1500000000,488096065
49277909776,1648057076,55717,50777909776,50917,62834782512,1500000000,1500000000
26769107729,1648072384,60862,28269107729,56062,36553959290,1500000000,1500000000
22286058242,1648464300,67634,23786058242,62834,37312238239,1500000000,1500000000
173870461276,1643657551,67634,175370461276,67634,222443113383,1500000000,1500000000
65751435171,1643633792,327968,66751435171,327968,69413305445,1000000000,1000000000
14968766541,1648032396,333680,16468766541,333680,21431160787,1500000000,1500000000
14968766541,1648032396,331175,16468766541,331175,23184725230,1500000000,1500000000
28503733908,1648011546,67646,30003733908,62846,42106267890,1500000000,1500000000
83671705698,1641073007,67634,85171705698,62834,94579152816,1500000000,1500000000
100449481684,1643595569,55580,101949481684,50780,156751309989,1500000000,1500000000
45736856137,1648055551,60850,47236856137,56050,52319748730,1500000000,1500000000
45736856137,1648055551,60838,47236856137,56038,52319748730,1500000000,1500000000
160769484833,1643672523,337486,162269484833,337486,189991800830,1500000000,1500000000
44445783995,1648048174,60850,45945783995,56050,60576700862,1500000000,1500000000
23390245808,1648460644,340687,24890245808,340687,25000000000,1500000000,1500000000
74444188329,1643593395,60850,75944188329,56050,93946533538,1500000000,1500000000
73255767904,1641015279,67646,75255767904,62846,92752122894,2000000000,2000000000
67234937112,1641017782,52940,68734937112,48140,71000000000,1500000000,1500000000
35400418377,1648447611,64741,36900418377,59941,43736745175,1500000000,1500000000
52819082492,1641020096,67646,54319082492,62846,68223506285,1500000000,1500000000
137465684944,1643664855,60850,138965684944,56050,157957354815,1500000000,1500000000
91197286069,1648495861,67646,92697286069,62846,129143880453,1500000000,1500000000
22173128600,1648017987,317284,23673128600,317284,27342141495,1500000000,1500000000
71736921427,1643623786,67634,73236921427,62834,86493691027,1500000000,1500000000
30039658275,1648047758,67634,31539658275,67634,35558925188,1500000000,1500000000
27249700905,1648460426,54848,28749700905,54848,37273434923,1500000000,1500000000
45141031398,1648005562,327207,46641031398,327207,61427502120,1500000000,1500000000
65352999245,1641058392,330581,83184684362,330581,,,
21543438533,1648451159,60850,23043438533,60850,28149575808,1500000000,1500000000
98458502795,1643643487,330557,99958502795,330557,117635377020,1500000000,1500000000
102807099236,1648051960,67646,104307099236,62846,133630629380,1500000000,1500000000
110040697068,1641070401,67646,112040697068,62846,150645816117,2000000000,2000000000
20511357713,1648031313,328322,22011357713,328322,26393995420,1500000000,1500000000
65320780200,1648492466,305766,66820780200,305766,77768131787,1500000000,1500000000
32496869813,1648061346,67622,33996869813,67622,44635442693,1500000000,1500000000
82187842431,1641065931,67646,83687842431,62846,97221893820,1500000000,1500000000
87764252683,1641064086,67622,89264252683,67622,95121696060,1500000000,1500000000
68588609714,1641052113,60838,70088609714,60838,88387092170,1500000000,1500000000
106908593065,1641071571,319309,108408593065,319309,128651778966,1500000000,1500000000
40004681549,1648050677,67622,41504681549,67622,49698160255,1500000000,1500000000
55308288248,1641021381,63921,56808288248,59121,72706252082,1500000000,1500000000
75959171466,1641024488,314272,77459171466,307803,79773723027,1500000000,1500000000
63858026860,1641065629,67646,65358026860,62846,84921419535,1500000000,1500000000
23907883507,1648463546,322963,24345325102,322963,24345325102,1500000000,437441595
59296706205,1648062889,67634,60796706205,62834,61137348335,1500000000,1500000000
70246876776,1641067373,60862,72246876776,56062,102655717383,2000000000,2000000000
48624361105,1641023732,67646,50624361105,62846,54000000000,2000000000,2000000000
55474978610,1641029870,318462,56974978610,318462,62543167695,1500000000,1500000000
69237931405,1641067109,67634,70737931405,62834,71004797667,1500000000,1500000000
53257530341,1641019332,48627,75000000000,43827,,,
66719640413,1641052119,59994,68219640413,59994,88387092170,1500000000,1500000000
40412887747,1648057458,316604,41912887747,316604,49248114480,1500000000,1500000000
62842185313,1648052263,67634,88000000000,67634,,,
18584127475,1648037535,323143,20084127475,323143,26765927945,1500000000,1500000000
30401896679,1648028077,67634,31901896679,62834,48350455773,1500000000,1500000000
61364521365,1641047823,67634,62864521365,62834,70944134770,1500000000,1500000000
64610404350,1641059265,60850,66110404350,56050,79588206220,1500000000,1500000000
121804617034,1641070387,67646,123304617034,62846,145888333390,1500000000,1500000000
110901035490,1643593921,60850,112401035490,56050,119906855265,1500000000,1500000000
28087899807,1648060105,67634,29587899807,67634,37072379275,1500000000,1500000000
45613598670,1648056538,55668,47113598670,50868,65642038005,1500000000,1500000000
48486688030,1641030942,60850,49986688030,56050,68339657499,1500000000,1500000000
34684781381,1648053501,60850,36184781381,56050,44494901440,1500000000,1500000000
16977869010,1648017353,60850,18477869010,60850,23446480759,1500000000,1500000000
107884086742,1643591901,340039,109384086742,340039,123282082580,1500000000,1500000000
52846423658,1648075374,326150,54346423658,326150,76838761689,1500000000,1500000000
89822722800,1641016532,300180,91322722800,300180,103864841952,1500000000,1500000000
89822722800,1641016532,296974,91322722800,296974,103864841952,1500000000,1500000000
57644942062,1641060497,313413,59144942062,313413,60024267332,1500000000,1500000000
147304149914,1643642716,67622,148804149914,67622,204707588630,1500000000,1500000000
23715285745,1648065023,67634,25215285745,62834,36690223044,1500000000,1500000000
48380173482,1648078335,322844,53380173482,322844,100000000000,5000000000,5000000000
119457365265,1643587881,67634,120867365265,62834,125000000000,1410000000,1410000000
28702536400,1648005839,55592,30202536400,50792,48157129308,1500000000,1500000000
33333001856,1648055238,55668,34833001856,50868,40882964680,1500000000,1500000000
38346337716,1648059684,49495,39846337716,49495,49992456939,1500000000,1500000000
23706989965,1648465994,349450,25206989965,349450,32368947093,1500000000,1500000000
157600446039,1643646916,67634,159100446039,67634,175000000000,1500000000,1500000000
49005003073,1641021408,331203,80000000000,331203,,,
66027779514,1643614501,60862,67527779514,56062,92274098958,1500000000,1500000000
27109412933,1648027206,67634,28609412933,67634,28827218814,1500000000,1500000000
54419322448,1641050189,67634,55919322448,67634,75495531203,1500000000,1500000000
53709393774,1648501173,337041,55209393774,337041,58000000000,1500000000,1500000000
21525969235,1648464511,48627,23025969235,43827,31223361047,1500000000,1500000000
235331179948,1643648418,55580,236831179948,55580,305910496595,1500000000,1500000000
64354707652,1648074229,67646,66072175703,62846,78369707123,1717468051,1717468051
63849003489,1648063108,60838,65349003489,56038,76260878237,1500000000,1500000000
32923430949,1648049770,55580,34423430949,55580,42454617342,1500000000,1500000000
48348576847,1648062105,67634,49848576847,67634,58994531282,1500000000,1500000000
39369113452,1648064616,60862,40869113452,60862,53692485658,1500000000,1500000000
25825807000,1648459937,326703,27325807000,326703,39280994900,1500000000,1500000000
46214563605,1648048769,67634,47714563605,67634,54744202604,1500000000,1500000000
67495398408,1641061791,331125,68995398408,331125,107406247979,1500000000,1500000000
25208022408,1648456591,53498,26708022408,48698,31787425345,1500000000,1500000000
25391561958,1648020716,316742,26891561958,316742,31266776133,1500000000,1500000000
56982470688,1641027533,316173,58482470688,316173,74182919878,1500000000,1500000000
18663497199,1648465108,52916,20163497199,48116,30309047285,1500000000,1500000000
41226160799,1648476290,333686,42726160799,333686,58179917893,1500000000,1500000000
173502246723,1643669093,67646,175002246723,62846,195583061169,1500000000,1500000000
27843676500,1648457035,336847,29343676500,336847,38464708960,1500000000,1500000000
65843059958,1641004653,307064,67343059958,307064,81339223926,1500000000,1500000000
67559447314,1643613754,343215,68736193228,343215,68736193228,1500000000,1176745914
41268162560,1648066873,67622,42768162560,67622,59440589158,1500000000,1500000000
57608764460,1641019864,55705,59108764460,50905,76340649020,1500000000,1500000000
97007417303,1643588921,334318,98507417303,334318,136567789338,1500000000,1500000000
26327486821,1648021666,67622,27827486821,67622,32399256177,1500000000,1500000000
58223652644,1648046888,322478,59723652644,322478,60733541602,1500000000,1500000000
42627532134,1648056052,67622,44127532134,67622,59015126637,1500000000,1500000000
64938669002,1644155326,326091,66438669002,326091,66584305830,1500000000,1500000000
75721130244,1644162276,48615,77221130244,43815,77539994459,1500000000,1500000000
86742908618,1644188982,66730,88242908618,66730,97978680177,1500000000,1500000000
92634060555,1644182755,67634,94134060555,62834,111205498889,1500000000,1500000000
50573321077,1644122851,66778,51573321077,61978,52700296363,1000000000,1000000000
67374963613,1644160467,326782,68874963613,326782,76361273797,1500000000,1500000000
59565802639,1644135265,316588,61065802639,316588,68103184979,1500000000,1500000000
40156375553,1644132205,67634,41656375553,67634,64016434974,1500000000,1500000000
44807669407,1644141645,60850,46307669407,56050,63880501254,1500000000,1500000000
54612609174,1644118434,55592,56112609174,50792,81335700102,1500000000,1500000000
63837804838,1644162396,67646,65337804838,67646,106810850464,1500000000,1500000000
58016533577,1644135303,316556,59516533577,316556,77464208084,1500000000,1500000000
53513579448,1644154683,54860,55013579448,54860,74967653177,1500000000,1500000000
56888199242,1644163822,55693,58388199242,50893,68366047664,1500000000,1500000000
77510939985,1644117855,55648,80010939985,55648,175169176238,2500000000,2500000000
97549021235,1644183669,67622,99049021235,67622,102597589913,1500000000,1500000000
68025813350,1644164681,349532,69525813350,349532,76552243793,1500000000,1500000000
46027012751,1644163539,318365,47527012751,318365,56038423893,1500000000,1500000000
69743067463,1644109643,317236,71243067463,317236,88757220160,1500000000,1500000000
62081477845,1644141156,313399,63581477845,313399,70485736379,1500000000,1500000000
56274258361,1644154449,64705,57774258361,59905,84154952547,1500000000,1500000000
59208559819,1644134403,66766,60708559819,61966,76734855274,1500000000,1500000000
46644438570,1644163758,55828,48144438570,51028,49701331290,1500000000,1500000000
51983693864,1644150201,322853,53483693864,322853,67168673779,1500000000,1500000000
89832984259,1644179182,319783,91332984259,319783,133126279402,1500000000,1500000000
61473892507,1644158266,337494,105000000000,337494,,,
110518721893,1644183191,323075,112018721893,323075,119439201205,1500000000,1500000000
182262214472,1642090951,67634,183762214472,62834,184165153864,1500000000,1500000000
160035915206,1642752647,336891,161535915206,336891,207616017248,1500000000,1500000000
29315482975,1645968603,304630,31315482975,304630,300000000000,2000000000,2000000000
23294804041,1645960395,56516,24794804041,51716,100000000000,1500000000,1500000000
43455004412,1644655546,55620,44955004412,50820,47979708747,1500000000,1500000000
78213448548,1645549634,343181,79713448548,343181,82178334338,1500000000,1500000000
38968250767,1647441794,67646,40968250767,62846,52794267080,2000000000,2000000000
180465189025,1642727595,346382,181965189025,346382,220495815152,1500000000,1500000000
56637973056,1647468753,55584,58137973056,55584,72050392072,1500000000,1500000000
55413071750,1648604878,66790,56913071750,66790,58464454525,1500000000,1500000000
45534316227,1645970275,306977,47534316227,306977,50545530187,2000000000,2000000000
75022935315,1641377943,67622,76522935315,67622,92957334425,1500000000,1500000000
181097121627,1641423883,340035,182507121627,340035,186923342619,1410000000,1410000000
106779489248,1645489633,332013,108000000000,332013,,,
90377201183,1641387150,67634,91877201183,67634,113851914699,1500000000,1500000000
182209894299,1642089077,60850,183709894299,56050,240136583835,1500000000,1500000000
148805810130,1642107097,67646,150305810130,62846,173512572927,1500000000,1500000000
148805810130,1642107097,334324,150305810130,334324,173512572927,1500000000,1500000000
37604274766,1647400086,55592,39104274766,50792,42004175138,1500000000,1500000000
21793578842,1648608231,67634,23293578842,67634,27756421957,1500000000,1500000000
380276591085,1642809133,67634,381776591085,67634,389296027307,1500000000,1500000000
172041659390,1642101453,60838,173541659390,60838,215133528679,1500000000,1500000000
172041659390,1642101453,60862,173541659390,56062,215133528679,1500000000,1500000000
88620479177,1645573289,67634,90120479177,67634,137559179994,1500000000,1500000000
90347318619,1641364078,60862,91847318619,56062,123480197533,1500000000,1500000000
153144975106,1642099997,60850,154644975106,56050,195455505604,1500000000,1500000000
30174149818,1645973064,67634,31674149818,62834,44605928312,1500000000,1500000000
155552088937,1641390926,60850,157052088937,60850,184286383590,1500000000,1500000000
138804030395,1642117008,55620,140304030395,50820,201504806937,1500000000,1500000000
176697542720,1642079158,322969,178197542720,322969,179331759302,1500000000,1500000000
194082420757,1642744273,329402,195582420757,329402,214271306819,1500000000,1500000000
51474367875,1645982916,327369,52974367875,327369,53437842225,1500000000,1500000000
51474367875,1645982916,313534,52974367875,313534,53437842225,1500000000,1500000000
36417001253,1645926364,67634,37917001253,67634,48620805019,1500000000,1500000000
111801962177,1641354552,67646,113301962177,62846,147198963253,1500000000,1500000000
80216388516,1641362000,60862,81716388516,56062,94680343514,1500000000,1500000000
21287638881,1647419044,55668,22787638881,50868,26092609412,1500000000,1500000000
28342943639,1645947405,349516,29842943639,349516,36090405962,1500000000,1500000000
103410731518,1641377856,64741,104910731518,59941,133191868183,1500000000,1500000000
84409423213,1641389960,55693,85909423213,50893,114602545540,1500000000,1500000000
102370879763,1642742338,336867,103870879763,336867,111321982898,1500000000,1500000000
83437150333,1645507608,322951,84937150333,322951,94851085764,1500000000,1500000000
100335375896,1641349856,330563,101835375896,330563,107589294379,1500000000,1500000000
109589692191,1642062100,340081,111589692191,340081,159004118039,2000000000,2000000000
144687521428,1642105026,60850,146187521428,60850,179959212408,1500000000,1500000000
110038238857,1642072920,55693,111538238857,50893,131986682977,1500000000,1500000000
114276339419,1642063656,340081,115776339419,340081,164002534698,1500000000,1500000000
150864544727,1642782276,336897,152364544727,336897,161038384169,1500000000,1500000000
101991852319,1641348686,67622,103491852319,67622,127816352925,1500000000,1500000000
98541197018,1641348257,327353,100041197018,327353,127280805920,1500000000,1500000000
30210838730,1645931320,315357,31710838730,315357,34140818449,1500000000,1500000000
30210838730,1645931320,303978,31710838730,303978,34140818449,1500000000,1500000000
69967825179,1644639900,325044,71967825179,325044,102479472762,2000000000,2000000000
137191450834,1645545947,343801,138691450834,343801,171175824285,1500000000,1500000000
157495881780,1641393143,334300,158995881780,334300,200604020232,1500000000,1500000000
148409647299,1642084903,55592,149909647299,55592,152142764989,1500000000,1500000000
101966979738,1642762867,328344,103466979738,328344,107243416187,1500000000,1500000000
41332796085,1647423408,55705,42832796085,50905,44000000000,1500000000,1500000000
21005137565,1648608204,60862,22505137565,56062,33371276370,1500000000,1500000000
160176554044,1645570666,60862,161676554044,56062,186300369137,1500000000,1500000000
85787922776,1641364194,67634,87287922776,62834,122291649078,1500000000,1500000000
95039772181,1641361770,66718,96539772181,61918,118457403187,1500000000,1500000000
151744368821,1642083499,67646,153244368821,62846,186011366857,1500000000,1500000000
56915263360,1647468602,55596,58415263360,55596,59282855295,1500000000,1500000000
16126494921,1647424089,64741,17626494921,59941,21530315775,1500000000,1500000000
43107053472,1648682077,60838,44607053472,60838,55222419955,1500000000,1500000000
43107053472,1648682077,321596,44607053472,304496,49341570235,1500000000,1500000000
170442091510,1645567756,340031,171982091510,340031,222813952049,1540000000,1540000000
146579508718,1645489991,320402,148079508718,320402,164367997958,1500000000,1500000000
124966934338,1642056843,60862,126466934338,56062,165816323755,1500000000,1500000000
19940708669,1647434392,331171,21440708669,331171,23434440624,1500000000,1500000000
42869414116,1644655918,55793,44369414116,50993,59326382919,1500000000,1500000000
155752762240,1642099830,330559,157402762240,330559,172000000000,1650000000,1650000000
33212016770,1644660732,314380,34712016770,314380,47197214532,1500000000,1500000000
30304825115,1647389720,67634,31804825115,67634,37260569394,1500000000,1500000000
65505306862,1648676429,320392,67005306862,320392,79040098355,1500000000,1500000000
74131017251,1645498873,55705,75631017251,50905,90006746674,1500000000,1500000000
59913460019,1645518659,323658,61251753095,323658,61251753095,1500000000,1338293076
51420422613,1645533064,55572,52920422613,50772,60879567247,1500000000,1500000000
85524936039,1641372425,319327,87024936039,319327,97091115713,1500000000,1500000000
144336831585,1642053102,60850,145836831585,60850,171883425372,1500000000,1500000000
130761984544,1642038672,330541,132261984544,330541,163884205477,1500000000,1500000000
127514333666,1642740650,60862,129014333666,56062,167434410794,1500000000,1500000000
105064329597,1645550290,55705,106564329597,50905,115000000000,1500000000,1500000000
32987359342,1648634623,60838,34987359342,56038,38981515087,2000000000,2000000000
77641414002,1648662731,322975,79141414002,322975,99536645303,1500000000,1500000000
27937610190,1648624654,55580,29437610190,55580,35000000000,1500000000,1500000000
76742342785,1645503350,331392,78242342785,331392,107915872383,1500000000,1500000000
99714998109,1641380735,67634,101214998109,62834,141361133932,1500000000,1500000000
97426718939,1641374107,67646,98926718939,62846,103538184662,1500000000,1500000000
145173824541,1641400565,67646,146673824541,62846,162576260004,1500000000,1500000000
123535309352,1642083667,67622,125535309352,67622,187956224009,2000000000,2000000000
146221963302,1642105270,60862,147721963302,56062,203280355923,1500000000,1500000000
196207663102,1641411053,54848,197707663102,50048,263901413304,1500000000,1500000000
113609506063,1642068742,330531,115109506063,330531,120000000000,1500000000,1500000000
145589422465,1642723223,527992,147239422465,327992,154000000000,1650000000,1650000000
129952294646,1642776887,336871,132952294646,336871,158189358134,3000000000,3000000000
65389844038,1644640036,54703,67389844038,54703,95041636477,2000000000,2000000000
150815744080,1641424860,53512,152815744080,48712,201112434837,2000000000,2000000000
202651393308,1641391535,67622,204368861359,67622,217654832692,1717468051,1717468051
145754565181,1642098996,319799,147254565181,319799,247337209913,1500000000,1500000000
46629396065,1647440957,56516,48129396065,51716,65239093847,1500000000,1500000000
118072721849,1642748087,314057,119572721849,314057,141537292062,1500000000,1500000000
137785887873,1642743928,346376,139285887873,346376,146131136295,1500000000,1500000000
111522064900,1642071115,60862,113022064900,56062,115000000000,1500000000,1500000000
85536266357,1642768038,62151,87036266357,57351,122781139718,1500000000,1500000000
99204950516,1645542024,340661,100704950516,340661,108849032039,1500000000,1500000000
95268393942,1641364834,54872,97768393942,54872,224698169592,2500000000,2500000000
100317748547,1641343938,67634,101817748547,67634,120488976204,1500000000,1500000000
74231472157,1641377535,67634,75731472157,62834,89812304254,1500000000,1500000000
81819637712,1641386102,60862,83319637712,56062,118526006218,1500000000,1500000000
112424296671,1641382045,55592,113924296671,50792,146729416188,1500000000,1500000000
121551415696,1642073723,297068,123051415696,297068,162524649774,1500000000,1500000000
128921701458,1648657342,67622,130421701458,67622,167727548812,1500000000,1500000000
66747016776,1644704061,60850,68247016776,56050,89523850219,1500000000,1500000000
113102420534,1642071041,333692,114602420534,333692,141165947297,1500000000,1500000000
78828680012,1647445487,60862,80828680012,56062,90209782307,2000000000,2000000000
43599301502,1647461224,66742,45099301502,66742,50774922280,1500000000,1500000000
48043721600,1644672154,338666,50043721600,338666,57258668813,2000000000,2000000000
181890267364,1641355956,60838,183390267364,60838,255477621377,1500000000,1500000000
87427250315,1641382666,327970,88927250315,327970,113784960654,1500000000,1500000000
121034752479,1642084373,67646,122534752479,62846,177298372563,1500000000,1500000000
15951776873,1647432860,331177,17451776873,331177,20902924740,1500000000,1500000000
117495268519,1645574223,322965,118995268519,322965,129572280098,1500000000,1500000000
131176204796,1641355996,67634,138028132280,67634,,,
85655142126,1641382688,60850,87155142126,56050,110784062894,1500000000,1500000000
85655142126,1641382688,60838,87155142126,56038,113784960654,1500000000,1500000000
138749450916,1641362815,67634,139997549045,62834,139997549045,1500000000,1248098129
207720104263,1642118339,67634,209220104263,62834,234413268135,1500000000,1500000000
138374813224,1642083295,60850,139874813224,60850,144967735877,1500000000,1500000000
96568553720,1642765646,331173,98068553720,331173,102135804352,1500000000,1500000000
104568944655,1641361236,334258,106068944655,334258,119209053997,1500000000,1500000000
114774188701,1642083206,55580,116274188701,50780,208762163754,1500000000,1500000000
75760389292,1648662809,295910,77260389292,295910,105422118920,1500000000,1500000000
47935462291,1645973846,340631,49435462291,340631,57927717097,1500000000,1500000000
124440971323,1641342162,67634,125940971323,67634,156921486420,1500000000,1500000000
104656937981,1642069715,310287,106156937981,310287,125404484588,1500000000,1500000000
206919817623,1642786429,62151,208419817623,57351,235094883305,1500000000,1500000000
51296954772,1646004359,67634,52167793355,62834,52167793355,1500000000,870838583
123497655243,1641409887,60862,124997655243,56062,148278131087,1500000000,1500000000
123497655243,1641409887,327902,124997655243,327902,133702588418,1500000000,1500000000
43687702259,1644675047,323743,45187702259,317274,74898410689,1500000000,1500000000
198164770476,1641417099,334314,199664770476,334314,243766290305,1500000000,1500000000
126866800331,1642063297,60850,128366800331,56050,171756011123,1500000000,1500000000
161265674558,1642086382,55592,162765674558,55592,204394414933,1500000000,1500000000
26303029693,1648627940,322937,27803029693,322937,42056241032,1500000000,1500000000
32514116133,1648611791,66778,34014116133,66778,47616976943,1500000000,1500000000
40988511751,1648604655,60862,41992080432,56062,41992080432,2000000000,1003568681
35295699429,1648648134,55592,37295699429,50792,44502802301,2000000000,2000000000
99304371003,1642773028,340055,100804371003,340055,169343110560,1500000000,1500000000
109731916678,1641360979,60850,109889817147,56050,109889817147,1500000000,157900469
53380929243,1645538082,346390,54880929243,346390,74211174458,1500000000,1500000000
84266102987,1641373614,67622,85766102987,62822,113522351325,1500000000,1500000000
204834172832,1642109936,60850,206334172832,56050,271330913719,1500000000,1500000000
49237823566,1647447586,55668,50737823566,50868,65643467083,1500000000,1500000000
27171375297,1648617192,60850,28671375297,56050,28990963163,1500000000,1500000000
80486465356,1648676003,64741,81986465356,59941,87387684217,1500000000,1500000000
246527874127,1642809554,122041,248527874127,117241,300096556623,2000000000,2000000000
56415627035,1645518977,311070,57915627035,311070,79511002132,1500000000,1500000000
40827824056,1645536975,54308,42327824056,54308,50534088930,1500000000,1500000000
27359493880,1647441916,321867,28656167021,321867,30985264906,1296673141,1296673141
96822032230,1642750209,322488,98322032230,322488,107509910424,1500000000,1500000000
67117235104,1645549033,326075,68617235104,326075,87816252063,1500000000,1500000000
193030990857,1642082531,54872,195530990857,54872,347074991126,2500000000,2500000000
154581328838,1642041896,60850,156081328838,56050,203578916787,1500000000,1500000000
51302216060,1647464343,67634,52802216060,62834,71671146279,1500000000,1500000000
28383731842,1648620473,56492,29883731842,51692,30309133385,1500000000,1500000000
119152902594,1641380029,59922,120652902594,55122,120974865180,1500000000,1500000000
80790326583,1644631709,317328,82290326583,317328,94271036297,1500000000,1500000000
193039210202,1642092683,67634,194539210202,67634,229757248344,1500000000,1500000000
29466838395,1647436426,310279,30966838395,310279,40032196408,1500000000,1500000000
21154009773,1647425445,67646,22654009773,62846,28506657650,1500000000,1500000000
54793799651,1647400581,327958,56293799651,327958,72702199690,1500000000,1500000000
109270566840,1641372217,60850,110770566840,56050,134240855409,1500000000,1500000000
120878709863,1642070582,52940,122378709863,48140,136000000000,1500000000,1500000000
76205010828,1644640161,331181,77705010828,331181,80067051167,1500000000,1500000000
177020832620,1641392942,55693,178520832620,50893,188062548492,1500000000,1500000000
153425516776,1642083526,67634,154925516776,62834,170121187347,1500000000,1500000000
84505611752,1641347315,316853,86005611752,316853,106699798859,1500000000,1500000000
76901512735,1641388465,60850,78401512735,60850,126668385772,1500000000,1500000000
140431318457,1642082946,60850,141931318457,56050,192014586153,1500000000,1500000000
140431318457,1642082946,60862,141931318457,56062,143135115378,1500000000,1500000000
165592612771,1642086186,67622,167092612771,67622,201967836535,1500000000,1500000000
166345250114,1642083401,55592,167845250114,50792,178432426958,1500000000,1500000000
107511121130,1648656129,67634,109011121130,67634,128225023983,1500000000,1500000000
190789951860,1641410601,67646,192289951860,67646,241853194594,1500000000,1500000000
52390092524,1644671865,318692,54390092524,318692,65361402349,2000000000,2000000000
136946656294,1642092203,60862,138514143012,56062,155500197333,1567486718,1567486718
129794836569,1642777773,310993,131294836569,310993,175944024915,1500000000,1500000000
135447321928,1642733280,333702,136857321928,333702,150602588167,1410000000,1410000000
45665181262,1647474273,67634,47165181262,62834,70839066712,1500000000,1500000000
25050769582,1645966307,55648,27550769582,55648,56092980416,2500000000,2500000000
33730926154,1645974383,335148,35230926154,335148,46751518599,1500000000,1500000000
91166241882,1645488950,333167,92666241882,333167,102808332517,1500000000,1500000000
57048593505,1644683267,62139,58548593505,57339,74290803780,1500000000,1500000000
42920298782,1644642798,52916,44420298782,48116,48844590545,1500000000,1500000000
113254852983,1641370804,66766,115254852983,66766,170266166024,2000000000,2000000000
58545405713,1647446855,49483,59545405713,44683,65396061056,1000000000,1000000000
83954670262,1641383374,67622,85454670262,62822,135122772683,1500000000,1500000000
125895752601,1642083011,336907,127395752601,336907,161452519822,1500000000,1500000000
125895752601,1642083011,67634,127395752601,67634,198970021348,1500000000,1500000000
60317108291,1647445326,67646,62317108291,62846,83155563995,2000000000,2000000000
32124786489,1645944086,347021,33624786489,347021,38631757069,1500000000,1500000000
81365934997,1645505255,55668,82865934997,50868,102380044433,1500000000,1500000000
126172903870,1642046067,54836,127672903870,54836,174681772863,1500000000,1500000000
24851351773,1648617852,66742,26351351773,66742,27697526344,1500000000,1500000000
35211716192,1648626930,324230,36711716192,324230,42181575713,1500000000,1500000000
132035345767,1642097420,67646,133535345767,62846,144812061415,1500000000,1500000000
117683592356,1642774899,338722,119183592356,338722,157127364072,1500000000,1500000000
27271113870,1645963532,300743,28771113870,300743,32703351957,1500000000,1500000000
134871472294,1642084107,60862,136371472294,56062,141991451268,1500000000,1500000000
142929381374,1642064555,340065,144754727374,340065,181920790814,1825346000,1825346000
172127600570,1642116912,336897,174127600570,336897,235223047650,2000000000,2000000000
119499454323,1642788544,48639,120999454323,43839,126042321940,1500000000,1500000000
81641187152,1644704388,319653,83141187152,319653,103236334669,1500000000,1500000000
41417833382,1645537780,317206,42917833382,317206,59014976273,1500000000,1500000000
113163706253,1641353939,67646,114663706253,62846,141468010058,1500000000,1500000000
42837033604,1648600875,339985,44337033604,339985,57214501605,1500000000,1500000000
39483555005,1648618602,320360,40983555005,320360,50914777294,1500000000,1500000000
103136632955,1645564727,55644,105636632955,55644,191218791734,2500000000,2500000000
34596520592,1645529849,328254,36096520592,328254,41016897772,1500000000,1500000000
163124119424,1641423087,60850,164624119424,56050,177952491627,1500000000,1500000000
190569002012,1642096446,64741,192569002012,59941,247447967169,2000000000,2000000000
139469206329,1642078002,337466,140969206329,337466,156485690714,1500000000,1500000000
146561380661,1642793490,317232,148061380661,317232,160351100553,1500000000,1500000000
109492558700,1642780127,319329,110992558700,319329,126000000000,1500000000,1500000000
156931144493,1641348826,67658,158431144493,62858,164516590712,1500000000,1500000000
132182987154,1642112905,327403,133682987154,327403,158402593614,1500000000,1500000000
132182987154,1642112905,54860,133682987154,54860,181282858060,1500000000,1500000000
62414919292,1645502302,334304,63414919292,334304,64926896729,1000000000,1000000000
81522248267,1641383404,67622,83022248267,67622,106443337828,1500000000,1500000000
156445261705,1642085201,67634,157945261705,62834,213107534169,1500000000,1500000000
144118499039,1642104564,60838,145618499039,60838,184603643444,1500000000,1500000000
96209372525,1648657680,293332,97709372525,293332,117251233108,1500000000,1500000000
85325624043,1642764974,332434,86825624043,332434,92254596688,1500000000,1500000000
105396438134,1641354123,67622,106896438134,62822,135142799169,1500000000,1500000000
79649690477,1641376671,54739,81149690477,49939,82101139112,1500000000,1500000000
160094262109,1642115905,60862,161594262109,60862,166232115993,1500000000,1500000000
31843550060,1648624198,59982,33343550060,59982,35886938600,1500000000,1500000000
118080705787,1641371363,52830,119580705787,52830,131300124760,1500000000,1500000000
32243203770,1648601916,331973,33743203770,331973,45404827195,1500000000,1500000000
464798893843,1642805555,64729,466298893843,59929,612265418478,1500000000,1500000000
95110536468,1645565263,55644,97610536468,55644,212125718692,2500000000,2500000000
130761079922,1641364752,67646,132261079922,62846,166841204787,1500000000,1500000000
118078671019,1642767422,325691,119578671019,325691,132700121084,1500000000,1500000000
170245261912,1642060721,64741,171745261912,59941,183962362943,1500000000,1500000000
205903804960,1641391533,60838,207621273011,60838,217654832692,1717468051,1717468051
174476381479,1642790508,67634,175976381479,62834,195387341963,1500000000,1500000000
48483097940,1644690774,334312,49983097940,334312,58615048772,1500000000,1500000000
41228878487,1647404414,320473,42728878487,320473,50030216903,1500000000,1500000000
27026443752,1648638751,314154,27201772637,314154,27201772637,1500000000,175328885
161980757694,1642108978,60850,163480757694,56050,189985019625,1500000000,1500000000
134180567195,1642106445,55632,135680567195,50832,173973456799,1500000000,1500000000
111211842090,1642742308,60862,112711842090,56062,137593394952,1500000000,1500000000
39697920164,1644664808,319783,40000000000,319783,40000000000,1500000000,302079836
39697920164,1644664808,322951,41197920164,322951,46000000000,1500000000,1500000000
39697920164,1644664808,322937,41000000000,322937,41000000000,1500000000,1302079836
112491380165,1642745593,52916,113991380165,48116,161725862802,1500000000,1500000000
163059965303,1642116049,67634,164559965303,62834,182676548275,1500000000,1500000000
32761775577,1647390615,66790,34261775577,61990,45181209362,1500000000,1500000000
41115947367,1645985484,307098,42615947367,307098,68149198148,1500000000,1500000000
50672612402,1644647853,314148,52172612402,314148,75395799318,1500000000,1500000000
45111459677,1644645027,327335,46611459677,327335,58851276094,1500000000,1500000000
115870625507,1642061152,60862,117370625507,56062,185220148447,1500000000,1500000000
173757796223,1642112514,67622,175257796223,67622,234671909075,1500000000,1500000000
70500978951,1647395779,329098,72000978951,329098,79844262950,1500000000,1500000000
39127600179,1648650774,313584,40627600179,313584,49869737427,1500000000,1500000000
130955870352,1642748714,312159,132455870352,312159,174616593785,1500000000,1500000000
65548138927,1645514161,333125,67048138927,333125,74298431098,1500000000,1500000000
169718826991,1642082565,64741,171218826991,59941,229811388887,1500000000,1500000000
146229393956,1642044053,67634,159285040756,62834,,,
41874953922,1648609377,67622,43374953922,62822,52450890863,1500000000,1500000000
195208155420,1642733239,322476,196708155420,322476,200636737724,1500000000,1500000000
125394526914,1641354097,67634,126894526914,62834,155006993597,1500000000,1500000000
137476701796,1642083758,60862,138976701796,56062,156865266587,1500000000,1500000000
25749994986,1648631857,55580,27249994986,55580,37383592913,1500000000,1500000000
160358450392,1642774384,62151,161858450392,57351,194805879075,1500000000,1500000000
75454629338,1645572992,323618,76636257651,323618,77779166617,1181628313,1181628313
119074883945,1645546057,322917,120574883945,322917,145676200708,1500000000,1500000000
188874605634,1642052292,67646,190384605634,62846,215926602282,1510000000,1510000000
65327115790,1647464251,55720,67208915790,50920,74123538690,1881800000,1881800000
50749628623,1644645075,323026,52249628623,323026,62826219123,1500000000,1500000000
79911105405,1641377951,67646,101911105405,58046,222000000000,22000000000,22000000000
183407409476,1641418802,67646,184907409476,62846,219662733194,1500000000,1500000000
181157088913,1642108226,60850,182657088913,60850,257692667567,1500000000,1500000000
128665192757,1642085889,64741,130165192757,59941,171220132847,1500000000,1500000000
146565246657,1642791114,310884,148065246657,310884,226638123237,1500000000,1500000000
21663627650,1645948722,346975,23163627650,346975,25776066654,1500000000,1500000000
143369378144,1642086340,343241,144869378144,343241,150362306294,1500000000,1500000000
172094259879,1642737108,60850,173614721995,56050,236000000000,1520462116,1520462116
161712719792,1642032989,67646,163212719792,62846,173165408227,1500000000,1500000000
125895621623,1642065782,55580,127395621623,37758,179887932573,1500000000,1500000000
125895621623,1642065782,55580,127395621623,55580,162356259714,1500000000,1500000000
107171576137,1642773424,67622,108671576137,67622,120655794550,1500000000,1500000000
29198808650,1645948412,346977,30698808650,346977,36150834382,1500000000,1500000000
80577672311,1641387969,55717,82077672311,50917,113115655969,1500000000,1500000000
78102438856,1641359180,67646,79602438856,62846,89672633282,1500000000,1500000000
107965623226,1641353180,59910,109465623226,59910,150740349389,1500000000,1500000000
46613653093,1647448717,56717,48113653093,47117,66268634293,1500000000,1500000000
22732097900,1647422430,324810,24232097900,324810,27177349888,1500000000,1500000000
59596286718,1648676273,67646,61096286718,67646,67248461960,1500000000,1500000000
40945458986,1644676142,337500,47514311287,337500,,,
40945458986,1644676142,336907,45439703257,336907,,,
125410703579,1642072973,327369,126910703579,327369,131986682977,1500000000,1500000000
55595145431,1647472272,55584,57095145431,55584,76275032502,1500000000,1500000000
28899479014,1648627057,317318,30399479014,317318,30503298874,1500000000,1500000000
35081834387,1645925039,52940,36581834387,48140,48716220650,1500000000,1500000000
101601994960,1641367457,317318,103101994960,317318,117570764485,1500000000,1500000000
46764515441,1647453887,67646,48264515441,62846,54542514215,1500000000,1500000000
87347794969,1648658771,54332,88847794969,49532,93835968434,1500000000,1500000000
27072897845,1645968059,60850,28572897845,56050,35952661503,1500000000,1500000000
82978638810,1641359327,59922,84478638810,55122,106647446192,1500000000,1500000000
181265109415,1641351650,55693,182765109415,50893,225987621362,1500000000,1500000000
106145832111,1642058582,60850,107645832111,60850,132169983458,1500000000,1500000000
114846672166,1642745014,323016,116346672166,323016,123582911682,1500000000,1500000000
93053339034,1645489811,52940,94553339034,48140,125162305295,1500000000,1500000000
96018858270,1641365856,60862,97518858270,56062,117842417970,1500000000,1500000000
91259669999,1641377148,334358,92759669999,334358,114448540988,1500000000,1500000000
231266451033,1642102601,60862,232766451033,56062,269677620104,1500000000,1500000000
136540014019,1642768808,316570,139540014019,316570,181153264107,3000000000,3000000000
177858797156,1642792707,60850,179358797156,56050,234103276608,1500000000,1500000000
182449107949,1641407703,59994,183949107949,55194,252677870742,1500000000,1500000000
22430950231,1647434404,316630,23434440624,316630,23434440624,1500000000,1003490393
46225942780,1647472409,55584,47725942780,55584,60201456389,1500000000,1500000000
172251543720,1642787440,326335,173751543720,326335,241459519834,1500000000,1500000000
192768534002,1642785159,56480,194268534002,56480,264619229855,1500000000,1500000000
131537497790,1642756069,64729,133037497790,59929,152059439037,1500000000,1500000000
99633857552,1642788387,55648,102133857552,55648,227891251398,2500000000,2500000000
108153471370,1645489304,340699,109653471370,340699,114460219640,1500000000,1500000000
127136718375,1642753054,333724,128636718375,333724,148499993130,1500000000,1500000000
50407650478,1645523039,55681,51907650478,50881,69120689128,1500000000,1500000000
153704310880,1642116618,67646,155204310880,62846,176990892215,1500000000,1500000000
41323388766,1645989749,67622,42823388766,67622,51394926844,1500000000,1500000000
94709499025,1641379378,67634,95045720443,62834,95045720443,1500000000,336221418
116376971344,1641400477,54739,117876971344,49939,123847674075,1500000000,1500000000
165747461982,1642117974,55705,167247461982,50905,169701760305,1500000000,1500000000
194373111392,1642103036,334360,195873111392,334360,197927613329,1500000000,1500000000
44059756701,1644646108,323634,45559756701,323634,200000000000,1500000000,1500000000
92195072699,1641361003,67646,93695072699,62846,127881151805,1500000000,1500000000
144797971389,1641407258,55592,146297971389,50792,150000000000,1500000000,1500000000
134653181649,1642078027,340043,136153181649,340043,156485690714,1500000000,1500000000
24309454033,1647419954,319749,25809454033,319749,34277283002,1500000000,1500000000
192571344069,1642786600,55648,194071344069,55648,329010354250,1500000000,1500000000
80584820162,1641376396,67646,82084820162,62846,112288731708,1500000000,1500000000
106100401598,1641342262,314146,107750401598,314146,120000000000,1650000000,1650000000
157503117751,1642062723,322941,159003117751,322941,181258835565,1500000000,1500000000
236676901058,1642111398,54836,238176901058,54836,274806025568,1500000000,1500000000
55120416879,1647447608,55620,56620416879,50820,64852975317,1500000000,1500000000
119542200426,1642765863,62139,121042200426,57339,143203068484,1500000000,1500000000
91515652342,1641343863,67646,93515652342,62846,125748535252,2000000000,2000000000
116843116369,1641380227,60850,118343116369,56050,151197721088,1500000000,1500000000
86305520149,1641384540,60838,87433861989,60838,103710545638,1128341840,1128341840
167395455061,1642114729,67634,168895455061,62834,173339164900,1500000000,1500000000
118363392121,1642066597,55592,119863392121,50792,120000000000,1500000000,1500000000
111200068227,1642762104,60850,112700068227,60850,117621724125,1500000000,1500000000
87502457641,1648662580,67622,89002457641,67622,116845011232,1500000000,1500000000
124730039408,1642748105,319787,126230039408,319787,162239693068,1500000000,1500000000
122067114709,1641343504,67622,123567114709,67622,141302960869,1500000000,1500000000
118620933958,1641351801,67646,120120933958,62846,157738422500,1500000000,1500000000
194389830625,1641414875,54771,195889830625,49971,223666695310,1500000000,1500000000
194389830625,1641414875,52928,195889830625,48128,223666695310,1500000000,1500000000
106284515987,1641375493,66766,115505905508,66766,,,
98786953296,1641381428,67622,100286953296,67622,110812269332,1500000000,1500000000
158652822909,1642737354,319311,160152822909,319311,169445734279,1500000000,1500000000
158652822909,1642737354,326816,160152822909,326816,169445734279,1500000000,1500000000
80720127980,1645547301,54772,82220127980,49972,90000000000,1500000000,1500000000
86042385912,1645503850,328799,87542385912,328799,109058348263,1500000000,1500000000
106173368293,1641401547,60850,107673368293,56050,140917409238,1500000000,1500000000
76816319022,1641382575,55693,78316319022,50893,109238288744,1500000000,1500000000
25358914062,1647437852,67634,26858914062,62834,35369275013,1500000000,1500000000
53239825010,1648676243,67646,54739825010,62846,76992847313,1500000000,1500000000
59873151378,1648650461,66814,61373151378,62014,77432060130,1500000000,1500000000
34155430135,1645934550,67634,35655430135,67634,50756911192,1500000000,1500000000
207443765287,1641412221,49483,209443765287,44683,272353006506,2000000000,2000000000
156680833305,1641412625,67646,158180833305,62846,193129538815,1500000000,1500000000
93296029180,1641388564,60850,94796029180,56050,107609816888,1500000000,1500000000
103987495635,1641400883,334320,105487495635,334320,158571052028,1500000000,1500000000
24333183148,1647405096,318696,25539869085,318696,25539869085,1500000000,1206685937
50464390620,1648645448,66790,51964390620,66790,62855316860,1500000000,1500000000
42552020224,1648651471,67710,44552020224,67710,49794074813,2000000000,2000000000
35878941797,1648641446,343197,37378941797,343197,44992374909,1500000000,1500000000
56685557811,1647441320,67634,58185557811,62834,66861903588,1500000000,1500000000
114447005684,1642742624,49507,115947005684,44707,140284459849,1500000000,1500000000
209776504520,1642785687,340065,211276504520,340065,259900168504,1500000000,1500000000
88316286429,1642766138,335542,89816286429,335542,109939813475,1500000000,1500000000
34388503058,1648609703,63200,35888503058,63200,56353539048,1500000000,1500000000
70335915019,1641376115,319343,71000000000,319343,71000000000,1500000000,664084981
104635881718,1641363165,60850,106135881718,56050,124094844779,1500000000,1500000000
131324332875,1642083556,55580,132824332875,50780,214463523050,1500000000,1500000000
65468029773,1647445229,67634,66968029773,62834,74243543675,1500000000,1500000000
38652782824,1648676743,52940,40152782824,48140,65118845704,1500000000,1500000000
98383049031,1642764008,52916,99883049031,48116,129557479757,1500000000,1500000000
44780516957,1644657351,333718,46280516957,333718,49643567560,1500000000,1500000000
50395906442,1645539952,332205,51895906442,331700,53366449730,1500000000,1500000000
151317070274,1642111907,60850,152817070274,56050,209612352629,1500000000,1500000000
115354533529,1642083933,64741,116854533529,59941,143883622683,1500000000,1500000000
21184055335,1648619626,55648,23684055335,55648,48347564854,2500000000,2500000000
58067226313,1644642242,66826,60067226313,62026,78235278186,2000000000,2000000000
78035095282,1645502401,315505,79535095282,315505,79867330122,1500000000,1500000000
127882485265,1641375583,66778,129382485265,61978,163042568604,1500000000,1500000000
34271109568,1647473649,311565,35771109568,311565,40000000000,1500000000,1500000000
33409984684,1647466942,67634,34909984684,62834,43291520574,1500000000,1500000000
40702940577,1645529397,346993,42202940577,346993,46726017504,1500000000,1500000000
81679187198,1641375673,59970,107322677811,59970,,,
230336306092,1641404965,60042,231836306092,55242,279350289643,1500000000,1500000000
18162698473,1647438166,331171,19662698473,245049,20310650223,1500000000,1500000000
18162698473,1647438166,331171,19662698473,245049,20148697599,1500000000,1500000000
25334767067,1648619730,330030,26834767067,330030,32357876097,1500000000,1500000000
133986948519,1641401325,60862,135486948519,56062,152246106445,1500000000,1500000000
155990763848,1642059406,55580,157490763848,55580,157815114228,1500000000,1500000000
155992579273,1642098029,67646,157492579273,62846,210272868734,1500000000,1500000000
30205250250,1648649113,55592,31705250250,50792,54570954143,1500000000,1500000000
23600013867,1645950461,326703,25600013867,326703,33526272890,2000000000,2000000000
23600013867,1645950461,349550,25600013867,349550,30026416242,2000000000,2000000000
177048361639,1645567747,337474,178598361639,337474,230556815104,1550000000,1550000000
95326853485,1641374980,60850,96826853485,56050,117533676963,1500000000,1500000000
91728728941,1641346743,334336,93228728941,334336,117996657003,1500000000,1500000000
91516503803,1641347795,67622,93016503803,67622,113383253824,1500000000,1500000000
114630463635,1641399904,67634,116130463635,67634,149315129059,1500000000,1500000000
135627975383,1642049849,67634,137127975383,67634,195600315407,1500000000,1500000000
175694790892,1642793527,331135,177194790892,331135,207357928004,1500000000,1500000000
119403238282,1642759522,331217,121403238282,331217,132430165864,2000000000,2000000000
37275141211,1645973710,349548,38775141211,349548,51304227940,1500000000,1500000000
101797162570,1642766763,325631,103297162570,325631,121442433247,1500000000,1500000000
73451919769,1641376399,60862,81584820162,56062,,,
112976803428,1641400869,330539,114476803428,330539,145730276813,1500000000,1500000000
138976400976,1642113652,67634,140476400976,62834,216296414850,1500000000,1500000000
41179907128,1648643370,314196,42679907128,314196,51768460955,1500000000,1500000000
190360655550,1642730025,331175,191860655550,331175,213038697493,1500000000,1500000000
42410113088,1645962094,324206,43910113088,324206,44000000000,1500000000,1500000000
40567555915,1645924865,307811,42067555915,307811,54791232378,1500000000,1500000000
73099819575,1645505934,52904,74599819575,52904,94119628502,1500000000,1500000000
66733057575,1645543328,55612,68233057575,50812,90348252927,1500000000,1500000000
73703449058,1645510540,67634,75203449058,62834,87213593223,1500000000,1500000000
84117956953,1641359314,60838,85617956953,56038,114394633245,1500000000,1500000000
81222375304,1644680738,54332,82722375304,49532,87486572732,1500000000,1500000000
125199302742,1641348511,60850,126699302742,56050,149182158960,1500000000,1500000000
143012958068,1642753094,67622,144512958068,67622,148499993130,1500000000,1500000000
197365237140,1641399551,60862,198865237140,56062,227856934323,1500000000,1500000000
24641486898,1648623124,67634,26141486898,67634,28518539198,1500000000,1500000000
87603007513,1644680144,316582,89103007513,316582,94814655368,1500000000,1500000000
83508031530,1641374184,60862,85008031530,56062,98358526993,1500000000,1500000000
83508031530,1641374184,67622,85008031530,67622,103067675908,1500000000,1500000000
43432245216,1645526567,67658,44932245216,62858,58818912877,1500000000,1500000000
64700775494,1645566554,55584,66370775494,50784,73201584919,1670000000,1670000000
28565058076,1647439532,316626,30065058076,316626,37336245782,1500000000,1500000000
84097140961,1641378313,67622,85597140961,62822,121710485270,1500000000,1500000000
91862902636,1641342313,311017,93512902636,293917,120000000000,1650000000,1650000000
88451371772,1641381636,67646,89951371772,62846,112573140219,1500000000,1500000000
50542802822,1644646831,315546,52042802822,315546,71203966980,1500000000,1500000000
130088793112,1642065335,60862,131588793112,56062,152506067093,1500000000,1500000000
184797899302,1642087394,49469,186297899302,49469,256334915447,1500000000,1500000000
39353428960,1647449036,334314,40853428960,334314,46970371614,1500000000,1500000000
63514466886,1647400566,330535,65014466886,241861,72702199690,1500000000,1500000000
63514466886,1647400566,330535,65014466886,330535,77012807592,1500000000,1500000000
50037937660,1648641855,318830,51537937660,318830,52517314958,1500000000,1500000000
26057505906,1648603075,66778,27557505906,66778,49148183713,1500000000,1500000000
42977935964,1648682034,324836,44477935964,324836,51154274155,1500000000,1500000000
147273061939,1642738062,60862,148773061939,56062,217942295738,1500000000,1500000000
105448113246,1641397548,67646,106948113246,62846,152618320352,1500000000,1500000000
80952658537,1641361399,60006,82452658537,55206,110194646990,1500000000,1500000000
123336544136,1641354659,54884,124836544136,50084,141252452722,1500000000,1500000000
143463760910,1642052831,320639,144963760910,320639,150000000000,1500000000,1500000000
159468493559,1642086768,55580,160968493559,50780,186557518129,1500000000,1500000000
27142371542,1648631406,55717,28642371542,50917,39405798760,1500000000,1500000000
28799100091,1645948391,346376,30299100091,346376,39218570229,1500000000,1500000000
35838137146,1644668762,336871,37338137146,336871,42597268717,1500000000,1500000000
227032816608,1641414133,67634,228532816608,62834,238143485462,1500000000,1500000000
261488230836,1642032289,60862,262988230836,56062,270547485763,1500000000,1500000000
52748138517,1647448578,55705,54248138517,50905,83907346104,1500000000,1500000000
169344519453,1642723202,67646,170844519453,62846,209370062428,1500000000,1500000000
150001363034,1642739450,60862,151501363034,56062,180114926897,1500000000,1500000000
176122845397,1644633655,59934,177622845397,59934,200140578057,1500000000,1500000000
29212319844,1644660277,336287,30000000000,336287,30000000000,1220444509,787680156
121287319365,1642064044,60862,122787319365,56062,153558065688,1500000000,1500000000
16564795712,1647417406,501477,17564795712,334318,36690394994,1000000000,1000000000
93912474695,1642766836,66742,95412474695,66742,126746069299,1500000000,1500000000
136152183270,1641424821,60850,137652183270,56050,177755306404,1500000000,1500000000
223231686951,1642088333,52396,225731686951,47596,417804162386,2500000000,2500000000
183384993293,1642114308,60850,184884993293,56050,187724340617,1500000000,1500000000
71749068849,1645488357,59934,73249068849,59934,99515442012,1500000000,1500000000
68631066373,1645510393,334298,70131066373,334298,72000000000,1500000000,1500000000
185066614653,1641403876,316568,186566614653,316568,208566509412,1500000000,1500000000
152507408043,1642092604,67634,154007408043,62834,191523654707,1500000000,1500000000
143438368171,1642106894,67646,144938368171,62846,226687586864,1500000000,1500000000
24410338489,1647427145,60850,25910338489,60850,30097377447,1500000000,1500000000
170217045455,1642744204,67634,171717045455,62834,193721554285,1500000000,1500000000
117146289910,1641400849,50000,250000000000,26883,,,
141110987399,1641397122,60850,142610987399,56050,149996257463,1500000000,1500000000
43608920371,1648601692,329298,45108920371,329298,49958042415,1500000000,1500000000
30035264358,1648604392,67646,32035264358,62846,42625805237,2000000000,2000000000
69280456989,1645488635,330266,70780456989,330266,96666171628,1500000000,1500000000
137432738687,1642079300,55681,138932738687,50881,186099619185,1500000000,1500000000
59690312077,1647446123,55668,61190312077,50868,62673648103,1500000000,1500000000
148357188326,1642767545,66742,149857188326,66742,151405264027,1500000000,1500000000
81859364298,1641373775,67622,83359364298,62822,101408159784,1500000000,1500000000
90006347754,1641359642,67646,91506347754,62846,103675095144,1500000000,1500000000
25690990350,1648627046,67634,27190990350,62834,36932448265,1500000000,1500000000
148753615190,1641415468,60850,150000000000,56050,150000000000,1500000000,1246384810
207652081193,1642088296,63200,210152081193,63200,394031066062,2500000000,2500000000
45982655203,1647468316,55584,47482655203,55584,93872460048,1500000000,1500000000
26277371873,1648604230,54812,27777371873,50012,37217421605,1500000000,1500000000
33243169111,1644657512,55804,34743169111,51004,50228051617,1500000000,1500000000
91058276496,1641387461,60862,92558276496,56062,121779322264,1500000000,1500000000
79851291952,1641359834,67622,81351291952,67622,121368985862,1500000000,1500000000
79851291952,1641359834,55492,81351291952,50692,121368985862,1500000000,1500000000
110550618486,1642749264,62139,112050618486,57339,136425904247,1500000000,1500000000
76382936382,1645498877,322842,78382936382,322842,98370322427,2000000000,2000000000
76382936382,1645498877,321903,78382936382,321903,94047016541,2000000000,2000000000
141434673905,1641343208,67634,143066304196,62834,175805341656,1631630291,1631630291
172966135604,1642116932,336897,174966135604,248222,235223047650,2000000000,2000000000
39304255771,1644670682,329298,40804255771,329298,53094000325,1500000000,1500000000
237764976772,1641404232,60018,239264976772,60018,244685620195,1500000000,1500000000
23621871813,1648629227,60850,25121871813,56050,35438018763,1500000000,1500000000
199167419807,1642088751,67646,200667419807,62846,270279125532,1500000000,1500000000
199167419807,1642088751,55592,200667419807,50792,270279125532,1500000000,1500000000
49682434782,1647465662,67646,51182434782,62846,66115768389,1500000000,1500000000
35942768679,1645969031,54813,37442768679,50013,57305596370,1500000000,1500000000
123307055545,1644637532,331175,124807055545,331175,137782330678,1500000000,1500000000
154931794077,1642112259,66742,156431794077,66742,216641488512,1500000000,1500000000
164622082443,1642090424,60862,166272082443,56062,185000000000,1650000000,1650000000
126589057211,1642073456,55580,128089057211,50780,147451448842,1500000000,1500000000
44582945124,1647472346,55596,46082945124,55596,58460992970,1500000000,1500000000
48535570905,1645523315,317214,50035570905,317214,63533991304,1500000000,1500000000
139959492684,1642104577,67622,141459492684,62822,184603643444,1500000000,1500000000
189998327876,1642095946,60850,191498327876,60850,204551534178,1500000000,1500000000
199707205255,1642082099,336853,201207205255,336853,264434278554,1500000000,1500000000
50464334978,1644646425,310975,51964334978,310975,72367519528,1500000000,1500000000
146053745418,1645568388,340079,167052311115,340079,,,
149293983405,1642115461,55608,150793983405,55608,198039893993,1500000000,1500000000
145923452791,1642739123,49495,147423452791,44695,254633482490,1500000000,1500000000
68334976850,1645517729,331392,69834976850,331392,84672344510,1500000000,1500000000
126606527887,1642032774,317564,128606527887,317564,189887770367,2000000000,2000000000
155969098049,1642116523,67634,157469098049,62834,181263631435,1500000000,1500000000
100631204679,1642775526,66802,108230677262,62002,,,
136700818501,1642744132,67646,180000000000,62846,,,
142206407120,1641408248,67622,143706407120,67622,197341040223,1500000000,1500000000
164326872744,1641396827,60850,165877872744,56050,199000000000,1551000000,1551000000
127966316458,1642045294,324788,129466316458,324788,171026275168,1500000000,1500000000
20744954862,1647406901,304614,22244954862,304614,22838401040,1500000000,1500000000
80899269974,1645488698,336915,82399269974,336915,88447841247,1500000000,1500000000
99635922200,1641388879,67646,101135922200,62846,127948254484,1500000000,1500000000
33580927235,1645953604,55648,36080927235,55648,65572074960,2500000000,2500000000
33061813597,1648632173,54332,34561813597,49532,44487031649,1500000000,1500000000
126362890057,1641397033,67622,127862890057,67622,154690595979,1500000000,1500000000
20438710651,1648616369,55840,21938710651,51040,32174265278,1500000000,1500000000
125818670715,1642780713,55636,128318670715,55636,226266216452,2500000000,2500000000
143987120873,1641402721,54703,145487120873,54703,157014727422,1500000000,1500000000
39847371946,1647397198,55720,41347371946,50920,56263750822,1500000000,1500000000
122433789814,1642747780,325074,124433789814,325074,168742765655,2000000000,2000000000
117988953633,1642753399,56516,119488953633,51716,152697682950,1500000000,1500000000
34613294795,1648651527,67622,36113294795,67622,49541091363,1500000000,1500000000
225785381850,1642735717,312970,227285381850,312970,263309979985,1500000000,1500000000
79554329998,1641383697,67622,80000000000,67622,80000000000,2500000000,445670002
133660697404,1642117088,67622,135160697404,62822,190868218455,1500000000,1500000000
133660697404,1642117088,67622,135160697404,67622,177268685242,1500000000,1500000000
175058466228,1642074224,60862,176558466228,56062,196009999095,1500000000,1500000000
28150198368,1648635387,67646,29650198368,62846,32167310413,1500000000,1500000000
34320578052,1645926636,304590,35820578052,304590,50563885277,1500000000,1500000000
23856190356,1645961626,67622,25356190356,67622,35132929640,1500000000,1500000000
104929806385,1641373165,67634,106429806385,62834,133956264440,1500000000,1500000000
165429723678,1642091606,60862,167429723678,56062,238796116093,2000000000,2000000000
24512683104,1648631907,67634,25382095934,62834,25382095934,1000000000,869412830
131562634184,1641392529,67646,133062634184,62846,192363223582,1500000000,1500000000
120820748722,1641345948,60862,122320748722,56062,153767175270,1500000000,1500000000
236326765368,1642094846,67634,237826765368,67634,281543955015,1500000000,1500000000
100147217857,1642764635,67622,101647217857,67622,129837295880,1500000000,1500000000
109414727309,1642753327,317620,110914727309,317620,137412786713,1500000000,1500000000
48785277797,1645518252,322400,50285277797,322400,53000000000,1500000000,1500000000
130527761392,1641392306,333708,132027761392,333708,164360478834,1500000000,1500000000
163237817170,1642090987,317286,164737817170,317286,167222854877,1500000000,1500000000
137775479401,1642780073,55648,139275479401,50848,154052656053,1500000000,1500000000
40685731188,1645970243,67634,42185731188,67634,48178394410,1500000000,1500000000
76265746255,1641361971,60850,77765746255,56050,86000000000,1500000000,1500000000
22002127069,1647414261,55705,23002127069,50905,26540239238,1000000000,1000000000
179778881251,1642748391,330485,181278881251,330485,223636710267,1500000000,1500000000
42364383151,1645535325,323672,43864383151,323672,53754104458,1500000000,1500000000
136536379012,1641352675,60850,138306964632,56050,172473948015,1770585620,1770585620
194099957979,1642052171,67646,195599957979,62846,241911414269,1500000000,1500000000
28858537088,1647441977,60862,30358537088,56062,33036017328,1500000000,1500000000
105064679617,1642753801,67646,106564679617,62846,119438714237,1500000000,1500000000
81034129323,1645507344,343825,82534129323,343825,101261046164,1500000000,1500000000
135066362622,1641364635,67634,136566362622,62834,164205891783,1500000000,1500000000
45014863528,1647440436,67646,46514863528,67646,64131173932,1500000000,1500000000
33726342795,1648603739,66790,35226342795,66790,47703677090,1500000000,1500000000
145986435037,1641407404,60862,147486435037,56062,160916654838,1500000000,1500000000
29116535207,1647409634,67646,30616535207,62846,37241256112,1500000000,1500000000
136863872962,1641393263,60850,138157236868,60850,138157236868,1500000000,1293363906
65592299383,1648673925,67622,67112761499,67622,82423017689,1520462116,1520462116
136485462343,1641424173,60850,137985462343,56050,142315952532,1500000000,1500000000
128700237666,1642073363,319307,130200237666,319307,172142510739,1500000000,1500000000
97666329345,1642744970,319783,99166329345,319783,100000000000,1500000000,1500000000
50298223772,1644654110,322480,51798223772,322480,52000000000,1500000000,1500000000
214492080819,1642108029,60850,215992080819,56050,286532113234,1500000000,1500000000
36308038379,1648684578,60850,37808038379,56050,42370593287,1500000000,1500000000
44837713477,1648680561,300807,46337713477,300807,47421150232,1500000000,1500000000
105693059403,1642776678,49495,107193059403,49495,138965118667,1500000000,1500000000
87446986884,1642761178,342021,89446986884,342021,103799750597,2000000000,2000000000
71846161814,1644707508,308900,73346161814,308900,90773152977,1500000000,1500000000
31152017072,1647451768,67646,32652017072,62846,43812334198,1500000000,1500000000
122050692000,1642752037,62139,123550692000,57339,144017299208,1500000000,1500000000
222239740233,1642118239,59970,223739740233,59970,245558464628,1500000000,1500000000
100294963067,1642066720,329469,101794963067,329469,105000000000,1500000000,1500000000
113773969057,1642061223,55592,115273969057,50792,147333038447,1500000000,1500000000
152618166783,1642100877,67634,159770548357,62834,,,
91001071675,1642761198,60838,92501071675,60838,99384375574,1500000000,1500000000
24858916928,1645966600,63200,27358916928,63200,57683393862,2500000000,2500000000
39997432697,1644667694,326830,41497432697,326830,42251973857,1500000000,1500000000
82331136117,1645545253,67634,83831136117,62834,120671493390,1500000000,1500000000
49407221196,1645518341,55584,50907221196,50784,66458838553,1500000000,1500000000
107520570187,1641379944,60006,109020570187,55206,128017818118,1500000000,1500000000
88885239965,1641366464,340005,90385239965,340005,110292753314,1500000000,1500000000
37213877569,1647435700,304534,39153877569,304534,53135625947,1940000000,1940000000
122203872358,1642086072,60850,123703872358,56050,165431173279,1500000000,1500000000
54628294306,1647400632,331143,56128294306,331143,69992249564,1500000000,1500000000
42695957270,1647413400,302823,44195957270,302823,44902019809,1500000000,1500000000
86943131214,1645505182,336855,88443131214,336855,100700670754,1500000000,1500000000
53337698836,1645518126,329292,54837698836,329292,60769668380,1500000000,1500000000
63114048650,1645517231,329192,64614048650,329192,76772934297,1500000000,1500000000
135986905652,1642070597,59994,137396905652,55194,169280762173,1410000000,1410000000
40694865482,1647459712,67646,42194865482,62846,43369289947,1500000000,1500000000
61994816561,1644704001,48627,63494816561,43827,75130745830,1500000000,1500000000
21262536766,1647424446,67634,22762536766,62834,27042362144,1500000000,1500000000
42626277671,1646001723,333672,43626277671,333672,47412486116,1000000000,1000000000
58022862879,1648676320,316714,59522862879,316714,60656180108,1500000000,1500000000
63286960236,1648673734,60862,65057545856,56062,96876170602,1770585620,1770585620
123658047659,1642058245,60838,125158047659,60838,153241660557,1500000000,1500000000
158226902079,1642099848,331195,159876902079,331195,172000000000,1650000000,1650000000
30456732217,1645974286,293287,31956732217,293287,33000000000,1500000000,1500000000
94984995490,1641387207,60838,96484995490,60838,130507384259,1500000000,1500000000
152457190904,1642047320,67646,153957190904,62846,207042871977,1500000000,1500000000
131454109902,1642083356,54861,133954109902,54861,285591883132,2500000000,2500000000
24508934593,1648614438,54771,26008934593,49971,31035938719,1500000000,1500000000
124708158701,1642772882,67622,126358158701,67622,169343110560,1650000000,1650000000
269039615298,1642732038,67646,270539615298,62846,323387664773,1500000000,1500000000
88650188032,1644631333,328346,90150188032,328346,118925859655,1500000000,1500000000
79669554554,1645503409,317326,81319554554,317326,114470320940,1650000000,1650000000
133101821101,1641355068,336897,134601821101,336897,154884861542,1500000000,1500000000
98536489526,1641397558,333740,100036489526,333740,152140161779,1500000000,1500000000
117515711385,1642109419,67634,120000000000,67634,120000000000,5000000000,2484288615
206462602687,1642098732,67634,207962602687,67634,271142350842,1500000000,1500000000
120448216752,1642052875,67646,121948216752,62846,151254696663,1500000000,1500000000
113214280335,1645541851,49483,114714280335,49483,117054398952,1500000000,1500000000
86784897527,1641370190,67646,88284897527,67646,129690707033,1500000000,1500000000
81748091190,1641375691,60862,83248091190,56062,113727573070,1500000000,1500000000
21284950454,1647425505,67634,22290644879,62834,22290644879,1500000000,1005694425
39791378668,1644670944,323610,41291378668,323610,51332208159,1500000000,1500000000
92377895337,1641382930,55717,93877895337,50917,124737127120,1500000000,1500000000
222110771739,1642074671,55717,224110771739,50917,263359786180,2000000000,2000000000
53019160940,1648652280,60838,54519160940,60838,70502308482,1500000000,1500000000
202238076883,1642800585,316622,203738076883,316622,282008747430,1500000000,1500000000
91792567206,1641358889,331161,93292567206,331161,110173594458,1500000000,1500000000
36679400579,1645926556,326751,38179400579,326751,53771778400,1500000000,1500000000
90997477182,1645542418,55680,92497477182,50880,100851858937,1500000000,1500000000
117856270058,1642066915,52928,119356270058,48128,151261343838,1500000000,1500000000
111995718372,1642070091,307777,113495718372,307777,156178084462,1500000000,1500000000
111995718372,1642070091,60862,113495718372,56062,145000000000,1500000000,1500000000
168006304970,1642065586,59946,169506304970,55146,221987156299,1500000000,1500000000
41766699417,1647449813,67634,43266699417,67634,53554856957,1500000000,1500000000
22675301413,1647426237,310141,24675301413,310141,33284409212,2000000000,2000000000
36441515650,1648610116,60850,37941515650,56050,46285995478,1500000000,1500000000
71575161063,1642763069,331139,93500000000,331139,,,
58925953696,1645527236,323529,60425953696,323529,69066413292,1500000000,1500000000
88835537502,1641343666,340023,90335537502,340023,139878126257,1500000000,1500000000
151176879835,1642733487,337532,152422755835,337532,155221863093,1245876000,1245876000
130473691178,1642056209,67646,131973691178,62846,142874902622,1500000000,1500000000
37030609218,1647443119,67622,38530609218,67622,43816743630,1500000000,1500000000
63540490264,1644685703,64729,65040490264,59929,70900583852,1500000000,1500000000
131205644034,1641358053,67622,132705644034,62822,159941538939,1500000000,1500000000
110180130354,1642047974,323501,111680130354,323501,139562613424,1500000000,1500000000
127116439514,1642065256,60862,128616439514,56062,184989575263,1500000000,1500000000
131785692794,1642115844,54545,132785692794,49745,132852956198,1000000000,1000000000
34366253164,1648633139,55693,35450639572,50893,35450639572,1500000000,1084386408
158144890980,1642771034,337490,159644890980,337490,208154964337,1500000000,1500000000
40677558383,1644676253,314108,42177558383,314108,56046254095,1500000000,1500000000
68601042399,1645565660,308930,70131042399,308930,107043307359,1530000000,1530000000
81740076115,1641359612,316596,83240076115,316596,92334629538,1500000000,1500000000
135032442153,1642084531,340677,136532442153,340677,171238193920,1500000000,1500000000
33237524118,1647434892,67658,34737524118,62858,42509526873,1500000000,1500000000
33301757675,1648632229,67622,34801757675,67622,47990966680,1500000000,1500000000
165228397285,1642732682,331205,166728397285,331205,194870372170,1500000000,1500000000
76975387890,1641359187,55283,78475387890,50483,110716721347,1500000000,1500000000
75703412974,1641359843,67634,77203412974,62834,96890176613,1500000000,1500000000
103509862645,1642054479,59958,105009862645,55158,145074454017,1500000000,1500000000
146936058417,1642041703,60862,148436058417,56062,244950326835,1500000000,1500000000
102496303881,1642069313,322496,103996303881,322496,109235444028,1500000000,1500000000
115770945350,1642749299,296254,117770945350,296254,160916270744,2000000000,2000000000
33340323886,1644669099,67722,34840323886,62922,43923219017,1500000000,1500000000
81663914355,1645492621,67646,83163914355,62846,90804335693,1500000000,1500000000
35640721143,1648628797,67634,37140721143,62834,49528244904,1500000000,1500000000
95492034363,1644631456,323801,96992034363,323801,125167700830,1500000000,1500000000
63996556792,1644685937,55684,65496556792,50884,79330342772,1500000000,1500000000
95928170372,1642771857,337464,97924909312,337464,,,
132740072310,1642112998,322917,134240072310,322917,134706148075,1500000000,1500000000
125462560427,1642047813,332412,126962560427,332412,153288337530,1500000000,1500000000
146251909718,1642038570,67646,147751909718,62846,180000000000,1500000000,1500000000
120466076610,1642037315,324760,121966076610,324760,159329485874,1500000000,1500000000
143776906332,1642777191,322979,145276906332,322979,161461371718,1500000000,1500000000
29658178048,1647428934,56588,31158178048,51788,41804844774,1500000000,1500000000
82557288811,1648670711,67622,84057288811,67622,113427386832,1500000000,1500000000
91048842955,1642744961,325703,92548842955,325703,100000000000,1500000000,1500000000
37626036293,1645971623,312475,39126036293,312475,50056569972,1500000000,1500000000
96102690938,1641389134,60874,97602690938,56074,140535467743,1500000000,1500000000
146964988215,1641345469,67634,148464988215,67634,177286125233,1500000000,1500000000
120684742274,1642079336,67634,122184742274,62834,181334850488,1500000000,1500000000
24463078893,1647418669,321893,25963078893,321893,30276614412,1500000000,1500000000
115814144605,1642776540,333680,117314144605,333680,123038216078,1500000000,1500000000
115814144605,1642776540,67646,124139376260,62846,,,
133210484330,1641351339,60874,134710484330,56074,149525020028,1500000000,1500000000
130731621995,1642117678,55592,132231621995,50792,171675680150,1500000000,1500000000
182588220804,1642089031,60862,184088220804,56062,275523551802,1500000000,1500000000
136655212137,1645564851,55632,138155212137,50832,165036665554,1500000000,1500000000
193838586048,1642116256,54800,195338586048,54800,235786832960,1500000000,1500000000
20164395707,1647427377,67634,21664395707,62834,29845426085,1500000000,1500000000
189268318801,1642091114,60850,190768318801,56050,243239300188,1500000000,1500000000
26646749233,1647433201,60862,28146749233,56062,41054044524,1500000000,1500000000
20713615744,1648630777,67634,22213615744,67634,32640876970,1500000000,1500000000
63915929985,1644683228,64741,65415929985,59941,85102386125,1500000000,1500000000
82789837940,1645503230,318740,84289837940,318740,300000000000,1500000000,1500000000
106775306723,1641392686,59910,108275306723,59910,126609261492,1500000000,1500000000
122016527842,1642053907,321678,123516527842,321678,147056272318,1500000000,1500000000
49713742709,1645526275,60862,51213742709,56062,58197673880,1500000000,1500000000
154450073346,1642077540,63200,156950073346,63200,278291558340,2500000000,2500000000
60794383941,1647400450,67622,62294383941,62822,77310304810,1500000000,1500000000
22875828227,1648609852,67722,24375828227,62922,33707662482,1500000000,1500000000
82176902542,1645509000,67622,83676902542,67622,99626946544,1500000000,1500000000
82176902542,1645509000,334615,83676902542,334615,99626946544,1500000000,1500000000
100937905719,1641360514,310382,102937905719,310382,135094875353,2000000000,2000000000
112257738059,1641342324,60862,113757738059,56062,125480200892,1500000000,1500000000
27125670098,1647405815,55592,28625670098,50792,33302382407,1500000000,1500000000
144065180021,1642080403,331151,145565180021,331151,161581323597,1500000000,1500000000
236541674628,1642784459,334322,238041674628,334322,242985665380,1500000000,1500000000
21134787679,1645936471,298211,22634787679,298211,25273634212,1500000000,1500000000
62854505869,1644683433,302597,64354505869,302597,85524380093,1500000000,1500000000
167999840591,1642109201,67634,169499840591,67634,233673460283,1500000000,1500000000
34950283207,1648601214,60862,36450283207,56062,45775877768,1500000000,1500000000
66199986554,1645991459,314160,67699986554,314160,71297640623,1500000000,1500000000
123117281934,1641370360,55705,124617281934,50905,136387539425,1500000000,1500000000
115141163969,1641368744,55592,116641163969,50792,142084172588,1500000000,1500000000
151268805136,1642741515,326171,152768805136,326171,192089324139,1500000000,1500000000
278463641394,1642797650,66862,279963641394,66862,346859224175,1500000000,1500000000
29137020221,1645928632,321068,30637020221,321068,43950528715,1500000000,1500000000
46800626911,1644648048,66778,48300626911,61978,63054011868,1500000000,1500000000
108214664119,1645489405,337542,109714664119,337542,129361914340,1500000000,1500000000
108214664119,1645489405,305950,109714664119,305950,140104666265,1500000000,1500000000
82789017508,1645541377,55608,84289017508,50808,85368244795,1500000000,1500000000
101739982955,1641368988,60838,103239982955,56038,130021628513,1500000000,1500000000
122855385457,1641362883,67634,139951411680,67634,,,
115187205013,1642063793,55592,116687205013,50792,130869627525,1500000000,1500000000
67465594932,1644698412,314025,68965594932,314025,69964044532,1500000000,1500000000
58634627447,1645505996,349554,60134627447,349554,70719209074,1500000000,1500000000
131984885974,1641400761,60862,133484885974,56062,193459031279,1500000000,1500000000
180130761449,1642111506,67634,181630761449,67634,238128079892,1500000000,1500000000
68155744500,1644680361,326046,69655744500,326046,97235639784,1500000000,1500000000
82508284934,1647447262,67646,84008284934,62846,84923302150,1500000000,1500000000
91613649842,1645554220,63873,93113649842,59073,135878422023,1500000000,1500000000
82626340146,1641358828,49495,84126340146,44695,117373324274,1500000000,1500000000
53803078028,1648605175,327371,55303078028,327371,75794702949,1500000000,1500000000
53803078028,1648605175,55592,55303078028,50792,75794702949,1500000000,1500000000
96334967600,1644631402,320605,97834967600,320605,121667633813,1500000000,1500000000
107169382356,1641364869,312940,108669382356,312940,129594594858,1500000000,1500000000
103502465250,1641347610,60838,105002465250,60838,112750849025,1500000000,1500000000
39072513138,1647441757,60850,41072513138,56050,53838088611,2000000000,2000000000
35133412509,1648614079,337482,36633412509,337482,42540403162,1500000000,1500000000
132184943362,1642773142,336935,133684943362,336935,144074977859,1500000000,1500000000
112791382261,1641363682,67622,114291382261,67622,141305919288,1500000000,1500000000
145339527374,1641417765,67634,146839527374,62834,180846795884,1500000000,1500000000
129770686026,1641364773,60862,131270686026,56062,147724879275,1500000000,1500000000
199555044231,1642101325,60850,201055044231,56050,223289553479,1500000000,1500000000
155590755364,1642110787,54836,178000000000,50036,,,
136560837369,1642034406,67634,138060837369,67634,180106692819,1500000000,1500000000
89497993951,1641386425,67634,90997993951,67634,124286746519,1500000000,1500000000
111895983024,1641360553,60862,113395983024,56062,143075305103,1500000000,1500000000
88991295842,1641347029,334338,119364351527,334338,,,
147309746700,1641395519,60862,148809746700,56062,171727922129,1500000000,1500000000
132632904513,1642117610,67646,134132904513,62846,172549080244,1500000000,1500000000
129767367368,1642747556,332374,131267367368,332374,137034337212,1500000000,1500000000
35264838914,1644665853,55612,36764838914,50812,42771015619,1500000000,1500000000
60001615741,1644693418,53240,62001615741,48440,99000000000,2000000000,2000000000
106512991073,1642066789,67622,108012991073,62822,119860141317,1500000000,1500000000
39233386463,1647391294,297643,40733386463,297643,44838612879,1500000000,1500000000
97261928702,1648663982,63188,98761928702,63188,174476895044,1500000000,1500000000
73384309052,1648673605,66754,75324309052,66754,101145897444,1940000000,1940000000
73384309052,1648673605,310249,75384309052,310249,79339149735,2000000000,2000000000
94820396476,1645565462,55584,96490396476,50784,99000000000,1670000000,1670000000
146025018001,1641398069,67634,147525018001,62834,169921969363,1500000000,1500000000
41430579837,1644646664,314118,42930579837,314118,54483933712,1500000000,1500000000
156548169766,1642791151,319319,158048169766,319319,195669800199,1500000000,1500000000
55660433699,1645519814,343225,57160433699,343225,59281126070,1500000000,1500000000
121410132670,1641357988,334308,122820132670,334308,146753392349,1410000000,1410000000
88065681687,1641368052,60850,89565681687,56050,113861577535,1500000000,1500000000
145727110207,1642117460,67646,147227110207,62846,192796872889,1500000000,1500000000
175303170144,1642088985,55781,176803170144,50981,216880847117,1500000000,1500000000
197824794304,1642088508,317338,199324794304,317338,226149721023,1500000000,1500000000
137502471377,1642055924,59982,139002471377,55182,151084176003,1500000000,1500000000
29558114317,1648604256,60850,32558114317,60850,69000000000,3000000000,3000000000
96751561476,1645543046,56492,98251561476,56492,134147657115,1500000000,1500000000
32193403359,1648628159,309816,33693403359,309816,44374503912,1500000000,1500000000
84044469497,1648656848,66730,85544469497,61930,124317976590,1500000000,1500000000
32537675993,1645951956,55705,34037675993,50905,49312037182,1500000000,1500000000
123048294556,1641356041,60862,124548294556,56062,177283277937,1500000000,1500000000
78444678676,1641359390,66718,79944678676,61918,98904967824,1500000000,1500000000
40724380981,1648651718,313479,42224380981,313479,53050101613,1500000000,1500000000
22269064987,1647432620,55717,23769064987,50917,28023964612,1500000000,1500000000
24847747545,1648620587,67634,26347747545,67634,34795603893,1500000000,1500000000
27043138740,1648604194,66790,28543138740,66790,36823807502,1500000000,1500000000
124740903912,1642754416,59982,126240903912,55182,149611287502,1500000000,1500000000
58198420585,1644703987,67634,59698420585,62834,75130745830,1500000000,1500000000
32380211774,1644660526,330083,33880211774,323614,48904877320,1500000000,1500000000
174299372138,1642087674,52928,175799372138,48128,215358509782,1500000000,1500000000
93849615572,1642767071,336883,95349615572,336883,115855558523,1500000000,1500000000
66571979699,1645504564,326032,68071979699,326032,73653306277,1500000000,1500000000
191071418349,1642034015,67646,192571418349,62846,203200246035,1500000000,1500000000
101689751965,1648657953,67722,103189751965,62922,107955441772,1500000000,1500000000
28249223670,1648618229,59982,29249223670,55182,30000000000,1000000000,1000000000
79168970867,1642754615,300174,80668970867,300174,81000000000,1500000000,1500000000
123319732972,1642057091,311297,124819732972,311297,125271450868,1500000000,1500000000
36916330495,1647435679,327421,38416330495,327421,41577895585,1500000000,1500000000
103486266328,1642776636,60850,104986266328,56050,126568461202,1500000000,1500000000
84129926163,1641377501,67710,85629926163,67710,100375933147,1500000000,1500000000
120599218346,1642083856,67646,122599218346,62846,154292829991,2000000000,2000000000
105150280154,1648662543,60838,106650280154,56038,140902366873,1500000000,1500000000
97502136640,1642745822,327992,99000000000,327992,99000000000,1500000000,1497863360
305645926732,1642805097,67646,307151837182,62846,439952733030,1505910450,1505910450
21710450457,1645953831,306603,23210450457,306603,30297401284,1500000000,1500000000
87042463636,1641377343,340053,88542463636,340053,97126087690,1500000000,1500000000
24587348467,1648630164,67646,26087348467,62846,31202037752,1500000000,1500000000
179389750403,1642728859,67634,181389750403,67634,230000000000,2000000000,2000000000
30776317749,1645968381,310953,32276317749,310953,38216503960,1500000000,1500000000
185564414329,1642045616,67634,187064414329,62834,245027696639,1500000000,1500000000
185564414329,1642045616,49519,187064414329,44719,245027696639,1500000000,1500000000
98904547305,1644678060,314069,100844547305,314069,107516509395,1940000000,1940000000
287734630371,1641406016,327347,289234630371,327347,390205864898,1500000000,1500000000
24900156470,1645939409,301464,26400156470,301464,32611203423,1500000000,1500000000
156050009137,1641408962,60042,157550009137,55242,173696555962,1500000000,1500000000
160813739961,1642114058,60850,162313739961,56050,207025186552,1500000000,1500000000
138382068649,1642100888,206324,139882068649,200119,204123178080,1500000000,1500000000
300104465910,1642808184,340663,301604465910,340663,303768722618,1500000000,1500000000
55066045992,1644701776,60838,56566045992,56038,85087108709,1500000000,1500000000
19012186065,1647421125,49483,20512186065,49483,28245309530,1500000000,1500000000
29880807422,1648636471,67622,31380807422,67622,51576944262,1500000000,1500000000
100661802719,1641375615,48615,107534515987,48615,,,
119653291582,1641424974,60862,121153291582,56062,172057212822,1500000000,1500000000
85116502691,1641372546,60850,86616502691,56050,111614588980,1500000000,1500000000
153830676907,1642753117,322987,155330676907,322987,180266197585,1500000000,1500000000
75515563728,1641371816,60850,77015563728,56050,88000000000,1500000000,1500000000
35068432902,1645968867,54861,37568432902,54861,73056904268,2500000000,2500000000
149967066897,1641402792,326814,151467066897,326814,181964019009,1500000000,1500000000
167986023721,1642087731,65518,169486023721,60718,213268090694,1500000000,1500000000
28108052809,1648631426,60926,29608052809,60926,39405798760,1500000000,1500000000
139072937509,1641395149,59958,140572937509,55158,166812465812,1500000000,1500000000
77676595625,1645551079,55584,79176595625,50784,110703513284,1500000000,1500000000
86746676107,1641358970,66766,88246676107,66766,113616942689,1500000000,1500000000
103283656348,1641381977,55705,104783656348,50905,123798263293,1500000000,1500000000
171777381456,1642096483,67634,173277381456,67634,237507660739,1500000000,1500000000
166294253582,1642111096,59982,167794253582,55182,188342962675,1500000000,1500000000
19996581062,1647421850,317318,21496581062,317318,24518588075,1500000000,1500000000
155102895545,1641408708,60850,156602895545,56050,193253308244,1500000000,1500000000
149851297454,1642065114,319771,151351297454,319771,191791900410,1500000000,1500000000
208915587201,1642732441,336873,210415587201,336873,306160531137,1500000000,1500000000
196027285853,1642784106,59982,197527285853,55182,233367000423,1500000000,1500000000
86711853717,1641360928,59970,88211853717,55170,93325248648,1500000000,1500000000
123434503209,1642069388,55580,124934503209,55580,145407533859,1500000000,1500000000
151967368395,1642052396,60862,153467368395,56062,218187567220,1500000000,1500000000
43153401637,1645519246,328212,44653401637,328212,45000000000,1500000000,1500000000
70434195696,1648653570,54784,71934195696,49984,75029119798,1500000000,1500000000
166066193113,1642793462,327988,167566193113,327988,211326821040,1500000000,1500000000
87920638106,1644678055,314081,89860638106,314081,90941268955,1940000000,1940000000
126263063481,1642103969,67646,127763063481,62846,167304590704,1500000000,1500000000
40420353270,1648619057,60850,41920353270,56050,43946840617,1500000000,1500000000
122140269193,1642782304,327952,123640269193,327952,176939982443,1500000000,1500000000
36146487122,1645980407,350193,37646487122,350193,43660879315,1500000000,1500000000
200111521269,1642081800,65530,201611521269,60730,273978597382,1500000000,1500000000
89871112179,1642771284,319738,90871112179,319738,100000000000,1000000000,1000000000
69248481663,1645998992,307142,71248481663,307142,75000000000,2000000000,2000000000
192165812210,1642109578,67634,193665812210,62834,234999092695,1500000000,1500000000
238127148751,1642089697,60862,239627148751,56062,261133933744,1500000000,1500000000
35757837421,1648627334,60850,37257837421,56050,45172157043,1500000000,1500000000
89514032487,1641389592,67658,91014032487,62858,118879454888,1500000000,1500000000
89514032487,1641389592,60850,91514032487,56050,124074633083,2000000000,2000000000
179228992576,1642092349,340071,180728992576,340071,223726448713,1500000000,1500000000
113866927936,1642771957,311114,115366927936,311114,122090819489,1500000000,1500000000
95342506018,1642754122,326832,96842506018,326832,114538583665,1500000000,1500000000
46933521178,1645983225,67634,48433521178,67634,64070302569,1500000000,1500000000
62534797014,1645540926,343205,64034797014,343205,80258377613,1500000000,1500000000
161104293048,1642074092,55580,162604293048,55580,208606578973,1500000000,1500000000
57999158705,1647447054,55705,59499158705,50905,61000000000,1500000000,1500000000
74885224837,1645504594,323594,75479499387,323594,75479499387,1500000000,594274550
176426452236,1642115064,66718,177926452236,66718,235552108155,1500000000,1500000000
186354274821,1642085332,64741,188004274821,59941,247450792115,1650000000,1650000000
41521093935,1647452070,336867,43021093935,336867,53300748893,1500000000,1500000000
98577459161,1642776660,308976,100077459161,308976,126403468187,1500000000,1500000000
115413114453,1645571191,67634,116913114453,62834,165731518145,1500000000,1500000000
146546286724,1641400036,50000,250000000000,22142,,,
136758370882,1642070269,64741,138258370882,59941,188340217243,1500000000,1500000000
479334921938,1642805608,315286,480834921938,315286,646983775430,1500000000,1500000000
77495748197,1645493976,67634,78995748197,62834,87607939985,1500000000,1500000000
94432346024,1641347439,52653,95932346024,52653,102595454313,1500000000,1500000000
94432346024,1641347439,67634,95932346024,62834,111346708453,1500000000,1500000000
101805565894,1641384374,54849,103305565894,50049,114617346552,1500000000,1500000000
163672445048,1642727195,52916,165172445048,48116,200375974485,1500000000,1500000000
167590368697,1642048506,59982,169090368697,55182,216307544779,1500000000,1500000000
44683935086,1647459073,336905,46183935086,336905,63559163975,1500000000,1500000000
32274537251,1648684544,313451,34274537251,313451,48148728825,2000000000,2000000000
76886909890,1642766200,312307,78386909890,312307,96700032294,1500000000,1500000000
121074831983,1641353801,67622,122574831983,67622,188000000000,1500000000,1500000000
120671376111,1642061588,67646,122171376111,62846,140925522153,1500000000,1500000000
196571742304,1642085276,60850,197056577132,56050,197056577132,1500000000,484834828
34982386087,1648628727,55693,36482386087,50893,42874420165,1500000000,1500000000
181777378171,1642738165,322799,183277378171,322799,185262950544,1500000000,1500000000
92291024353,1644702793,331151,93791024353,331151,105782416554,1500000000,1500000000
102408252549,1645504259,307819,103908252549,307819,105791632654,1500000000,1500000000
130432871250,1641395130,60862,131932871250,56062,176651856445,1500000000,1500000000
93869848776,1641363912,67646,95369848776,62846,112188049893,1500000000,1500000000
157426437435,1642082481,60862,158926437435,56062,214821404635,1500000000,1500000000
27280833684,1648648453,67622,28780833684,67622,32720948434,1500000000,1500000000
103643222349,1641349971,331195,105143222349,331195,134130046074,1500000000,1500000000
135299854000,1642043614,67622,136799854000,67622,194054189304,1500000000,1500000000
121285572471,1642745693,56504,122695572471,51704,128525259587,1410000000,1410000000
118113961228,1642099339,324212,119763961228,324212,120000000000,1650000000,1650000000
75317283198,1648677663,64741,76817283198,59941,85188737934,1500000000,1500000000
34510349169,1648631740,340671,36010349169,340671,41058877879,1500000000,1500000000
33803428108,1645971063,321666,35840797719,321666,,,
109269319556,1641363809,67622,110769319556,67622,143123829930,1500000000,1500000000
53698191090,1644648990,316620,55198191090,316620,79258981762,1500000000,1500000000
73366477245,1645494417,329994,74866477245,329994,84343648304,1500000000,1500000000
141567021874,1642070474,330008,143067021874,330008,187197745767,1500000000,1500000000
220709603867,1642800752,327970,222209603867,327970,254297596104,1500000000,1500000000
71909944309,1645488736,326286,73409944309,326286,93184108133,1500000000,1500000000
87239615206,1645503527,334304,88739615206,317204,98442027672,1500000000,1500000000
87239615206,1645503527,334344,88739615206,334344,107468209933,1500000000,1500000000
121718898932,1641344901,60850,123218898932,56050,188503871524,1500000000,1500000000
104282148071,1641351943,321662,105782148071,321662,131316813663,1500000000,1500000000
203905857980,1642094156,67622,205405857980,67622,250809557488,1500000000,1500000000
23606410872,1648621185,65518,25106410872,60718,32950489388,1500000000,1500000000
147932908912,1642797317,331111,149432908912,331111,150000000000,1500000000,1500000000
147932908912,1642797317,333674,149432908912,333674,150000000000,1500000000,1500000000
141370455752,1641397457,67646,142870455752,62846,237069999485,1500000000,1500000000
53432251718,1644681319,64067,54932251718,59267,57448973294,1500000000,1500000000
98969043850,1641371489,67646,99000000000,62846,99000000000,1500000000,30956150
73868458959,1641377881,327996,75368458959,327996,106474997029,1500000000,1500000000
108376420985,1641389224,54800,109876420985,54800,147482915415,1500000000,1500000000
155688743035,1642098793,60862,157188743035,56062,228323554918,1500000000,1500000000
155657210751,1642083312,55592,157157210751,50792,174468516530,1500000000,1500000000
59183599509,1645504508,55644,61683599509,55644,117945290042,2500000000,2500000000
131095212879,1641346461,60862,132595212879,56062,136710930382,1500000000,1500000000
117856882799,1641350967,67634,119356882799,67634,143779638903,1500000000,1500000000
165535474956,1641396505,316602,167035474956,316602,208339206792,1500000000,1500000000
147264082147,1642113333,313449,148764082147,313449,210532708714,1500000000,1500000000
141788193473,1642114629,54884,143288193473,50084,186068566640,1500000000,1500000000
21440522224,1647432950,60838,22940522224,60838,26730122669,1500000000,1500000000
231280051892,1642724423,330561,232780051892,330561,249579766483,1500000000,1500000000
37252818908,1645974255,300721,38902818908,300721,39000000000,1650000000,1650000000
141924559194,1642060935,320410,143924559194,320410,190099088462,2000000000,2000000000
70948526967,1648653635,60018,72448526967,55218,85009918053,1500000000,1500000000
164531142397,1642793472,331161,166031142397,314061,225582856365,1500000000,1500000000
163081716425,1642733421,55693,164581716425,50893,201343658237,1500000000,1500000000
75331984264,1641383750,60850,76831984264,56050,112736414607,1500000000,1500000000
98200474238,1641390432,64741,100200474238,59941,139574196039,2000000000,2000000000
222167882341,1642032066,48627,223667882341,48627,282250270515,1500000000,1500000000
107647800742,1645559808,55596,109147800742,50796,113040418467,1500000000,1500000000
67034979136,1641359562,59958,73731353768,59958,,,
198198160228,1643407643,328026,200079960228,328026,274175559123,1881800000,1881800000
162389691024,1643404393,55624,163799691024,50824,168322770334,1410000000,1410000000
91162647790,1644193769,67646,92662647790,67646,115112713579,1500000000,1500000000
130452943571,1643344518,67646,131952943571,62846,166664711773,1500000000,1500000000
57704217380,1644231893,320352,59204217380,320352,70956188779,1500000000,1500000000
141176355273,1643402799,320397,142676355273,320397,210896251695,1500000000,1500000000
93494931963,1643378540,321612,94994931963,321612,114429049534,1500000000,1500000000
108521943088,1643378646,313463,110021943088,313463,133983534844,1500000000,1500000000
158825357453,1643392400,308545,160325357453,308545,197574344265,1500000000,1500000000
139221226367,1644247629,340625,140721226367,340625,151018437552,1500000000,1500000000
124745583769,1643404978,64705,126245583769,59905,151883313979,1500000000,1500000000
117911808234,1643342244,310894,119911808234,310894,159657605789,2000000000,2000000000
89171135391,1644219891,322929,90671135391,322929,121220625905,1500000000,1500000000
125477370605,1644247473,54727,126977370605,49927,140937006113,1500000000,1500000000
145342855681,1643386966,317210,157000000000,317210,,,
129125815646,1644199290,322434,130625815646,322434,180292491692,1500000000,1500000000
47518664996,1644229043,64067,49018664996,59267,78114429873,1500000000,1500000000
103477280049,1644270324,67622,105477280049,67622,188387006834,2000000000,2000000000
109057587019,1643383007,60850,110557587019,56050,130452537095,1500000000,1500000000
165690603498,1643401185,314064,167190603498,314064,172227254170,1500000000,1500000000
62184982839,1644212870,317186,63684982839,317186,79512149858,1500000000,1500000000
132924055443,1643340279,310912,134424055443,310912,185661737289,1500000000,1500000000
132924055443,1643340279,313455,134424055443,313455,172357882085,1500000000,1500000000
81046319403,1644223446,67646,82546319403,67646,96136632728,1500000000,1500000000
73779651359,1644218604,326067,75279651359,326067,101163552923,1500000000,1500000000
117962672324,1643341437,54715,119462672324,54715,133901219023,1500000000,1500000000
79023776444,1644274389,54332,80523776444,49532,114876022595,1500000000,1500000000
84684621221,1644203213,55632,87184621221,55632,185162285364,2500000000,2500000000
112445689644,1643342470,319297,113945689644,319297,139615173135,1500000000,1500000000
60130668457,1644231305,55668,61630668457,50868,92800680475,1500000000,1500000000
107601584629,1643355442,332482,109101584629,332482,129393116508,1500000000,1500000000
144532969210,1643394020,334286,146032969210,334286,160615540719,1500000000,1500000000
105184102494,1643347600,309810,106684102494,309810,121000000000,1500000000,1500000000
115842520315,1643404030,327421,117342520315,327421,123658396964,1500000000,1500000000
133960026697,1644256053,312147,135460026697,312147,173172867710,1500000000,1500000000
150578288417,1643405619,60850,152078288417,56050,160970695283,1500000000,1500000000
140400016830,1643413511,320491,141900016830,320491,200000000000,1500000000,1500000000
122373829107,1643344192,346392,123873829107,346392,125751379875,1500000000,1500000000
142313931702,1643404904,60850,143813931702,56050,204453897350,1500000000,1500000000
123926190210,1643375861,313437,125426190210,313437,148953376942,1500000000,1500000000
226954180242,1643407570,333736,229101015306,333736,305875319237,2146835064,2146835064
139373925148,1643400917,66790,140873925148,66790,231832431138,1500000000,1500000000
51844828775,1644229922,64067,53344828775,59267,67737173962,1500000000,1500000000
137429445320,1644251794,60938,138929445320,56138,236900604282,1500000000,1500000000
84878828130,1644274412,55584,86000000000,50784,86000000000,1245876000,1121171870
122296210999,1643342332,319761,124296210999,319761,160000000000,2000000000,2000000000
150080725556,1643404879,64729,151580725556,64729,202254655833,1500000000,1500000000
129236315753,1644265462,322933,130736315753,322933,169678125535,1500000000,1500000000
84339655689,1643370551,296260,85839655689,296260,99705359292,1500000000,1500000000
144061379083,1643403908,206324,145561379083,200119,269336111852,1500000000,1500000000
145787006204,1644267218,67622,147287006204,62822,154476672790,1500000000,1500000000
80796615201,1644218385,67634,82296615201,62834,133052711344,1500000000,1500000000
94680130448,1643360720,330527,96180130448,330527,125929566678,1500000000,1500000000
116406528040,1643374939,320461,117906528040,320461,117965934235,1500000000,1500000000
80724287639,1643370718,60850,82224287639,56050,98727451203,1500000000,1500000000
132591805261,1643334908,67622,134091805261,67622,168619011769,1500000000,1500000000
75617482021,1644250808,60926,77117482021,60926,115526873582,1500000000,1500000000
113300332983,1643413657,60862,114800332983,56062,144089183052,1500000000,1500000000
129518871045,1643397440,335548,131018871045,335548,166341245657,1500000000,1500000000
77101270971,1643367445,300232,78621733087,300232,105683093708,1520462116,1520462116
124809899676,1643340331,67634,126309899676,67634,133955264268,1500000000,1500000000
116329583063,1643359757,343809,117829583063,343809,122236942900,1500000000,1500000000
147457623646,1643330328,327972,148957623646,327972,191549465782,1500000000,1500000000
125068978863,1643406767,55592,126568978863,50792,166286410474,1500000000,1500000000
151105412168,1643389160,330561,152260756167,330561,154970000355,1155343999,1155343999
138276960947,1643376334,333704,139776960947,333704,178610274200,1500000000,1500000000
116125188774,1643354729,54848,117625188774,50048,133448548809,1500000000,1500000000
129503332204,1643376814,60850,131003332204,56050,137424534208,1500000000,1500000000
123228815763,1643414165,336849,124728815763,336849,143054382953,1500000000,1500000000
277194195844,1643385741,319813,279194195844,319813,366002446256,2000000000,2000000000
110394033939,1643341604,304648,111894033939,304648,118027017472,1500000000,1500000000
123568168132,1643333809,321925,125068168132,321925,167427701727,1500000000,1500000000
106002197748,1644193977,54736,107502197748,49936,135111370924,1500000000,1500000000
56875759663,1644222198,324946,58375759663,324946,78956963245,1500000000,1500000000
85759226490,1643377705,347003,87409226490,347003,90166301095,1650000000,1650000000
101615688245,1643355669,328004,103115688245,328004,127232964179,1500000000,1500000000
138867504439,1644249924,56516,140367504439,51716,152106218694,1500000000,1500000000
69957509502,1644219222,337450,71457509502,337450,97262427297,1500000000,1500000000
124899815105,1641220159,60018,126399815105,55218,128211020673,1500000000,1500000000
105647878557,1641223492,313979,107147878557,313979,111794777104,1500000000,1500000000
71240202910,1649677961,336889,73065548910,336889,93180284494,1825346000,1825346000
32617499508,1646990725,60838,34117499508,60838,44663507278,1500000000,1500000000
39386732688,1647041623,67646,40886732688,62846,45677284122,1500000000,1500000000
137014664525,1642262532,60862,138514664525,56062,175040729830,1500000000,1500000000
149941179462,1642206016,67634,151441179462,67634,192660501078,1500000000,1500000000
152107929254,1641249628,60850,153607929254,56050,200400190005,1500000000,1500000000
162445433514,1642210312,67634,163855433514,62834,172935386957,1410000000,1410000000
135613600616,1642218597,60850,137113600616,56050,142142752079,1500000000,1500000000
143422574734,1641995620,55668,144922574734,50868,176162987182,1500000000,1500000000
143422574734,1641995620,322930,144922574734,322930,164287008235,1500000000,1500000000
205698879787,1641954994,316624,207198879787,316624,273070508862,1500000000,1500000000
122318515150,1641973254,67634,123818515150,62834,168080825555,1500000000,1500000000
200574093369,1642017196,55480,202074093369,55480,295773229588,1500000000,1500000000
27789495356,1647955693,54533,29289495356,49733,42402477264,1500000000,1500000000
74505149988,1649696510,63200,76005149988,63200,158158798860,1500000000,1500000000
157682045657,1642226534,60862,159182045657,56062,164187501039,1500000000,1500000000
20566129383,1646978460,60850,22066129383,56050,25088758190,1500000000,1500000000
44391093204,1647020826,66814,45891093204,66814,57259275482,1500000000,1500000000
18632055346,1647950740,60862,20132055346,56062,32700742193,1500000000,1500000000
48929401076,1647484412,340063,50429401076,340063,61006139418,1500000000,1500000000
62984789782,1647536482,55705,64484789782,50905,83752805064,1500000000,1500000000
14401195288,1647852515,65530,15901195288,60730,22251079594,1500000000,1500000000
16371088767,1646986532,333728,17871088767,333728,24265477779,1500000000,1500000000
17063014419,1646985475,333728,18563014419,333728,20771371139,1500000000,1500000000
39450154451,1647016572,67646,40950154451,58046,43977190060,1500000000,1500000000
85079706400,1641221110,60850,86579706400,56050,87411831810,1500000000,1500000000
48911309040,1649687012,67622,50411309040,67622,68394500138,1500000000,1500000000
18047932071,1646553109,325569,19547932071,320769,25733565830,1500000000,1500000000
22475192899,1647829200,329968,23975192899,329968,30040673355,1500000000,1500000000
115485908258,1642261085,336897,116985908258,336897,201042923108,1500000000,1500000000
115376886002,1641248324,49445,116876886002,44645,144592670354,1500000000,1500000000
105580127568,1641982053,54812,107080127568,50012,136922347880,1500000000,1500000000
105580127568,1641982053,60862,107080127568,60862,141766858500,1500000000,1500000000
77831398196,1649695664,67634,79331398196,67634,98263432085,1500000000,1500000000
45936129829,1649679828,54836,47436129829,50036,57868661239,1500000000,1500000000
45936129829,1649679828,52580,47436129829,47780,51375560075,1500000000,1500000000
34017863089,1647030688,55572,35517863089,50772,50383674270,1500000000,1500000000
69549601544,1641169865,330541,71049601544,330541,108099881939,1500000000,1500000000
115945840712,1641973850,300797,117445840712,300797,136731217935,1500000000,1500000000
98458627738,1642258792,320505,99958627738,320505,105063836544,1500000000,1500000000
76567021031,1641180912,160874,116000000000,56074,,,
101381984681,1641228899,60850,102881984681,60850,137585063397,1500000000,1500000000
117440488429,1641987049,60850,118940488429,60850,142281692228,1500000000,1500000000
35391491056,1646959368,67622,36891491056,67622,41837310122,1500000000,1500000000
102480298123,1641238121,67646,103980298123,62846,137234419446,1500000000,1500000000
99188607172,1641993493,55644,101688607172,55644,209784355676,2500000000,2500000000
18944247995,1646569485,319869,20944247995,319869,26162844996,2000000000,2000000000
124356243354,1642230174,56468,125856243354,51668,132164340380,1500000000,1500000000
129556048468,1642207646,329940,131056048468,329940,158511798068,1500000000,1500000000
73894861104,1649698971,67634,75394861104,62834,77325458184,1500000000,1500000000
17434293414,1647501540,55596,18934293414,55596,24181307022,1500000000,1500000000
17197850794,1646980545,60838,18697850794,60838,20940509303,1500000000,1500000000
27852144872,1647016464,55705,29352144872,50905,30000000000,1500000000,1500000000
18554995096,1646988484,60850,20054995096,56050,23008207943,1500000000,1500000000
30569155944,1647922995,60874,32069155944,56074,45062060127,1500000000,1500000000
44474878040,1647964580,318476,45974878040,318476,57196323867,1500000000,1500000000
31125321618,1649688412,63188,32625321618,63188,66226798904,1500000000,1500000000
85229259584,1641195492,340083,86729259584,340083,100656698096,1500000000,1500000000
25260598085,1649655030,55693,26760598085,50893,30324976953,1500000000,1500000000
54465992999,1649706339,343809,55965992999,343809,60288034140,1500000000,1500000000
54465992999,1649706339,343217,55965992999,343217,60288034140,1500000000,1500000000
22679081017,1649652993,67722,24179081017,62922,29757046759,1500000000,1500000000
35251997107,1647481353,327311,36751997107,327311,43147389885,1500000000,1500000000
131766560619,1642263298,343819,133266560619,343819,135708959130,1500000000,1500000000
35430066091,1647919995,56516,36930066091,51716,47137570599,1500000000,1500000000
17736966079,1647935124,86822,19236966079,82022,28371150779,1500000000,1500000000
99956632569,1649694363,49595,101456632569,44795,110864824774,1500000000,1500000000
25531365876,1647552324,55680,27031365876,50880,30000000000,1500000000,1500000000
25563014431,1646550146,56516,27063014431,51716,29906523592,1500000000,1500000000
14546726243,1646994853,60850,16046726243,60850,18619808684,1500000000,1500000000
113895943618,1642273102,67634,115395943618,67634,160102565040,1500000000,1500000000
107856017637,1641223552,60862,109356017637,56062,111794777104,1500000000,1500000000
117497932749,1641992313,52665,118997932749,47865,132058420993,1500000000,1500000000
142420062072,1642022868,60862,143920062072,56062,150000000000,1500000000,1500000000
142420062072,1642022868,67646,143920062072,62846,150000000000,1500000000,1500000000
157552253615,1641979715,321072,159052253615,321072,175874871167,1500000000,1500000000
157552253615,1641979715,321696,159052253615,321696,175874871167,1500000000,1500000000
33419944202,1647947307,326256,46000000000,326256,,,
80133979552,1646597123,67634,81749945241,62834,103035533560,1615965689,1615965689
102720740124,1642234740,67646,104220740124,62846,150341387937,1500000000,1500000000
84564240534,1641191198,333706,86064240534,333706,89157016779,1500000000,1500000000
126941703380,1642000278,67622,128441703380,62822,145448944947,1500000000,1500000000
19241638218,1647932450,334330,20741638218,334330,28618222842,1500000000,1500000000
17481289768,1649659567,311031,19481289768,311031,150000000000,2000000000,2000000000
19422000147,1646571755,331097,20922000147,331097,27318298853,1500000000,1500000000
33958890537,1647875460,55705,34958890537,50905,36000000000,1000000000,1000000000
114403493802,1642213816,343187,115903493802,343187,156525064375,1500000000,1500000000
140783262763,1642265112,56516,142283262763,51716,157939066860,1500000000,1500000000
116660101424,1642256176,55705,118160101424,55705,138921443439,1500000000,1500000000
165078016412,1641948915,340691,166728016412,340691,203891927154,1650000000,1650000000
30522909324,1649649159,59994,32022909324,59994,33281865449,1500000000,1500000000
94965573059,1647530952,327409,96465573059,327409,109146078013,1500000000,1500000000
119371108184,1642230478,55693,120871108184,50893,141947961508,1500000000,1500000000
134243547213,1642229176,320453,135743547213,320453,167519308870,1500000000,1500000000
130337286472,1641247575,60850,131837286472,60850,175696488202,1500000000,1500000000
66654324113,1641201266,67622,68154324113,67622,77624031962,1500000000,1500000000
137391239295,1641995809,67646,152153044088,67646,,,
37331940720,1647990639,310919,38831940720,310919,45820928503,1500000000,1500000000
25065030362,1649641175,67634,26715030362,62834,29795087297,1650000000,1650000000
12294825830,1647843174,319799,14294825830,319799,17461869855,2000000000,2000000000
28721398864,1647042243,67634,30221398864,67634,37124390502,1500000000,1500000000
123872657548,1642224384,336875,125372657548,336875,139137132455,1500000000,1500000000
80367403837,1641211115,60862,81867403837,56062,99824174824,1500000000,1500000000
109648613975,1641978376,60862,111148613975,56062,147752331143,1500000000,1500000000
60395373255,1647987476,67634,61895373255,62834,85370353202,1500000000,1500000000
40962292545,1649679613,48567,42462292545,48567,56046688142,1500000000,1500000000
42017106569,1649679866,55680,43517106569,50880,60493581917,1500000000,1500000000
42870116141,1647031026,67634,44370116141,62834,60485638405,1500000000,1500000000
127856554132,1642216750,56516,129356554132,51716,150647691552,1500000000,1500000000
68636824170,1641173250,336895,70136824170,336895,73778571669,1500000000,1500000000
94368823478,1641245496,334350,95868823478,334350,119845979344,1500000000,1500000000
112187706118,1641244627,64717,113687706118,59917,144918816578,1500000000,1500000000
58661410501,1641199521,333728,66064916334,333728,66064916334,66064916334,7403505833
43694291311,1649671115,55580,45194291311,50780,56430706549,1500000000,1500000000
35404420203,1646576690,298157,36804725627,298157,36804725627,1500000000,1400305424
25237134580,1646971308,313391,26737134580,313391,35256902895,1500000000,1500000000
147886909781,1642216463,60850,178728535699,56050,,,
185564877563,1641999735,55608,187064877563,50808,212323250345,1500000000,1500000000
62652398497,1649716288,67710,64152398497,67710,76841882054,1500000000,1500000000
27231323558,1649639535,55680,28731323558,50880,36246431047,1500000000,1500000000
25883460324,1647506885,55717,27067512858,50917,27067512858,1500000000,1184052534
24896743038,1646559820,336863,26396743038,248188,33633519584,1500000000,1500000000
17474501497,1647848113,60874,18974501497,56074,25647929853,1500000000,1500000000
146044701956,1642269279,54872,148544701956,54872,327954660170,2500000000,2500000000
86753020585,1642247188,326085,87965620585,326085,91082435961,1212600000,1212600000
123412733384,1642249662,334288,124912733384,334288,153817048834,1500000000,1500000000
160355352377,1642279363,67634,161855352377,67634,169857703318,1500000000,1500000000
76849645806,1641198936,67646,78349645806,62846,93598312173,1500000000,1500000000
139267740999,1641979823,60850,140767740999,56050,152663692053,1500000000,1500000000
61774900707,1649701430,67710,63274900707,67710,76077526590,1500000000,1500000000
34689592810,1647042042,317222,36189592810,317222,48402471450,1500000000,1500000000
99594161542,1642252938,66730,101094161542,66730,129411210697,1500000000,1500000000
159363096291,1641947422,55781,160863096291,50981,213285742229,1500000000,1500000000
33655208734,1647866671,60838,35155208734,56038,40964833965,1500000000,1500000000
107060223452,1642253277,343161,108560223452,343161,139321093147,1500000000,1500000000
179176090606,1642001311,331153,180676090606,331153,210773326394,1500000000,1500000000
35896125419,1649639878,327988,37396125419,310888,41741009277,1500000000,1500000000
35896125419,1649639878,327986,37396125419,327986,41741009277,1500000000,1500000000
35896125419,1649639878,60862,37396125419,56062,41741009277,1500000000,1500000000
35896125419,1649639878,333722,37396125419,333722,37661765364,1500000000,1500000000
45909194177,1647872055,55648,48409194177,55648,91653045234,2500000000,2500000000
114561632490,1642215471,67634,116061632490,67634,141576546418,1500000000,1500000000
394383453582,1642014858,67646,395883453582,62846,528760284543,1500000000,1500000000
74115856533,1649698336,63200,75615856533,63200,118630702212,1500000000,1500000000
39753480286,1649717758,326864,41253480286,326864,45673007215,1500000000,1500000000
75776857132,1649699363,343221,77276857132,343221,91055353019,1500000000,1500000000
25598966267,1646525423,323960,27098966267,323960,46384154757,1500000000,1500000000
23897724554,1647833765,334332,25397724554,334332,31972264642,1500000000,1500000000
48460760372,1647018917,67634,50460760372,67634,220000000000,2000000000,2000000000
93797480568,1642238272,67710,95297480568,67710,127270241070,1500000000,1500000000
98383402103,1642253314,326093,99883402103,326093,129487578605,1500000000,1500000000
98383402103,1642253314,55648,100883402103,55648,197581281532,2500000000,2500000000
100657358297,1642255307,55648,103157358297,55648,224479524418,2500000000,2500000000
82620124694,1641190636,55592,84620124694,50792,105301838748,2000000000,2000000000
87147984515,1641180114,337504,89457984515,337504,95100000000,2310000000,2310000000
32216268923,1647857994,66778,33716268923,61978,35554669992,1500000000,1500000000
71819358899,1641180893,67646,73319358899,62846,126617850994,1500000000,1500000000
78494859983,1641206598,321981,79994859983,321981,93004383652,1500000000,1500000000
29422079632,1647936442,60862,30561866195,56062,30561866195,1500000000,1139786563
129997405574,1642219066,70000,132197405574,56050,140000000000,2200000000,2200000000
16695789939,1649660437,48579,18195789939,48579,23460413683,1500000000,1500000000
71072420180,1647537167,336935,72572420180,336935,77198151147,1500000000,1500000000
18383216309,1646571523,321062,19883216309,321062,22496034882,1500000000,1500000000
136770949069,1642281561,60862,138270949069,56062,168641509334,1500000000,1500000000
36287324237,1647971656,60850,37787324237,60850,44920668297,1500000000,1500000000
83813418756,1649693696,329964,85313418756,329964,93287170217,1500000000,1500000000
83813418756,1649693696,49571,85313418756,49571,93287170217,1500000000,1500000000
15628532632,1649659773,56516,25628532632,51716,200000000000,10000000000,10000000000
32848119427,1647483355,60850,34348119427,60850,42778414114,1500000000,1500000000
121782893695,1641253654,67634,123282893695,62834,145093402514,1500000000,1500000000
176148620515,1642029420,63200,178648620515,63200,332457397910,2500000000,2500000000
20703830330,1649644149,67658,22203830330,62858,31548052222,1500000000,1500000000
19859563897,1647503450,67646,21359563897,62846,24890670168,1500000000,1500000000
85101623817,1647531400,337522,86601623817,337522,95940937744,1500000000,1500000000
20598291795,1646990982,60838,22098291795,60838,25418191400,1500000000,1500000000
119289613719,1642228228,326012,120789613719,326012,140258039369,1500000000,1500000000
115118743723,1641994196,326077,116618743723,326077,120000000000,1500000000,1500000000
19270536369,1647928336,67622,20770536369,67622,28409847925,1500000000,1500000000
98355140318,1649710707,48651,99855140318,48651,112277300059,1500000000,1500000000
47042926640,1647030409,60850,48542926640,56050,65260086228,1500000000,1500000000
135447418802,1642232153,329419,136947418802,329419,153193937544,1500000000,1500000000
119177026590,1642240500,55636,120677026590,50836,146267355023,1500000000,1500000000
135324410555,1641971671,60850,136824410555,60850,166904923544,1500000000,1500000000
180304548917,1642005695,60862,181804548917,56062,198943271390,1500000000,1500000000
25297789202,1649644058,67634,29000000000,67634,,,
81420553762,1647544043,55705,82920553762,50905,114001633983,1500000000,1500000000
23292834259,1646997084,321640,24792834259,321640,30144190857,1500000000,1500000000
136276451524,1642243638,59946,137776451524,55146,142843778982,1500000000,1500000000
26189715653,1649668400,67646,27689715653,62846,31779969413,1500000000,1500000000
123380732946,1642276231,60850,124880732946,56050,159213071324,1500000000,1500000000
123380732946,1642276231,56492,125380732946,51692,166021594177,2000000000,2000000000
151864188385,1641996706,60862,153364188385,56062,194740512085,1500000000,1500000000
39306714640,1647913168,67634,40806714640,62834,60449309244,1500000000,1500000000
71526255521,1649696240,67622,73026255521,67622,99159929475,1500000000,1500000000
43443339868,1647554073,310227,44943339868,310227,58595643658,1500000000,1500000000
20493526633,1647515742,328014,21993526633,328014,24688676763,1500000000,1500000000
31445521385,1647857805,67646,32945521385,62846,42760362704,1500000000,1500000000
113798505794,1649691522,314049,113913490622,314049,113913490622,1500000000,114984828
49683002996,1649679946,66778,51183002996,61978,59861436704,1500000000,1500000000
58803982515,1641189244,60862,60303982515,56062,89004516578,1500000000,1500000000
104337863872,1641240649,54825,105837863872,50025,169005946053,1500000000,1500000000
104337863872,1641240649,60938,105837863872,56138,107784105544,1500000000,1500000000
102124385403,1641232801,55705,103624385403,50905,129612155712,1500000000,1500000000
131136912431,1641247524,65518,132636912431,60718,143466328905,1500000000,1500000000
107102712818,1641982732,67646,108602712818,67646,155217194270,1500000000,1500000000
71605325641,1649695879,49507,73105325641,44707,87924529177,1500000000,1500000000
26535225419,1649661758,334288,28035225419,334288,33925539438,1500000000,1500000000
31630163917,1649636743,303371,33130163917,303371,35000000000,1500000000,1500000000
44011275552,1649662351,54688,46011275552,49888,47228353709,2000000000,2000000000
77928756925,1649704249,48615,79428756925,48615,80739593293,1500000000,1500000000
45946289705,1647479960,64717,47446289705,64717,57212466923,1500000000,1500000000
25646829401,1646585171,67646,27646829401,62846,38552662536,2000000000,2000000000
21985688436,1647862402,67646,23485688436,62846,32487606815,1500000000,1500000000
116150587996,1641229972,64741,117650587996,59941,147493070858,1500000000,1500000000
62741045559,1647983922,67634,64241045559,62834,67807898457,1500000000,1500000000
18433182828,1647493219,55580,19933182828,55580,25753116062,1500000000,1500000000
33297637912,1647872502,55636,35797637912,55636,81253413780,2500000000,2500000000
109719184203,1642257759,334286,111219184203,334286,140845158005,1500000000,1500000000
109473192736,1641243344,336831,110973192736,336831,137888756387,1500000000,1500000000
60232143057,1641173144,60850,61732143057,56050,65000000000,1500000000,1500000000
239929346188,1642027612,60862,241429346188,60862,268099812812,1500000000,1500000000
239929346188,1642027612,319899,241429346188,319899,256085700605,1500000000,1500000000
410678518441,1642014361,334294,412178518441,334294,564486781733,1500000000,1500000000
22601349261,1649653329,63200,24101349261,63200,45629649932,1500000000,1500000000
24294327641,1646527148,67646,25794327641,62846,30273178138,1500000000,1500000000
18852343765,1646540272,327998,20352343765,327998,25389464978,1500000000,1500000000
15878934641,1647854906,53450,17378934641,53450,21889984332,1500000000,1500000000
19264530375,1646991050,60838,20764530375,60838,25418959182,1500000000,1500000000
19938406383,1647934996,67622,21438406383,67622,28948837802,1500000000,1500000000
54913776378,1649703701,336895,56413776378,336895,75907247615,1500000000,1500000000
37328634605,1646579325,310995,38828634605,310995,49429019560,1500000000,1500000000
34206114655,1646534154,67622,35706114655,67622,44942272537,1500000000,1500000000
28242747562,1647875673,67622,29742747562,67622,46747124757,1500000000,1500000000
102083173751,1641986392,66862,103583173751,62062,115952308725,1500000000,1500000000
128101910231,1641977667,60874,129601910231,56074,140000000000,1500000000,1500000000
193617780671,1642029486,67646,195117780671,62846,233085499683,1500000000,1500000000
158043433331,1642000867,55608,159543433331,55608,200578516619,1500000000,1500000000
39669433926,1649716855,337452,41169433926,337452,44000000000,1500000000,1500000000
39967654867,1649717516,67634,41467654867,62834,100000000000,1500000000,1500000000
58633357891,1649716220,63200,60133357891,63200,113489783384,1500000000,1500000000
16869383667,1647517906,67634,18369383667,62834,20462184953,1500000000,1500000000
35841894226,1646578111,54261,37841894226,49461,51042014996,2000000000,2000000000
27346424765,1647828088,67622,28512413919,67622,28512413919,1500000000,1165989154
181661526707,1641242909,49519,183161526707,44719,250011632482,1500000000,1500000000
181661526707,1641242909,60850,183161526707,56050,199554620492,1500000000,1500000000
119190364339,1641995657,55644,121690364339,55644,306661340644,2500000000,2500000000
169618894936,1642003925,54812,171118894936,54812,229937452090,1500000000,1500000000
55101764282,1649703086,54724,56601764282,54724,79995607769,1500000000,1500000000
21065507808,1646575439,334326,22565507808,334326,34963954760,1500000000,1500000000
172074239251,1641995410,55572,173574239251,55572,242381782970,1500000000,1500000000
159120812218,1642013572,330567,160620812218,330567,209281052343,1500000000,1500000000
186458335447,1642023208,333676,187958335447,333676,226542069853,1500000000,1500000000
108075636586,1641982742,49458,114000000000,49458,,,
32257585425,1647954390,310989,33757585425,293889,34504698193,1500000000,1500000000
32257585425,1647954390,304674,33757585425,287574,34504698193,1500000000,1500000000
32257585425,1647954390,314196,33907585425,314196,37955168012,1650000000,1650000000
50302908113,1647984713,67634,51802908113,62834,55000000000,1500000000,1500000000
67833235557,1649689302,67634,69333235557,67634,70832732699,1500000000,1500000000
15428380988,1647504796,67646,16928380988,62846,23386773178,1500000000,1500000000
34957128772,1647019562,333734,36457128772,333734,52835156007,1500000000,1500000000
40233348520,1647542142,67646,41733348520,62846,64683242050,1500000000,1500000000
18152833772,1647860867,67634,19152833772,62834,20740194729,1000000000,1000000000
17322738625,1647007985,60850,18822738625,60850,29027797907,1500000000,1500000000
22376396683,1646967261,67658,23876396683,62858,27365684613,1500000000,1500000000
162028045499,1642277607,67646,163528045499,62846,173594234074,1500000000,1500000000
140508667982,1642212785,67634,142008667982,67634,143268234334,1500000000,1500000000
121887793768,1642228122,67646,123387793768,62846,154664656983,1500000000,1500000000
127026791075,1642274710,60862,128526791075,56062,159647244195,1500000000,1500000000
116397975444,1641254074,334308,117897975444,334308,120376023737,1500000000,1500000000
142744414347,1642021933,67646,144244414347,62846,150000000000,1500000000,1500000000
140016980404,1641966674,55592,141516980404,50792,166765396684,1500000000,1500000000
33899648570,1647993198,66730,35399648570,66730,39587303920,1500000000,1500000000
42198960673,1649688562,66862,43698960673,66862,52173342280,1500000000,1500000000
22412823860,1649665885,60938,23912823860,60938,28692301887,1500000000,1500000000
144842480209,1641967265,55620,146342480209,50820,188245368044,1500000000,1500000000
40548721084,1649686119,310844,42048721084,310844,53534613582,1500000000,1500000000
16490290512,1647822442,325020,17990290512,325020,20447266149,1500000000,1500000000
18635255192,1647861711,325002,20635255192,325002,25309399861,2000000000,2000000000
119470072005,1642276120,55636,121970072005,55636,214904055308,2500000000,2500000000
105352861855,1642238707,67634,107452499405,67634,,,
94263529076,1641182669,67646,95773529076,62846,140775697018,1510000000,1510000000
104035960561,1641973710,340021,105535960561,340021,105673816500,1500000000,1500000000
149207394587,1642271202,67634,150707394587,62834,195491441397,1500000000,1500000000
32400941838,1647992724,66718,33900941838,66718,43832005885,1500000000,1500000000
19277492240,1649642183,67622,20777492240,67622,35268684812,1500000000,1500000000
28954012395,1649641622,66766,30454012395,61966,36838536915,1500000000,1500000000
33573152851,1647889050,67622,35073152851,67622,46089827424,1500000000,1500000000
141874864463,1642261476,60862,143374864463,56062,202675655484,1500000000,1500000000
98991878766,1641181331,67634,100931878766,67634,130127818769,1940000000,1940000000
18005679988,1647867014,60838,19505679988,56038,30628877249,1500000000,1500000000
112989812321,1642238170,67634,114489812321,67634,134400449084,1500000000,1500000000
134200088229,1641236397,67634,135700088229,62834,153206596853,1500000000,1500000000
131256092308,1641996092,55804,132756092308,51004,182528145147,1500000000,1500000000
180515457546,1642004098,340087,182015457546,340087,219216097824,1500000000,1500000000
169391438540,1642272107,67622,170891438540,67622,208453818739,1500000000,1500000000
124917829520,1642285523,60838,126417829520,60838,128859985825,1500000000,1500000000
71755914391,1641173178,323672,73255914391,323672,73778571669,1500000000,1500000000
29219073683,1649720879,60862,30719073683,60862,30736687302,1500000000,1500000000
25870570175,1647518106,324848,27174851953,324848,27174851953,1500000000,1304281778
28070964281,1647022129,67646,29570964281,62846,38341085700,1500000000,1500000000
96806201478,1642225228,322856,98306201478,322856,149885368502,1500000000,1500000000
127081546371,1641960920,331163,128491546371,331163,132162610005,1410000000,1410000000
104798645687,1649707765,340653,106298645687,340653,121211360110,1500000000,1500000000
110597518198,1647529439,67646,112097518198,62846,125555825753,1500000000,1500000000
27195808076,1646531795,67622,28695808076,67622,40915498578,1500000000,1500000000
32369627548,1647029597,55592,33869627548,50792,46562318368,1500000000,1500000000
140475367515,1642273473,334348,141975367515,334348,164080249799,1500000000,1500000000
140475367515,1642273473,343211,141975367515,343211,156170065540,1500000000,1500000000
164024714631,1641995524,316759,165524714631,316759,192736336947,1500000000,1500000000
145644394687,1642026665,336875,147144394687,336875,148000000000,1500000000,1500000000
150665471694,1642261811,56504,152165471694,51704,199107342120,1500000000,1500000000
147227473473,1641251474,67634,148727473473,62834,230439457492,1500000000,1500000000
99825679120,1641228296,60862,101000000000,56062,101000000000,1500000000,1174320880
236856769389,1647522527,55644,239356769389,55644,446984189966,2500000000,2500000000
21198958359,1646533421,60850,22698958359,60850,30689643882,1500000000,1500000000
172720188951,1641968890,60862,174220188951,56062,195670994158,1500000000,1500000000
26640440974,1649657489,316610,28140440974,316610,31546575453,1500000000,1500000000
50475353903,1649706125,336867,52475353903,336867,69780264394,2000000000,2000000000
35059085740,1647478047,328038,36559085740,328038,41089339373,1500000000,1500000000
35059085740,1647478047,330583,36559085740,330583,40639430539,1500000000,1500000000
32125799333,1646960064,327968,33625799333,327968,37689187545,1500000000,1500000000
86338069023,1642247210,67634,87838069023,67634,95000000000,1500000000,1500000000
66396469732,1641213585,54789,67896469732,54789,83172284510,1500000000,1500000000
93070298491,1641990262,67646,94570298491,62846,126096592073,1500000000,1500000000
108944711596,1641989762,54860,110444711596,50060,175884596864,1500000000,1500000000
117427059130,1642245581,60850,118837059130,56050,123000000000,1410000000,1410000000
295557401695,1642007029,55620,297057401695,50820,297807540404,1500000000,1500000000
57712124298,1649714639,322969,59212124298,322969,67575295479,1500000000,1500000000
17868862665,1647494858,67634,19368862665,62834,25746164678,1500000000,1500000000
119778970646,1642250885,333654,121278970646,333654,147890110917,1500000000,1500000000
225756481616,1642025039,333714,227256481616,333714,259215829228,1500000000,1500000000
22915352685,1646997058,55592,24915352685,50792,34399139329,2000000000,2000000000
70940005073,1641212482,327928,72440005073,327928,102174998681,1500000000,1500000000
184166054767,1641957222,313506,185666054767,313506,194614734338,1500000000,1500000000
58504720531,1649715798,55592,60004720531,50792,72454885024,1500000000,1500000000
23527150751,1649672846,55592,24527150751,50792,25993383159,1000000000,1000000000
75208334266,1641215520,334294,76708334266,334294,89281764375,1500000000,1500000000
107293420204,1641248269,63837,108793420204,59037,144833983912,1500000000,1500000000
30021656378,1647962918,60862,31521656378,56062,40220040758,1500000000,1500000000
58998908784,1649706914,48639,60938908784,48639,89148779728,1940000000,1940000000
174849616238,1642207281,67622,176349616238,67622,213280198145,1500000000,1500000000
96612569998,1641218076,60862,98112569998,56062,135153290267,1500000000,1500000000
63043633523,1641210928,60850,64543633523,56050,72873719759,1500000000,1500000000
155472874562,1641950445,55644,156972874562,50844,177510576605,1500000000,1500000000
41855372979,1647901168,64729,43355372979,59929,44284443372,1500000000,1500000000
105122264999,1642249118,313415,106622264999,313415,109304015439,1500000000,1500000000
81012741492,1641187567,56705,82512741492,51905,87264824290,1500000000,1500000000
63784384565,1641202491,334326,65284384565,334326,71490182303,1500000000,1500000000
60722603251,1647962093,66778,62222603251,61978,68973046279,1500000000,1500000000
64225813986,1647959827,67634,65725813986,62834,66680100888,1500000000,1500000000
121914780118,1641971580,60862,123414780118,56062,157144557747,1500000000,1500000000
146787649450,1641977620,60850,148287649450,56050,157065626682,1500000000,1500000000
49143772330,1647977932,67634,50643772330,67634,65796339912,1500000000,1500000000
59428453371,1649706027,60950,60928453371,56150,69176375235,1500000000,1500000000
27434633948,1646581200,309824,28934633948,309824,43834502695,1500000000,1500000000
20190227137,1647012117,319803,21690227137,319803,24011518877,1500000000,1500000000
18191728718,1646988632,67634,19691728718,67634,24240032128,1500000000,1500000000
20613173568,1646967395,333105,22113173568,333105,27060132897,1500000000,1500000000
159068579527,1642263730,60862,160568579527,56062,194077497024,1500000000,1500000000
120905484209,1641952572,326223,122405484209,326223,161814321437,1500000000,1500000000
100651772982,1641990217,60838,102151772982,56038,114197833030,1500000000,1500000000
111968415620,1642265868,67634,134000000000,62834,,,
144281893336,1642216844,60850,145781893336,60850,192548771875,1500000000,1500000000
158134403564,1642030650,67634,159634403564,62834,168281229833,1500000000,1500000000
135777446640,1641957591,67646,137777446640,62846,145000000000,2000000000,2000000000
36209640175,1647922167,60862,37709640175,56062,40678157747,1500000000,1500000000
18858646382,1647952860,307124,20358646382,307124,28859288965,1500000000,1500000000
44264055824,1647985690,60862,46264055824,56062,54671538463,2000000000,2000000000
15167345744,1646993463,67634,16667345744,62834,20655390752,1500000000,1500000000
167407195376,1642210369,67622,168907195376,67622,222041868868,1500000000,1500000000
139605228057,1642206999,60850,141105228057,56050,190603122973,1500000000,1500000000
108828140763,1641226568,310195,110328140763,310195,114308228628,1500000000,1500000000
23029191507,1649658924,59946,24529191507,59946,29316091939,1500000000,1500000000
18902590753,1649675873,333672,20402590753,333672,25438637897,1500000000,1500000000
18056529786,1647504729,67646,19556529786,62846,22570285524,1500000000,1500000000
25007103811,1647027070,67634,26507103811,67634,34924722892,1500000000,1500000000
27466086071,1647038829,60862,28966086071,56062,33498553580,1500000000,1500000000
155700483272,1642211709,56492,157200483272,56492,185782452673,1500000000,1500000000
89517504730,1642234516,54848,91017504730,50048,159742071877,1500000000,1500000000
124369896213,1641248108,67646,125869896213,62846,127253559738,1500000000,1500000000
154321459023,1642000372,324868,155821459023,324868,172251638682,1500000000,1500000000
25086362511,1647858215,319793,26586362511,319793,35788424402,1500000000,1500000000
43027831423,1647885681,60862,44527831423,60862,63036268983,1500000000,1500000000
18389503820,1647001847,60862,19889503820,56062,24422256544,1500000000,1500000000
175692035879,1642023916,54836,177192035879,50036,228146410957,1500000000,1500000000
45675679313,1647980258,67646,47175679313,62846,47746745680,1500000000,1500000000
43459555278,1647975705,67622,44959555278,67622,46774199053,1500000000,1500000000
17563494930,1647486838,316504,18563494930,316504,19162698473,1000000000,1000000000
30658542354,1647016052,327996,32158542354,327996,49959695940,1500000000,1500000000
260709175978,1641249519,67634,262209175978,67634,326982384124,1500000000,1500000000
43245546479,1647973836,60862,44745546479,56062,60936926173,1500000000,1500000000
50131395506,1649669842,48591,51221775620,43791,51221775620,1500000000,1090380114
26164396999,1649644383,60938,27610170935,56138,27610170935,1500000000,1445773936
121853639067,1642249551,340657,123353639067,340657,160964831332,1500000000,1500000000
131328521728,1642217011,66730,136949226112,66730,,,
92592170560,1642253019,62154,94092170560,51704,97000000000,1500000000,1500000000
245135704716,1642020713,55620,246635704716,50820,276364433539,1500000000,1500000000
27133173343,1647482669,67646,28633173343,67646,38302845690,1500000000,1500000000
20984512066,1647867187,67634,22484512066,62834,32372634208,1500000000,1500000000
57307862344,1641206421,331145,58807862344,331145,60000000000,1500000000,1500000000
144412231082,1641238934,327914,145912231082,327914,156078733346,1500000000,1500000000
52437693405,1647914803,56492,53937693405,51692,80062348562,1500000000,1500000000
18532396859,1646552287,322504,20032396859,322504,21669379250,1500000000,1500000000
154563197068,1642261459,67622,156063197068,62822,162456725259,1500000000,1500000000
26990991737,1647489623,324844,28161100313,324844,28161100313,1500000000,1170108576
82109992813,1641211390,60850,83609992813,60850,86977160607,1500000000,1500000000
133325636843,1642002172,67622,134825636843,67622,160832932829,1500000000,1500000000
37234687807,1647480549,67634,38734687807,67634,56906820205,1500000000,1500000000
28551558354,1647837327,337484,30051558354,337484,31046088468,1500000000,1500000000
25756493463,1649666409,67734,27756493463,62934,31866104358,2000000000,2000000000
48719809051,1649717171,59946,50219809051,55146,54085696759,1500000000,1500000000
45295331884,1647030376,303349,46795331884,303349,65598574758,1500000000,1500000000
18387684771,1646986142,60850,19387684771,56050,19944357540,1000000000,1000000000
87170855603,1642238927,55705,88670855603,50905,118000000000,1500000000,1500000000
125863594339,1642264038,60850,127363594339,56050,191557468087,1500000000,1500000000
206977034457,1641246468,67646,208477034457,62846,260013997364,1500000000,1500000000
15995467045,1646555696,327279,17495467045,327279,20961187454,1500000000,1500000000
119715554560,1641243612,317210,121215554560,317210,153519866338,1500000000,1500000000
105082654906,1641979083,55668,106582654906,50868,136484784420,1500000000,1500000000
71890587345,1647973655,67646,73390587345,62846,112426435360,1500000000,1500000000
20278882954,1647941025,67646,21778882954,62846,23561510365,1500000000,1500000000
52300569719,1649681802,336863,53800569719,336863,60613783858,1500000000,1500000000
37597406497,1647015518,318716,39097406497,318716,51939149222,1500000000,1500000000
13657709887,1647001465,67634,15157709887,58034,17358112049,1500000000,1500000000
61191451921,1647915869,337458,62691451921,337458,74209707105,1500000000,1500000000
88623157441,1649700909,308980,90123157441,308980,100845047569,1500000000,1500000000
23657344704,1646573812,56480,25157344704,56480,32656053853,1500000000,1500000000
26436658707,1647038746,333676,27936658707,333676,45234185607,1500000000,1500000000
14645074977,1647001160,55592,16145074977,50792,21302969575,1500000000,1500000000
107792880479,1642228573,416753,109292880479,316753,110000000000,1500000000,1500000000
101610704583,1641235265,60850,103110704583,56050,126734260232,1500000000,1500000000
110121923071,1649707614,63200,111621923071,63200,197277066948,1500000000,1500000000
30200722245,1647496968,67646,31700722245,62846,33695696097,1500000000,1500000000
95439782287,1642263196,55624,97939782287,55624,214659199054,2500000000,2500000000
82528252212,1641171437,67646,84028252212,62846,121406665877,1500000000,1500000000
109849487153,1641248026,60850,111349487153,56050,141906939463,1500000000,1500000000
115724264466,1641238028,60862,117224264466,56062,117451496775,1500000000,1500000000
115724264466,1641238028,64729,117224264466,59929,117451496775,1500000000,1500000000
22532315281,1647007580,67646,24032315281,62846,27394948985,1500000000,1500000000
107907117255,1641225916,60850,109907117255,60850,123100900097,2000000000,2000000000
114414862750,1641970111,318498,115914862750,318498,124002602593,1500000000,1500000000
213746001865,1642012013,60850,215246001865,56050,272763009935,1500000000,1500000000
12769981934,1647843046,67634,13800000000,67634,,,
34919476843,1647025182,67634,36522413783,67634,46581797571,1602936940,1602936940
117546317561,1642274943,67622,119046317561,67622,173800496530,1500000000,1500000000
117546317561,1642274943,55592,119046317561,50792,161047493280,1500000000,1500000000
133544111575,1642223729,66742,135044111575,57142,135417535209,1500000000,1500000000
65898199951,1641211646,305350,67398199951,305350,69594577580,1500000000,1500000000
71688136801,1641213379,333680,73188136801,333680,101240412018,1500000000,1500000000
22140348101,1646559815,336863,23640348101,336863,33633519584,1500000000,1500000000
92106649457,1642257771,334274,93606649457,334274,100155522190,1500000000,1500000000
231752728833,1642010983,55620,233252728833,50820,263424495450,1500000000,1500000000
15647880731,1647934531,67646,16747880731,62846,18306016090,1100000000,1100000000
30733794185,1649673950,60950,32233794185,56150,42691237988,1500000000,1500000000
22950440416,1647836970,52916,24450440416,52916,24918840869,1500000000,1500000000
27284199090,1646958481,67634,28784199090,67634,42363849110,1500000000,1500000000
127253926080,1641233480,60862,129253926080,56062,162922269628,2000000000,2000000000
19835728234,1649667623,60862,21335728234,56062,25086832563,1500000000,1500000000
19835728234,1649667623,60006,21335728234,60006,25086832563,1500000000,1500000000
115891187446,1641976132,343859,117391187446,343859,160248241984,1500000000,1500000000
25866200183,1647950908,327401,27366200183,327401,35045243090,1500000000,1500000000
71070853237,1649678144,59970,72570853237,55170,102737003273,1500000000,1500000000
19854438701,1649668961,60862,21354438701,56062,27251100068,1500000000,1500000000
13315607067,1646994930,330423,14815607067,330423,16281357100,1500000000,1500000000
72562233172,1641200809,67634,74562233172,67634,83523359269,2000000000,2000000000
20116142813,1649673750,60926,21616142813,60926,31862061678,1500000000,1500000000
161834073991,1642268466,56516,163834073991,51716,168463427744,2000000000,2000000000
161834073991,1642268466,55636,164334073991,55636,258597581144,2500000000,2500000000
103177449707,1642242500,326228,104677449707,326228,139106734638,1500000000,1500000000
27547955421,1649676196,60938,29047955421,56138,36096392069,1500000000,1500000000
139278374465,1642207186,326834,140778374465,326834,170351049274,1500000000,1500000000
130219517497,1642265727,55636,132719517497,55636,287333134296,2500000000,2500000000
181213666126,1642011337,67646,182713666126,62846,190905203813,1500000000,1500000000
130041462732,1641965328,49507,131541462732,44707,135000000000,1500000000,1500000000
250861593027,1642018262,55480,252361593027,50680,310966224722,1500000000,1500000000
183663131482,1642005380,60850,185163131482,56050,194260232797,1500000000,1500000000
150128057568,1641991090,55580,151628057568,50780,196180186567,1500000000,1500000000
149517000035,1642022867,67634,151017000035,62834,236713428363,1500000000,1500000000
32294092335,1647945716,67634,34294092335,67634,45721624751,2000000000,2000000000
23597370919,1649655353,54748,25097370919,49948,29004338909,1500000000,1500000000
30352906081,1647519498,67634,31852906081,67634,39731278803,1500000000,1500000000
36782448776,1647553961,60862,38282448776,56062,44577548359,1500000000,1500000000
34434097038,1646585501,321656,35934097038,321656,39798171797,1500000000,1500000000
162923198715,1642271233,60850,164423198715,56050,195491441397,1500000000,1500000000
16770837059,1649663639,56492,18270837059,56492,22958636404,1500000000,1500000000
114650591827,1647533294,63200,116150591827,63200,246448900448,1500000000,1500000000
168073125161,1642210354,317258,169573125161,317258,204556791893,1500000000,1500000000
81012908210,1641216143,322965,82512908210,322965,98000747360,1500000000,1500000000
12719045346,1646989635,314136,14219045346,314136,19952743983,1500000000,1500000000
153045862095,1642275852,67634,154545862095,67634,171553102250,1500000000,1500000000
149408813011,1642264304,60862,150908813011,56062,183175489512,1500000000,1500000000
82365083478,1641216662,67634,83865083478,62834,106360682578,1500000000,1500000000
226819934454,1642021237,67634,228319934454,67634,231404921547,1500000000,1500000000
32461628460,1647955634,67646,34461628460,62846,50603753330,2000000000,2000000000
129668429635,1642275513,56504,131168429635,51704,165669148324,1500000000,1500000000
132304388256,1642276359,56492,134304388256,56492,163513582913,2000000000,2000000000
26155125482,1649641759,314083,27655125482,314083,38432133364,1500000000,1500000000
17165424523,1646990914,60838,18665424523,60838,24463624393,1500000000,1500000000
84129642397,1642256368,317564,85629642397,317564,108013446969,1500000000,1500000000
116098602091,1641250444,60862,117075535395,56062,117075535395,1500000000,976933304
68329960993,1647890895,67634,69829960993,67634,87875684290,1500000000,1500000000
75027220458,1641211156,316584,76527220458,316584,90644397934,1500000000,1500000000
107921087327,1641219644,331191,109921087327,331191,115835901460,2000000000,2000000000
67880004190,1641187013,66742,69380004190,61942,72746843426,1500000000,1500000000
201234199010,1641957212,327369,202734199010,327369,218739961234,1500000000,1500000000
38824185662,1646602477,327990,39000000000,327990,39000000000,1316000000,175814338
41248336770,1647873145,55648,43748336770,55648,76010280632,2500000000,2500000000
109985430039,1642240421,63188,111485430039,58388,148064956344,1500000000,1500000000
17742787667,1649667685,333692,19242787667,333692,23395924007,1500000000,1500000000
18418267881,1647865767,60862,19918267881,56062,26719667112,1500000000,1500000000
219890481341,1641249409,67646,221390481341,62846,250165972962,1500000000,1500000000
219890481341,1641249409,60850,221390481341,60850,250165972962,1500000000,1500000000
121481701637,1641252105,54896,122981701637,50096,129463873184,1500000000,1500000000
117147682183,1641988375,60850,118647682183,60850,136321649015,1500000000,1500000000
33671299926,1647923322,67646,35171299926,62846,44890896489,1500000000,1500000000
19021429325,1647943481,307791,20521429325,290691,22639759168,1500000000,1500000000
19021429325,1647943481,317314,20521429325,317314,20749589514,1500000000,1500000000
19021429325,1647943481,310997,20521429325,310997,20749589514,1500000000,1500000000
16375145605,1647844801,67622,17875145605,67622,19674337440,1500000000,1500000000
117756973895,1642275734,322486,119256973895,322486,127257526842,1500000000,1500000000
93740576285,1641181121,60862,95740576285,56062,124747548937,2000000000,2000000000
95546758265,1641235751,60850,97046758265,56050,109536777639,1500000000,1500000000
72565961822,1641178660,343229,74065961822,343229,75000000000,1500000000,1500000000
18424944774,1647949467,55705,19924944774,50905,20000000000,1500000000,1500000000
41817899286,1649657219,52372,43817899286,47572,69427668507,2000000000,2000000000
27617695602,1647495950,67646,29117695602,62846,36574336664,1500000000,1500000000
127782018236,1641968783,67634,129282018236,67634,140209135402,1500000000,1500000000
102854116179,1641988057,67646,104854116179,62846,110000000000,2000000000,2000000000
115132642792,1641979437,64741,116632642792,59941,142920693432,1500000000,1500000000
24642964863,1647924528,343229,26142964863,343229,31114280910,1500000000,1500000000
20930484568,1647859644,314095,22430484568,314095,24091218560,1500000000,1500000000
22717354004,1647855792,320605,24217354004,320605,30703843220,1500000000,1500000000
105648337011,1642284017,60850,107148337011,56050,133469988698,1500000000,1500000000
144219248137,1641245920,333656,145719248137,333656,206925339245,1500000000,1500000000
147501891554,1641232370,314063,149001891554,314063,155109322617,1500000000,1500000000
28346522970,1649668533,306615,29846522970,306615,33114180173,1500000000,1500000000
20570431651,1649665990,60950,22070431651,56150,26280358037,1500000000,1500000000
29864512116,1647559446,320457,31364512116,320457,37222007895,1500000000,1500000000
68972848866,1641198488,67634,70472848866,62834,87693497570,1500000000,1500000000
101905976878,1641244990,60850,103405976878,56050,147621774605,1500000000,1500000000
47928864862,1649702482,52916,49428864862,48116,53099940938,1500000000,1500000000
26566250941,1649667998,48627,28066250941,43827,33749399348,1500000000,1500000000
36488254589,1647871904,56492,37988254589,56492,54185961369,1500000000,1500000000
16997073973,1647848271,333700,18497073973,333700,20848575637,1500000000,1500000000
28771552288,1647007305,52916,30271552288,48116,46845559378,1500000000,1500000000
174443256364,1642269511,67646,175943256364,62846,184055877445,1500000000,1500000000
145049102364,1642264956,55636,147549102364,55636,279063933092,2500000000,2500000000
95822103672,1642290869,67622,97322103672,67622,114354578937,1500000000,1500000000
82994656200,1641190096,60862,84494656200,56062,93647317809,1500000000,1500000000
27985456937,1649670360,66754,29985456937,61954,40000000000,2000000000,2000000000
31164906033,1647495454,330579,32368308314,330579,32368308314,1500000000,1203402281
90026591459,1642241395,316582,91526591459,316582,111104865702,1500000000,1500000000
128486557058,1641228853,67622,129986557058,67622,169600330120,1500000000,1500000000
153479845244,1641975065,329197,154979845244,329197,221346023603,1500000000,1500000000
185522374538,1641955057,67646,187022374538,62846,288006631344,1500000000,1500000000
55190320114,1647546876,316510,56690320114,316510,60513106470,1500000000,1500000000
39868528084,1646577453,337530,41368528084,337530,44703187312,1500000000,1500000000
30225014900,1647857996,67634,31725014900,62834,35554669992,1500000000,1500000000
18119072285,1647860995,322961,19398248665,322961,19398248665,1500000000,1279176380
32145423792,1647871612,55648,34645423792,55648,67417219224,2500000000,2500000000
100054356552,1641225955,327948,101554356552,327948,143010626244,1500000000,1500000000
199641048919,1641946846,54909,201141048919,50109,300000000000,1500000000,1500000000
235503133487,1642019421,67634,237220601538,62834,291810866716,1717468051,1717468051
21787978594,1647943798,310971,23287978594,310971,29289139967,1500000000,1500000000
59842883855,1649695911,64120,61342883855,59320,97657902912,1500000000,1500000000
26313513114,1647502636,55572,27813513114,55572,31572149350,1500000000,1500000000
125792903877,1641966371,54848,127292903877,50048,150549270370,1500000000,1500000000
125792903877,1641966371,60850,127292903877,60850,155830391262,1500000000,1500000000
24306135756,1649638676,67622,25306135756,62822,28021102214,1000000000,1000000000
34692285151,1647555143,67634,36192285151,62834,53070808352,1500000000,1500000000
170104457343,1642268496,60850,171604457343,56050,181564795893,1500000000,1500000000
120635920341,1641245741,64741,122135920341,59941,164423468797,1500000000,1500000000
113493744470,1641980739,60862,114993744470,56062,150000000000,1500000000,1500000000
53676375565,1647984396,67634,55176375565,62834,64031941267,1500000000,1500000000
57621834983,1647976687,327403,59503634983,327403,83552836943,1881800000,1881800000
29933312501,1649644917,60862,31433312501,56062,43739355963,1500000000,1500000000
29933312501,1649644917,323644,31433312501,323644,43739355963,1500000000,1500000000
35612545860,1649704942,64144,37112545860,64107,66744958940,1500000000,1500000000
35612545860,1649704942,64132,37112545860,64095,68247452165,1500000000,1500000000
35612545860,1649704942,64132,37112545860,64095,56113058935,1500000000,1500000000
35612545860,1649704942,64132,37112545860,64095,84437148098,1500000000,1500000000
35612545860,1649704942,64132,100000000000,54532,100000000000,100000000000,64387454140
199148729888,1647523586,305996,200648729888,305996,250121108397,1500000000,1500000000
28527601523,1647841643,326808,30317513120,326808,43603916264,1789911597,1789911597
103991338724,1641250063,55620,105491338724,50820,123402587507,1500000000,1500000000
160214461926,1642025641,319747,161714461926,319747,226958681104,1500000000,1500000000
44970596385,1649682344,67634,46470596385,67634,54254907914,1500000000,1500000000
35817056593,1649651307,336853,37317056593,336853,39901158732,1500000000,1500000000
97498310160,1642237993,323586,98998310160,323586,113174296393,1500000000,1500000000
102504342329,1642251489,60862,104004342329,56062,156245247948,1500000000,1500000000
101086805449,1641980457,67646,102586805449,62846,144794039339,1500000000,1500000000
128056217733,1641999997,60850,129556217733,60850,158787915475,1500000000,1500000000
31405225062,1647919782,323648,32905225062,323648,35144635704,1500000000,1500000000
53249771766,1649716704,63200,54749771766,63200,124701230738,1500000000,1500000000
21137703554,1647507845,321975,22137703554,315506,23305064994,1000000000,1000000000
17986249080,1647848556,316474,19486249080,316474,22317843779,1500000000,1500000000
144479394502,1642257645,60030,145979394502,55230,172258217174,1500000000,1500000000
99157923744,1642255293,338763,101097923744,332294,156618007324,1940000000,1940000000
114368374542,1641236495,55592,115868374542,50792,123829910758,1500000000,1500000000
88811677969,1641173970,331139,90311677969,331139,119651060427,1500000000,1500000000
19343644980,1649661212,307992,20843644980,307992,21037430259,1500000000,1500000000
19097753267,1647866301,55568,20597753267,50768,28782504667,1500000000,1500000000
21007638224,1646999328,56504,22507638224,51704,24845088478,1500000000,1500000000
95319318394,1642252672,67634,96819318394,67634,103722716310,1500000000,1500000000
150467417002,1642279294,56516,151967417002,51716,183735160837,1500000000,1500000000
56778272278,1649697599,49571,58278272278,44771,69238183428,1500000000,1500000000
71576584298,1649704550,67722,73076584298,67722,84723342767,1500000000,1500000000
447416615058,1646591193,66766,451229833532,61966,585234974600,3813218474,3813218474
144091772003,1642264391,67622,145591772003,62822,162917371500,1500000000,1500000000
109927646789,1642280041,56516,111427646789,51716,193990091419,1500000000,1500000000
109927646789,1642280041,56516,111927646789,51716,181905456932,2000000000,2000000000
32026380729,1647923017,320402,33526380729,320402,35518144237,1500000000,1500000000
29336226929,1647868777,67646,31336226929,62846,44242849448,2000000000,2000000000
95593975788,1642253908,60850,97093975788,56050,140094784712,1500000000,1500000000
110147873975,1641253819,334340,111647873975,334340,132207847238,1500000000,1500000000
58231144025,1649707248,63200,59731144025,63200,126600718940,1500000000,1500000000
32323808697,1649645412,317304,33823808697,317304,48840868725,1500000000,1500000000
117933226703,1647534279,63200,119433226703,58400,164898163399,1500000000,1500000000
45283149700,1647841172,67634,48978610253,67634,61655136812,3695460553,3695460553
119807378813,1641250166,60862,121307378813,56062,143242722504,1500000000,1500000000
99447661758,1641168576,67646,100947661758,62846,127307461194,1500000000,1500000000
61983436393,1647973497,49519,63483436393,44719,95459241645,1500000000,1500000000
40339807036,1646588359,67658,41839807036,62858,45000000000,1500000000,1500000000
19951892241,1647858723,334298,21451892241,334298,24698613354,1500000000,1500000000
53587338232,1647890402,67634,55587338232,62834,68728784388,2000000000,2000000000
148679898278,1642263737,67634,150179898278,62834,163232402304,1500000000,1500000000
97290641633,1641191815,67622,98790641633,67622,113575922669,1500000000,1500000000
112769265961,1641248128,67646,130000000000,62846,,,
45742240957,1649713345,335572,46368535200,335572,46368535200,1000000000,626294243
65894822421,1641199289,67622,67394822421,67622,77959353545,1500000000,1500000000
106611520928,1641980869,333670,108611520928,333670,161736146274,2000000000,2000000000
164707429191,1641951503,60862,166207429191,56062,191571921809,1500000000,1500000000
57874404250,1649702834,55580,59374404250,55580,84790858943,1500000000,1500000000
14731514334,1646995754,67634,16231514334,67634,20160446507,1500000000,1500000000
49671930989,1647013259,60862,51171930989,56062,69298918505,1500000000,1500000000
91228079098,1642257171,56516,92728079098,51716,118000000000,1500000000,1500000000
97982718215,1642244746,322882,99982718215,322882,128489024107,2000000000,2000000000
95756781675,1642246347,54861,98256781675,54861,218371620062,2500000000,2500000000
98139041032,1642222916,66766,99639041032,61966,123639524403,1500000000,1500000000
111042319941,1642285488,60862,112542319941,56062,147918864140,1500000000,1500000000
29536289145,1649644703,320461,31036289145,320461,37749689123,1500000000,1500000000
22479010700,1647823188,327994,24000000000,327994,,,
14973163673,1647843325,55720,16473163673,50920,18697662425,1500000000,1500000000
51910391994,1647014242,67658,53910391994,62858,65886524026,2000000000,2000000000
15737935576,1646998383,60850,17237935576,56050,22643435359,1500000000,1500000000
138133512216,1642226556,60838,140133512216,60838,205550951731,2000000000,2000000000
108956130071,1641171143,60850,110456130071,56050,119439037340,1500000000,1500000000
108956130071,1641171143,330489,110456130071,330489,132882937060,1500000000,1500000000
42043979292,1647919519,67646,43543979292,62846,76904978399,1500000000,1500000000
52808199656,1647979394,67634,54308199656,62834,72018173935,1500000000,1500000000
24549668476,1649640932,67622,26049668476,67622,31811290300,1500000000,1500000000
20109678250,1649655701,319795,21609678250,319795,24062947395,1500000000,1500000000
91926314356,1642235934,320398,93426314356,320398,117687443297,1500000000,1500000000
124392227409,1642217063,326095,125892227409,326095,128000000000,1500000000,1500000000
72338850281,1641201145,64741,73838850281,59941,86827069878,1500000000,1500000000
260991936478,1642008448,60838,262491936478,60838,287350365793,1500000000,1500000000
56965507930,1647915577,56492,58465507930,51692,64762767543,1500000000,1500000000
55745567549,1649709882,66730,57245567549,61930,68093314520,1500000000,1500000000
19395646428,1647490392,346913,20895646428,346913,27660422148,1500000000,1500000000
290907880813,1647526156,71175,300907880813,59905,556031322442,10000000000,10000000000
20916474935,1646971625,327996,22416474935,327996,32671112065,1500000000,1500000000
27023416852,1646960089,67646,28523416852,62846,39599097632,1500000000,1500000000
122547975107,1642282174,56504,124047975107,51704,144592572797,1500000000,1500000000
21800053234,1647937884,67646,110000000000,62846,110000000000,110000000000,88199946766
35184268929,1647518490,67646,37184268929,62846,39322171900,2000000000,2000000000
157083664875,1642268952,56516,158583664875,51716,172707179080,1500000000,1500000000
94170832148,1641193470,64705,95670832148,59905,95922269366,1500000000,1500000000
141781339029,1641968551,67646,143281339029,62846,143795673342,1500000000,1500000000
128194407003,1641993152,64705,129694407003,64705,166300669050,1500000000,1500000000
128194407003,1641993152,55644,130694407003,55644,266181070480,2500000000,2500000000
53600819203,1647979830,67634,55100819203,67634,59885639569,1500000000,1500000000
46517125351,1647965940,67634,48017125351,62834,63070482227,1500000000,1500000000
30066390311,1649656328,66742,31566390311,61942,36829674308,1500000000,1500000000
103027259698,1641223909,310822,104527259698,310822,109223487676,1500000000,1500000000
108521761408,1641987477,60850,110021761408,56050,142719458827,1500000000,1500000000
75321306623,1641183625,437498,76821306623,337498,80000000000,1500000000,1500000000
125462372047,1641967364,67646,126962372047,62846,188128303610,1500000000,1500000000
58012421420,1647917536,55612,59512421420,50812,81553763907,1500000000,1500000000
30622788540,1646587484,67634,32277664946,67634,44000000000,1654876406,1654876406
123764852858,1642270287,56504,125264852858,51704,135602411754,1500000000,1500000000
130389942861,1642215726,67634,131889942861,67634,149878691489,1500000000,1500000000
116293356145,1641247042,64717,117793356145,64717,140273462988,1500000000,1500000000
72750527979,1641194541,67634,74250527979,62834,96313656734,1500000000,1500000000
112395570535,1642005209,60838,113895570535,60838,141719300979,1500000000,1500000000
37421063037,1647979997,67646,38921063037,62846,42558014760,1500000000,1500000000
17206566354,1646988453,322901,18706566354,322901,25026496473,1500000000,1500000000
24861780576,1646978857,323076,26501405207,323076,26501405207,1940000000,1639624631
116206886109,1642230146,60838,117706886109,60838,137637847423,1500000000,1500000000
102371098547,1641250739,55705,103871098547,50905,129227181598,1500000000,1500000000
72272835425,1641213866,329227,74272835425,329227,91574193374,2000000000,2000000000
24312985728,1647504545,67646,25812985728,62846,25954187860,1500000000,1500000000
26513285357,1647836544,313528,28013285357,313528,32345925922,1500000000,1500000000
128497377103,1641970113,54849,129997377103,50049,170235532299,1500000000,1500000000
14302753677,1647943377,316694,15802753677,316694,17764526527,1500000000,1500000000
27152726958,1649662160,67634,28652726958,62834,37029461660,1500000000,1500000000
32071564842,1646578215,67634,34071564842,62834,47121754366,2000000000,2000000000
95906264380,1642249130,334312,97316264380,334312,100000000000,1410000000,1410000000
135853782008,1641993546,64729,137353782008,64729,152540950392,1500000000,1500000000
17064319315,1647508127,333728,18564319315,333728,26291728080,1500000000,1500000000
20733969524,1647502168,55584,22233969524,55584,29816577572,1500000000,1500000000
49763812699,1646605575,324812,51263812699,324812,84157206855,1500000000,1500000000
15198313885,1647001210,320451,16698313885,320451,20315595333,1500000000,1500000000
38869708471,1649679113,66790,40369708471,61990,56990238565,1500000000,1500000000
26183321039,1649673965,317340,27134508197,317340,27134508197,1170901695,951187158
16418583515,1646988348,67646,17918583515,62846,22013905210,1500000000,1500000000
16418583515,1646988348,54700,17918583515,49900,22013905210,1500000000,1500000000
100251695713,1642222689,309654,101751695713,309654,104000000000,1500000000,1500000000
65549755994,1641226269,67634,67549755994,67634,121502544468,2000000000,2000000000
71840515647,1641198150,67622,73840515647,67622,83704678269,2000000000,2000000000
131065364870,1641254311,60850,132565364870,60850,184077869258,1500000000,1500000000
50596391389,1649688963,73117,52096391389,73117,60133654724,1500000000,1500000000
27167816764,1646974656,301484,28667816764,301484,31688989332,1500000000,1500000000
111695991798,1642254368,340661,113195991798,340661,134560335644,1500000000,1500000000
119395499599,1642260837,67622,120589974693,67622,,,
118668929916,1642236473,60862,120168929916,56062,131482802662,1500000000,1500000000
85839611024,1641209653,334296,87339611024,334296,104143436285,1500000000,1500000000
32268222347,1647948584,55612,33768222347,50812,34297386430,1500000000,1500000000
35340213825,1647919948,55612,36840213825,50812,43978927158,1500000000,1500000000
39471716694,1649637875,330553,40971716694,330553,57597954688,1500000000,1500000000
14551020967,1646991203,60850,16051020967,60850,23138303440,1500000000,1500000000
108462699510,1642238869,336831,109962699510,336831,121674973293,1500000000,1500000000
137701269103,1642265716,56516,139701269103,51716,175125375030,2000000000,2000000000
144919927771,1641247637,64741,146419927771,59941,172651960802,1500000000,1500000000
211912453531,1642017238,60862,213412453531,56062,253750323690,1500000000,1500000000
39190624911,1647971878,324834,40690624911,324834,42921197252,1500000000,1500000000
21880177756,1649638565,67622,23380177756,67622,31313209322,1500000000,1500000000
58711799277,1649682876,60862,60211799277,56062,79756820200,1500000000,1500000000
19275287831,1647508179,56504,20775287831,51704,23007882368,1500000000,1500000000
33637323516,1646529768,333927,35137323516,333927,43143690507,1500000000,1500000000
15551645921,1646558620,60838,17051645921,60838,21706118743,1500000000,1500000000
51990491507,1647013339,67634,53490491507,62834,56481550782,1500000000,1500000000
32313972904,1649675171,337408,33706496310,337408,33706496310,1500000000,1392523406
144384586676,1647533825,63200,145884586676,63200,206073066932,1500000000,1500000000
44509360851,1647878838,319781,46009360851,319781,51093562907,1500000000,1500000000
44334696854,1647872786,54261,45524398710,49461,45524398710,1500000000,1189701856
14465841136,1646997781,52916,15965841136,48116,19845831993,1500000000,1500000000
21253237607,1647027347,67646,22753237607,67646,26324861809,1500000000,1500000000
83595310954,1642256898,334318,205000000000,334318,,,
27559564392,1647943645,317366,28790450263,317366,28790450263,1500000000,1230885871
23741973596,1646986248,67634,25241973596,62834,25534520207,1500000000,1500000000
134795507732,1641247898,67646,136295507732,62846,138707745317,1500000000,1500000000
295781836141,1642029288,67646,297519871348,62846,386079341647,1738035207,1738035207
26034063427,1649675445,67722,27534063427,62922,38409506367,1500000000,1500000000
76025103376,1649700816,307898,77525103376,307898,91746164475,1500000000,1500000000
13107763830,1647847893,334348,14607763830,334348,17879008495,1500000000,1500000000
25874985459,1647038806,310967,27374985459,310967,33498553580,1500000000,1500000000
168433321966,1642212320,67622,169933321966,67622,219564578807,1500000000,1500000000
65288871170,1649714928,48651,66788871170,43851,92945008143,1500000000,1500000000
61542208264,1649703479,333187,63542208264,333187,64211289151,2000000000,2000000000
16793320710,1647851913,66802,18293320710,62002,24269554468,1500000000,1500000000
27469275015,1646974497,52916,28969275015,48116,40991132317,1500000000,1500000000
30438319446,1647042562,313421,32038819447,313421,32386820316,1600500001,1600500001
111844015084,1642282949,56492,113344015084,51692,150846973249,1500000000,1500000000
108788808885,1641978199,67634,110288808885,62834,130105935244,1500000000,1500000000
49114047750,1647917598,67634,50614047750,62834,79681012134,1500000000,1500000000
51020721587,1647977826,60862,52520721587,56062,75800078405,1500000000,1500000000
37207778541,1647034638,327982,38707778541,327982,41263687149,1500000000,1500000000
105150288632,1642248764,340631,106650288632,340631,122657476543,1500000000,1500000000
109577907957,1642244183,66790,111077907957,61990,137015852738,1500000000,1500000000
96362720890,1642283473,56516,98362720890,51716,164134369231,2000000000,2000000000
104401036771,1641225945,319781,105901036771,319781,117756864093,1500000000,1500000000
104401036771,1641225945,60850,105901036771,56050,117756864093,1500000000,1500000000
68737594037,1649715874,55580,70237594037,50780,79976709010,1500000000,1500000000
21248546372,1649643566,66742,23248546372,66742,47416533922,2000000000,2000000000
103002517499,1649693056,49583,104502517499,44783,121501623839,1500000000,1500000000
103002517499,1649693056,60950,104502517499,60950,121501623839,1500000000,1500000000
19453889492,1646552014,337518,20953889492,337518,25513619509,1500000000,1500000000
137257816948,1641234344,55580,138757816948,50780,154784438066,1500000000,1500000000
36420402315,1647830889,67646,37920402315,62846,48490069940,1500000000,1500000000
161125857748,1642217231,67634,162625857748,62834,168922744197,1500000000,1500000000
113143766395,1641244985,60862,114643766395,60862,148031896552,1500000000,1500000000
144126613127,1641966148,60862,145626613127,56062,199214629858,1500000000,1500000000
52100942568,1649687883,66802,53600942568,57202,54538197013,1500000000,1500000000
209736671768,1647523866,67646,211736671768,62846,245008354202,2000000000,2000000000
41340788018,1647015590,67634,42840788018,62834,54877337608,1500000000,1500000000
105849790553,1642249259,339997,107349790553,339997,116554416834,1500000000,1500000000
120516666155,1641994167,55644,123016666155,55644,275101699080,2500000000,2500000000
63983106908,1647987032,60850,65983106908,60850,96529350026,2000000000,2000000000
40538673824,1649688537,49483,42038673824,44683,46384730994,1500000000,1500000000
55177536587,1649699467,331201,56677536587,331201,61000141898,1500000000,1500000000
114670158597,1641236487,55580,116170158597,50780,132001857150,1500000000,1500000000
114670158597,1641236487,55592,116670158597,50792,137939434532,2000000000,2000000000
40208312938,1649682599,60850,41708312938,60850,51599476425,1500000000,1500000000
18070068873,1647486803,316147,19570068873,316147,20000000000,1500000000,1500000000
146590039342,1642213544,67646,148090039342,62846,184305861445,1500000000,1500000000
140929413103,1642214249,60862,142429413103,56062,164550360774,1500000000,1500000000
213806605775,1642022780,67634,215306605775,67634,225484056922,1500000000,1500000000
127518044517,1641992618,55644,129018044517,50844,184880197267,1500000000,1500000000
30334919486,1649646720,340057,31834919486,340057,41480702015,1500000000,1500000000
37385727655,1646583401,337454,38885727655,337454,46797277329,1500000000,1500000000
48195132465,1647905515,67634,49695132465,67634,63484698338,1500000000,1500000000
16826577658,1646993882,67634,18326577658,62834,22010066973,1500000000,1500000000
103449924953,1642257949,60862,107035009288,56062,,,
87885718295,1641238180,60862,89385718295,60862,121858828971,1500000000,1500000000
75109987670,1641217201,315286,76609987670,315286,92148614080,1500000000,1500000000
88250493586,1649690685,67634,89750493586,62834,104265919769,1500000000,1500000000
20785326645,1647505878,67634,22285326645,67634,23435283782,1500000000,1500000000
33399998874,1647496249,55668,34899998874,50868,44587387643,1500000000,1500000000
135364058509,1642276625,56516,136864058509,51716,147093888048,1500000000,1500000000
113214424727,1642221826,52916,114714424727,48116,130707296084,1500000000,1500000000
113639861257,1642258656,60838,115139861257,60838,157674075517,1500000000,1500000000
217306191751,1641963384,67634,218806191751,62834,304952205098,1500000000,1500000000
110466683750,1641988793,60862,112466683750,56062,115000000000,2000000000,2000000000
44366645182,1647964276,60850,45866645182,56050,63981291059,1500000000,1500000000
34612348598,1647974308,67646,36112348598,62846,47560165693,1500000000,1500000000
26805561198,1649672208,60006,28305561198,55206,38137855815,1500000000,1500000000
99037245179,1649690642,51440,100537245179,46640,118257987717,1500000000,1500000000
26624029616,1647870355,67646,28624029616,62846,38635425370,2000000000,2000000000
26103152166,1646976047,60862,27603152166,56062,30508930667,1500000000,1500000000
83622605925,1641188440,60862,85122605925,56062,100686309940,1500000000,1500000000
38470403000,1649686170,54664,39970403000,49864,49678833253,1500000000,1500000000
29032478533,1647559612,327984,30532478533,327984,37507105190,1500000000,1500000000
109115652577,1642223404,67646,110615652577,62846,155775616218,1500000000,1500000000
110408914247,1641247311,64741,111908914247,59941,159400888835,1500000000,1500000000
71563463271,1641192373,60862,73063463271,56062,107025708110,1500000000,1500000000
121762807710,1642005841,55608,123412807710,50808,125000000000,1650000000,1650000000
106758487451,1641996483,67634,108258487451,62834,146970388609,1500000000,1500000000
21398356253,1647949689,67622,23398356253,67622,25109168625,2000000000,2000000000
102761107484,1641244638,336835,103000000000,336835,103000000000,1650000000,238892516
131003059406,1641961523,60018,132503059406,55218,133104268353,1500000000,1500000000
20034001911,1646571280,324206,21534001911,324206,27642298294,1500000000,1500000000
158945554370,1642271660,322957,160445554370,322957,182561785009,1500000000,1500000000
158945554370,1642271660,336859,160445554370,336859,194881056759,1500000000,1500000000
91654058603,1641236943,64056,93154058603,59256,112890852768,1500000000,1500000000
91654058603,1641236943,65530,93154058603,60730,118526116517,1500000000,1500000000
117761391234,1641980879,60862,119261391234,56062,174290159168,1500000000,1500000000
23538035817,1646979194,60838,24875417478,60838,24875417478,1500000000,1337381661
92607733586,1642240940,67634,94107733586,62834,116523574392,1500000000,1500000000
74884049784,1641208360,336891,76384049784,336891,81377450406,1500000000,1500000000
55952432185,1641199557,60333,57452432185,50048,61000000000,1500000000,1500000000
65090514828,1649705858,67646,66590514828,62846,81492185485,1500000000,1500000000
65090514828,1649705858,317262,66590514828,317262,81492185485,1500000000,1500000000
40008955626,1647487352,67646,41031133373,62846,41031133373,1500000000,1022177747
21491209448,1647486754,55668,22991209448,50868,28006431807,1500000000,1500000000
34396783325,1647877422,60850,35896783325,60850,45497120192,1500000000,1500000000
155298647534,1642269808,67646,156798647534,62846,192974681742,1500000000,1500000000
191494578123,1642023787,317220,192994578123,317220,201240786510,1500000000,1500000000
70598813845,1647970788,67646,72598813845,62846,108504922145,2000000000,2000000000
24387196193,1649659067,308942,25887196193,308942,34350848799,1500000000,1500000000
117973901166,1642284995,67634,119473901166,62834,139304590043,1500000000,1500000000
124683934450,1641996286,60850,126183934450,56050,130264849408,1500000000,1500000000
54178435937,1647983857,67634,55678435937,67634,88026384650,1500000000,1500000000
24617282309,1647926058,67646,26117282309,62846,33925509055,1500000000,1500000000
19603024472,1649653222,64120,21103024472,64120,28746860363,1500000000,1500000000
16595448240,1649660497,295307,18095448240,295307,22174436738,1500000000,1500000000
31935733545,1647823058,333726,33435733545,333726,50455087208,1500000000,1500000000
128214957904,1642275404,54759,129714957904,49959,184004212428,1500000000,1500000000
44036669002,1647992262,316684,45536669002,316684,59096981378,1500000000,1500000000
25783086883,1649673513,323646,27283086883,323646,31822273649,1500000000,1500000000
25783086883,1649673513,314122,27283086883,314122,37532161689,1500000000,1500000000
29866758512,1647876973,56492,31366758512,51692,44194934992,1500000000,1500000000
127863856596,1641975775,55608,129000000000,50808,129000000000,1500000000,1136143404
40650341756,1649651820,59934,41795425500,55134,41795425500,1500000000,1145083744
118064029263,1641223476,321628,122000000000,321628,,,
118064029263,1641223476,327367,122000000000,327367,,,
45064792169,1647958653,49507,46564792169,44707,58282138849,1500000000,1500000000
21333480819,1647009589,60862,22833480819,56062,33429502032,1500000000,1500000000
125608378982,1642220236,67634,127108378982,62834,135253687228,1500000000,1500000000
116613369694,1641248200,67634,118113369694,62834,151965692135,1500000000,1500000000
128039531927,1641229226,322965,129539531927,322965,164159914084,1500000000,1500000000
42215570675,1649671074,67722,43715570675,67722,49275065037,1500000000,1500000000
15961956107,1647506348,334366,17461956107,334366,26059435649,1500000000,1500000000
15961956107,1647506348,333728,17461956107,333728,27007496349,1500000000,1500000000
46824065368,1646601521,54320,48324065368,49520,55861738772,1500000000,1500000000
112331724860,1642242022,319763,113831724860,319763,115269679423,1500000000,1500000000
22434065154,1647953775,49483,23934065154,49483,27854243073,1500000000,1500000000
18081540213,1646976688,310924,19581540213,310924,28420123167,1500000000,1500000000
117224656773,1641250619,67622,118724656773,67622,145699660667,1500000000,1500000000
115187679014,1641246925,52928,116687679014,48128,142474971102,1500000000,1500000000
19520597688,1647934955,337488,21020597688,337488,23614582320,1500000000,1500000000
73512579101,1649696000,303385,75512579101,303385,122000000000,2000000000,2000000000
39643714617,1649645377,67646,41143714617,62846,46586186757,1500000000,1500000000
44862297883,1647477630,330489,46362297883,330489,56359945343,1500000000,1500000000
80580570854,1641194756,67634,82080570854,67634,101931371686,1500000000,1500000000
105084664346,1641252293,67634,106584664346,62834,128581240390,1500000000,1500000000
22357191940,1647990887,64044,23357191940,64044,27000000000,1000000000,1000000000
33235948351,1646957898,55592,34735948351,50792,45834154753,1500000000,1500000000
107271438641,1642225310,340635,108771438641,340635,120370919024,1500000000,1500000000
95399125407,1641234647,60850,96899125407,56050,107897808288,1500000000,1500000000
177104029750,1641995541,55620,178604029750,50820,192736336947,1500000000,1500000000
135092317077,1642002440,59946,136592317077,55146,139000000000,1500000000,1500000000
256129496691,1642017977,60838,257629496691,60838,286241313783,1500000000,1500000000
24834177887,1649639663,63200,26334177887,63200,58662639020,1500000000,1500000000
41703754958,1647543542,67634,43203754958,62834,59532812623,1500000000,1500000000
19843911681,1646561490,55580,21246923557,50780,21246923557,1500000000,1403011876
93101220212,1641237096,64741,94601220212,59941,95276322699,1500000000,1500000000
30051317842,1649644776,320497,31551317842,303397,40818045477,1500000000,1500000000
30051317842,1649644776,322935,31551317842,322935,41172023262,1500000000,1500000000
30051317842,1649644776,326846,31551317842,326846,40818045477,1500000000,1500000000
17269511751,1647493141,317298,18769511751,317298,34262945472,1500000000,1500000000
82943409012,1646595330,67646,84443409012,67646,85000000000,1500000000,1500000000
159023845828,1642267375,60862,160523845828,56062,166851914379,1500000000,1500000000
140811159927,1641976078,60850,142811159927,60850,165000000000,2000000000,2000000000
25369763736,1647925193,67634,26869763736,62834,33322762634,1500000000,1500000000
68541211943,1647973200,319915,70041211943,319915,91884772399,1500000000,1500000000
42057534509,1649671546,48639,43557534509,48639,56847042108,1500000000,1500000000
128500255580,1642225543,67646,130000255580,62846,147418593028,1500000000,1500000000
128500255580,1642225543,67634,130000255580,67634,148031110134,1500000000,1500000000
46708511655,1647979766,60850,48208511655,60850,63625698813,1500000000,1500000000
46708511655,1647979766,67634,48208511655,62834,72364204934,1500000000,1500000000
29093825532,1649649587,60950,30593825532,56150,38877670778,1500000000,1500000000
38404453710,1649650941,67634,39904453710,67634,45155630598,1500000000,1500000000
77795516936,1641200860,324774,79295516936,324774,79762424898,1500000000,1500000000
109485780883,1641171113,314053,110985780883,314053,130233994191,1500000000,1500000000
156028183453,1641231610,55608,157528183453,55608,168009845235,1500000000,1500000000
100744181885,1641248919,55592,102244181885,50792,136248627222,1500000000,1500000000
129410288958,1642001121,64056,130910288958,59256,174475675295,1500000000,1500000000
136091069212,1641966806,310293,137591069212,310293,140000000000,1500000000,1500000000
153740008987,1641994310,67634,155240008987,62834,189371580922,1500000000,1500000000
69882671352,1649701681,67710,71382671352,62910,80123599159,1500000000,1500000000
24141987153,1649667416,67646,26141987153,62846,32606650385,2000000000,2000000000
62615068313,1646595714,55592,64115068313,50792,78584840132,1500000000,1500000000
121525039854,1642205457,54715,123025039854,54715,178076424649,1500000000,1500000000
125400170956,1642257739,303311,126900170956,303311,151750050033,1500000000,1500000000
147649831654,1641996131,67634,149149831654,67634,161071686187,1500000000,1500000000
163989105189,1641958880,55693,165489105189,50893,182157696613,1500000000,1500000000
16915764600,1649658634,66742,18415764600,61942,25489536782,1500000000,1500000000
181638716115,1642019851,67646,183138716115,62846,276806961299,1500000000,1500000000
23030096079,1646536132,67634,24530096079,67634,26582561382,1500000000,1500000000
33172385698,1646581283,306038,34484766598,306038,34484766598,1500000000,1312380900
163339023195,1642208011,67634,164839023195,67634,214683429204,1500000000,1500000000
97227040267,1642223459,55693,98727040267,55693,114778181347,1500000000,1500000000
109785873474,1641178401,320487,110832388362,320487,110832388362,1500000000,1046514888
178354735808,1641950995,60838,179854735808,60838,208426253395,1500000000,1500000000
178354735808,1641950995,60862,179854735808,56062,208426253395,1500000000,1500000000
24839755717,1649670480,67634,25839755717,62834,28000000000,1000000000,1000000000
17350883151,1649659584,314206,19350883151,297106,150000000000,2000000000,2000000000
72695286625,1647544164,56729,74195286625,47129,117304432393,1500000000,1500000000
27552983336,1646573042,55580,29052983336,55580,37012581163,1500000000,1500000000
30989052073,1646555542,331179,32107408902,331179,32107408902,1500000000,1118356829
44297030440,1647020806,60850,45797030440,56050,55402697810,1500000000,1500000000
200224893313,1642031531,60850,201724893313,56050,222249960685,1500000000,1500000000
152359905944,1641990723,60862,153859905944,56062,155088636434,1500000000,1500000000
39139073708,1647960476,60850,40639073708,56050,50447463624,1500000000,1500000000
42829992003,1649705955,326838,45000000000,326838,45000000000,45000000000,2170007997
26140743125,1649676834,67634,27640743125,62834,34064604228,1500000000,1500000000
19506879840,1647504625,67646,21006879840,62846,25734655458,1500000000,1500000000
27925402998,1647870501,67646,28925402998,62846,31788289855,1000000000,1000000000
20646088959,1646976161,60838,22146088959,60838,30218954948,1500000000,1500000000
122103902875,1642259306,331145,123603902875,331145,127028378559,1500000000,1500000000
122103902875,1642259306,333658,123603902875,333658,127028378559,1500000000,1500000000
127455833310,1642266532,327992,128955833310,327992,132916323805,1500000000,1500000000
86382165351,1641191253,331165,87882165351,331165,104119382584,1500000000,1500000000
86382165351,1641191253,336887,87882165351,336887,104119382584,1500000000,1500000000
36865952187,1647920277,337522,38275952187,337522,40842829090,1410000000,1410000000
25598315976,1647490934,319311,27098315976,319311,35035355522,1500000000,1500000000
24971259980,1646582066,67658,26471259980,62858,36607669070,1500000000,1500000000
24622995242,1647825987,333273,26122995242,333273,31732357653,1500000000,1500000000
24622995242,1647825987,329363,26622995242,329363,33441651959,2000000000,2000000000
86615645272,1641225210,55580,88115645272,55580,99170407192,1500000000,1500000000
140130666366,1641956784,60862,141630666366,56062,141874274408,1500000000,1500000000
37632094069,1647925848,67622,39132094069,67622,47834807920,1500000000,1500000000
27474982500,1647951049,324188,28974982500,324188,29104508042,1500000000,1500000000
42605342354,1647478305,312350,44605342354,312350,57879863012,2000000000,2000000000
93152012133,1641228034,54461,96152012133,49661,134599125588,3000000000,3000000000
85536196904,1641209617,67646,87036196904,62846,100337840492,1500000000,1500000000
19049833983,1647934265,64067,20549833983,59267,23825584370,1500000000,1500000000
29486609130,1647868818,66766,30986609130,61966,38170283662,1500000000,1500000000
28611626358,1646961127,314043,30111626358,314043,40919948339,1500000000,1500000000
50891023706,1647037009,60850,52391023706,56050,68027357578,1500000000,1500000000
115634863338,1641225656,55580,117634863338,50780,154500086792,2000000000,2000000000
124642208074,1641968098,67634,126142208074,62834,144020518529,1500000000,1500000000
156165729878,1641975484,340677,157665729878,340677,169523424283,1500000000,1500000000
52416322812,1647962765,310287,53803728583,310287,53803728583,1500000000,1387405771
25199975837,1646957136,60850,28000000000,56050,28000000000,25000000000,2800024163
105656175051,1642281902,60850,107156175051,56050,158980066765,1500000000,1500000000
132281531503,1642267315,64741,133781531503,59941,188389062368,1500000000,1500000000
69581916487,1649695768,66790,71081916487,66790,90859386597,1500000000,1500000000
21057332531,1649666477,60850,22557332531,56050,34270614967,1500000000,1500000000
23339121817,1649659009,319769,24839121817,319769,27952407824,1500000000,1500000000
73723506566,1641215205,322886,75223506566,322886,85000000000,1500000000,1500000000
167822928106,1641967163,60850,169472928106,56050,205932060752,1650000000,1650000000
15918994957,1649661106,56492,17418994957,56492,20343153003,1500000000,1500000000
15918994957,1649661106,312127,17418994957,312127,20343153003,1500000000,1500000000
15589677783,1646561527,52940,17089677783,48140,23332447542,1500000000,1500000000
118578744470,1642224903,60862,120078744470,56062,123716087560,1500000000,1500000000
93436642151,1641204693,67634,95436642151,62834,126308712772,2000000000,2000000000
57465846932,1641214282,67658,75000000000,62858,,,
206719402800,1641963442,337506,208219402800,337506,253762126532,1500000000,1500000000
55235269541,1649697610,59946,56735269541,59946,72472840348,1500000000,1500000000
32326075911,1649647519,67634,33826075911,62834,41995937450,1500000000,1500000000
23133029172,1649666002,67722,24633029172,62922,27213039564,1500000000,1500000000
40259926936,1647883782,67634,41759926936,67634,52560689967,1500000000,1500000000
97701622347,1642252280,64717,99201622347,59917,121111180934,1500000000,1500000000
88269026909,1641226711,64717,89769026909,64717,118534477932,1500000000,1500000000
94111895337,1641226990,333704,95611895337,333704,98359530326,1500000000,1500000000
79870420233,1641209804,309157,81370420233,309157,108577751531,1500000000,1500000000
149845241705,1641994753,55644,152345241705,55644,345003409610,2500000000,2500000000
24343127307,1649672715,60850,25843127307,56050,32741728949,1500000000,1500000000
68206718059,1646598318,67634,69706718059,62834,85224413843,1500000000,1500000000
125458467644,1642223991,343201,126958467644,343201,145791882532,1500000000,1500000000
146602844290,1642276689,55600,148102844290,50800,155443693190,1500000000,1500000000
26181454253,1649672117,48651,27681454253,43851,30593615355,1500000000,1500000000
54494255311,1649703617,337456,55994255311,337456,72391659100,1500000000,1500000000
50165550747,1647901685,60850,51665550747,56050,64185257427,1500000000,1500000000
50165550747,1647901685,64705,51665550747,59905,64185257427,1500000000,1500000000
139588288377,1641240602,55608,141088288377,50808,150409842902,1500000000,1500000000
174879180092,1642030433,67634,176379180092,62834,176422645484,1500000000,1500000000
17910588447,1649658727,49595,19410588447,44795,26456920404,1500000000,1500000000
21398915617,1647513451,55584,22898915617,55584,23067268322,1500000000,1500000000
25154782696,1647835616,67622,26654782696,67622,36710416334,1500000000,1500000000
58153914379,1647879929,60862,59653914379,56062,62696278447,1500000000,1500000000
38729632026,1647869704,60838,40229632026,60838,47846281967,1500000000,1500000000
59644331780,1641180551,302805,61000000000,302805,61000000000,1500000000,1355668220
21311507900,1647951946,60850,22811507900,56050,26580596737,1500000000,1500000000
32204823554,1647956876,67634,33704823554,62834,43183515239,1500000000,1500000000
39857209796,1647988986,307690,41357209796,307690,45788094054,1500000000,1500000000
14977677734,1649659605,310209,16977677734,310209,150000000000,2000000000,2000000000
157005707336,1642270582,60838,158505707336,60838,181224385770,1500000000,1500000000
172159193596,1642262027,60850,173659193596,56050,209904355078,1500000000,1500000000
106388722684,1647972775,316726,107888722684,316726,126478676710,1500000000,1500000000
34343701165,1647946386,67634,35843701165,67634,42985802045,1500000000,1500000000
17605014146,1647494767,67634,19105014146,67634,25000000000,1500000000,1500000000
23135916143,1646553482,54332,24635916143,49532,30278002025,1500000000,1500000000
115914182982,1641170535,67634,117414182982,67634,144891109386,1500000000,1500000000
125168068162,1641238300,52928,126668068162,48128,135023705322,1500000000,1500000000
185843993187,1642004403,59982,187343993187,55182,231599057207,1500000000,1500000000
30430893141,1649672260,55681,31930893141,55681,38656162914,1500000000,1500000000
233044456163,1647520796,49483,234638800763,49483,333554484311,1594344600,1594344600
26152607266,1647497789,55668,27652607266,50868,37830853304,1500000000,1500000000
23598670148,1646551647,336879,25098670148,336879,29942619469,1500000000,1500000000
13713590769,1647001595,60850,15213590769,60850,18457423894,1500000000,1500000000
138415425180,1642284198,67646,140697107680,62846,188757025280,2281682500,2281682500
127320994381,1642233013,80850,128820994381,60850,190963663233,1500000000,1500000000
43751697795,1649647038,66730,45251697795,61930,47519595064,1500000000,1500000000
46529919128,1647481721,55668,48029919128,50868,48579488918,1500000000,1500000000
22865788118,1646544515,67658,24365788118,62858,25848025848,1500000000,1500000000
102111214007,1641224537,336853,103611214007,336853,109386521157,1500000000,1500000000
94006025180,1641983327,59958,105000000000,59958,,,
122588029452,1642000188,67634,124088029452,62834,138682934055,1500000000,1500000000
111701680100,1641993481,329267,113201680100,329267,173010739305,1500000000,1500000000
109300132407,1642280852,333704,110800132407,333704,138563199733,1500000000,1500000000
128617567112,1641182179,60862,130617567112,56062,174432709494,2000000000,2000000000
110766100027,1641233340,52928,112266100027,48128,131255661634,1500000000,1500000000
72631299247,1641189591,60850,74131299247,56050,77890487926,1500000000,1500000000
118644182351,1641219698,55592,120144182351,50792,144152738374,1500000000,1500000000
172319755571,1641991059,329300,173819755571,329300,240879627608,1500000000,1500000000
15286747238,1647941257,67634,16386747238,67634,23097193978,1100000000,1100000000
26601324015,1647825983,328370,28601324015,328370,37933316523,2000000000,2000000000
133908266528,1642274584,67710,135908266528,67710,177748224194,2000000000,2000000000
86891348705,1641184109,330509,88391348705,330509,102924478918,1500000000,1500000000
190127122255,1642024231,326092,191627122255,326092,256009330135,1500000000,1500000000
35703345540,1647991866,56705,36767866547,47105,36767866547,1500000000,1064521007
14004542126,1647001146,317348,15504542126,317348,22773782612,1500000000,1500000000
117318672414,1642267131,60862,118818672414,56062,162228284513,1500000000,1500000000
101231545669,1642288786,333664,102731545669,333664,126712128434,1500000000,1500000000
90103618926,1641180252,67646,91603618926,62846,133000000000,1500000000,1500000000
102494211222,1641225855,313397,103994211222,313397,114529928862,1500000000,1500000000
102494211222,1641225855,327343,103994211222,327343,114529928862,1500000000,1500000000
123854537527,1642225630,60862,125354537527,60862,129342612659,1500000000,1500000000
105239749422,1641248012,55592,106739749422,50792,128213297958,1500000000,1500000000
229034145457,1642012041,67634,230534145457,62834,272763009935,1500000000,1500000000
162110881190,1641997437,55608,163610881190,50808,194595030610,1500000000,1500000000
34052609816,1647946418,67634,35552609816,67634,44981771928,1500000000,1500000000
26734798479,1649665171,67722,28234798479,62922,30712400245,1500000000,1500000000
26734798479,1649665171,67658,28234798479,62858,30712400245,1500000000,1500000000
94990127408,1642285952,67646,96490127408,62846,134248930152,1500000000,1500000000
184464455991,1642004653,54848,185964455991,50048,233004110217,1500000000,1500000000
168599786209,1641947384,55592,170099786209,55592,256694508394,1500000000,1500000000
28350271767,1649673580,67646,29850271767,62846,40787041312,1500000000,1500000000
49977838396,1649678272,64032,51748424016,54432,55000000000,1770585620,1770585620
24022598274,1646965443,336917,25522598274,336917,44078499483,1500000000,1500000000
117407338411,1642280910,54771,118907338411,49971,139154035059,1500000000,1500000000
157506989731,1642021978,60850,159006989731,56050,179930517934,1500000000,1500000000
154622416098,1641966004,67646,156122416098,62846,196743596767,1500000000,1500000000
206265920976,1642020281,60862,207765920976,56062,258042412090,1500000000,1500000000
28920496631,1647955688,314174,30000000000,314174,30000000000,1500000000,1079503369
40381966943,1649639896,333700,41386207317,316600,41386207317,1500000000,1004240374
34583983143,1647894749,60838,36083983143,60838,39845680669,1500000000,1500000000
54399922986,1649719570,60862,55899922986,56062,72689582757,1500000000,1500000000
34958648614,1647896126,317242,36458648614,317242,50983046080,1500000000,1500000000
134544600216,1642245068,66730,136044600216,61930,159682999128,1500000000,1500000000
116303182715,1641218775,60862,117803182715,56062,122272204763,1500000000,1500000000
56188513073,1649687658,334304,57688513073,334304,68618907178,1500000000,1500000000
27289366032,1649646371,60850,29289366032,56050,34093726816,2000000000,2000000000
50495806896,1649698603,67646,51995806896,62846,55801759787,1500000000,1500000000
236860764336,1647522167,55596,238526708345,55596,388248903980,1665944009,1665944009
87921451265,1642273765,60850,89421451265,60850,135630923089,1500000000,1500000000
123661071024,1642255178,60862,125161071024,56062,136150753254,1500000000,1500000000
170546743363,1642208000,66754,172046743363,66754,218190555347,1500000000,1500000000
72716078826,1642254040,323381,74366078826,323381,75000000000,1650000000,1650000000
118963127455,1642219428,323616,120463127455,323616,185212887369,1500000000,1500000000
104264875828,1641180836,67634,110000000000,62834,,,
79797319170,1641221047,333710,81297319170,333710,108701991107,1500000000,1500000000
18885346288,1649654765,67634,20385346288,67634,22624808924,1500000000,1500000000
16918038210,1647512059,313453,18418038210,313453,19392926262,1500000000,1500000000
179116887689,1642215629,309154,180616887689,309154,204867931359,1500000000,1500000000
122704940363,1641220479,60030,124204940363,55230,166432395893,1500000000,1500000000
204543319126,1641251231,67646,206043319126,62846,239703349168,1500000000,1500000000
35500528973,1647954040,67622,36500528973,62822,40938375049,1000000000,1000000000
88409294639,1641219408,320449,89909294639,320449,113143731579,1500000000,1500000000
74596985771,1641204737,59946,76096985771,55146,81574689573,1500000000,1500000000
19395912794,1647928127,60850,20895912794,56050,24837057797,1500000000,1500000000
127637994624,1642274896,334336,129137994624,334336,152053632898,1500000000,1500000000
177071123122,1641246346,64729,178571123122,59929,201686612097,1500000000,1500000000
107043058500,1641253942,55781,108543058500,50981,131131226188,1500000000,1500000000
83525307313,1641190806,336905,85525307313,336905,102609744337,2000000000,2000000000
37153352773,1647963793,67622,38653352773,67622,50855440390,1500000000,1500000000
15511120928,1647853300,309116,17011120928,309116,24457456968,1500000000,1500000000
196709929089,1641995170,55668,198209929089,50868,270345776539,1500000000,1500000000
19729161010,1649659205,321919,21229161010,321919,24837233452,1500000000,1500000000
29018882594,1647483567,313360,30518882594,313360,46707514110,1500000000,1500000000
128635738349,1642219828,60862,130135738349,56062,161079607544,1500000000,1500000000
144407538908,1642209250,60862,145907538908,56062,200386109039,1500000000,1500000000
152121461696,1641982552,67634,153621461696,62834,154537141147,1500000000,1500000000
22456434557,1649665778,60926,23956434557,60926,38307056930,1500000000,1500000000
20492552701,1647874150,323612,21492552701,323612,23000000000,1000000000,1000000000
66876478627,1641193669,333744,68376478627,333744,87429199029,1500000000,1500000000
127491795720,1641978711,67658,128991795720,62858,140000000000,1500000000,1500000000
30208393787,1647963244,67634,31708393787,62834,42438769592,1500000000,1500000000
74450049837,1649694953,60862,75950049837,56062,89183449182,1500000000,1500000000
28948474228,1647490085,55720,30448474228,50920,38372820243,1500000000,1500000000
31738315243,1646537535,67634,33238315243,67634,43544394459,1500000000,1500000000
26035163591,1647886520,317340,27535163591,317340,28679753420,1500000000,1500000000
155222822378,1642204882,54920,156722822378,50120,215407571919,1500000000,1500000000
116238648491,1642253674,56516,118238648491,51716,136286269141,2000000000,2000000000
85460252800,1642256874,336875,205000000000,336875,,,
71434143438,1641209257,323676,72934143438,323676,97431978285,1500000000,1500000000
111295225077,1641236614,67634,112795225077,67634,130115294454,1500000000,1500000000
16335505200,1646969634,60090,17835505200,55290,21780691913,1500000000,1500000000
138135816401,1642028110,60838,139635816401,60838,167201010722,1500000000,1500000000
70061862342,1649706087,325655,71561862342,325655,75785566714,1500000000,1500000000
24348243573,1647518145,326822,25707753292,326822,25707753292,1500000000,1359509719
24348243573,1647518145,52916,26348243573,48116,28701846031,2000000000,2000000000
16052291953,1646994173,67646,17552291953,62846,21486177132,1500000000,1500000000
88918141377,1642248419,60850,90418141377,60850,144754564337,1500000000,1500000000
86462394033,1649692981,49571,87962394033,49571,109658578382,1500000000,1500000000
86462394033,1649692981,64729,87962394033,59929,131186653959,1500000000,1500000000
116630872523,1641253858,336859,118130872523,336859,131131226188,1500000000,1500000000
109433026931,1641227204,67634,111433026931,67634,132404508983,2000000000,2000000000
122481853759,1642288030,52653,123981853759,47853,152154745318,1500000000,1500000000
43322921978,1649687288,326786,44822921978,326786,50699261588,1500000000,1500000000
63485383206,1649702282,64741,65485383206,59941,70000000000,2000000000,2000000000
23871834430,1649664895,330471,25371834430,330471,32528988975,1500000000,1500000000
97753936311,1647538952,67658,99253936311,62858,116845700142,1500000000,1500000000
23847885617,1647864152,316656,25347885617,316656,33043078100,1500000000,1500000000
29362311972,1647016390,67634,49362311972,62834,88000000000,20000000000,20000000000
144180587456,1642212402,67634,145680587456,62834,206567107147,1500000000,1500000000
89157715949,1641182327,60950,90657715949,56150,93380425238,1500000000,1500000000
71681011052,1641183659,331165,73181011052,331165,91084156025,1500000000,1500000000
169374205383,1641971393,60862,170874205383,56062,189867871590,1500000000,1500000000
73073615153,1649701776,64741,74573615153,59941,84726252368,1500000000,1500000000
20187830383,1649654497,64132,21687830383,59332,25437651738,1500000000,1500000000
18825734065,1647854873,59970,20325734065,55170,25451037610,1500000000,1500000000
17793819978,1647000985,63200,20293819978,63200,36454099758,2500000000,2500000000
132593043788,1642254509,60850,134093043788,56050,149819527595,1500000000,1500000000
162271285829,1641962741,60850,163771285829,56050,232568811758,1500000000,1500000000
140391370682,1641995943,67646,141891370682,62846,189081670083,1500000000,1500000000
80209932212,1647544251,60838,81709932212,56038,89075028575,1500000000,1500000000
31126047982,1647902327,327956,32626047982,327956,49175172837,1500000000,1500000000
21962776166,1646981926,60850,23462776166,56050,26310401464,1500000000,1500000000
99813867840,1641224336,55592,124000847939,50792,124000847939,124000847939,24186980099
105175005878,1641236673,67634,108179412045,67634,,,
136849645607,1641989191,67634,138349645607,67634,166016433087,1500000000,1500000000
50597470187,1649700327,66754,52097470187,66754,64714790340,1500000000,1500000000
21642107466,1649659334,67722,23142107466,67722,30288166130,1500000000,1500000000
24630643066,1649652337,317234,26130643066,317234,31847981132,1500000000,1500000000
57383166615,1649704784,331173,58883166615,331173,74672770447,1500000000,1500000000
41077492804,1649681591,66730,42577492804,61930,56756652120,1500000000,1500000000
27426244527,1649674787,59982,28926244527,59982,40704758234,1500000000,1500000000
19436172750,1649640541,60862,20000000000,56062,20000000000,1000000000,563827250
23386777496,1646977129,67634,24886777496,67634,36655244343,1500000000,1500000000
25968671589,1646957788,60838,27468671589,60838,33805325239,1500000000,1500000000
88174432362,1641224391,60838,89674432362,60838,92886543690,1500000000,1500000000
88174432362,1641224391,322524,89674432362,322524,92886543690,1500000000,1500000000
69166589541,1641214892,60850,70666589541,60850,89506216079,1500000000,1500000000
156403844793,1641961098,59970,157903844793,55170,195361395414,1500000000,1500000000
175324515855,1642018777,67634,176824515855,67634,183893301862,1500000000,1500000000
22108883763,1647945885,56492,23608883763,51692,28977937495,1500000000,1500000000
65751288387,1647968951,67634,67251288387,62834,87994422973,1500000000,1500000000
28593095297,1649658242,60926,30093095297,60926,36997533458,1500000000,1500000000
51074894872,1649703134,320489,52074894872,320489,60847948312,1000000000,1000000000
41196436508,1647560016,67634,42696436508,67634,57058765469,1500000000,1500000000
28271691508,1647831544,319761,29771691508,319761,34159347054,1500000000,1500000000
113948128613,1641248304,55580,115448128613,50780,149707611138,1500000000,1500000000
130233758423,1641950268,330010,131733758423,330010,174672671733,1500000000,1500000000
42609742293,1647960364,60862,44109742293,56062,48211934675,1500000000,1500000000
47549540938,1647973828,49495,49049540938,49495,66023977944,1500000000,1500000000
28579598989,1649676830,67634,30079598989,62834,37379155933,1500000000,1500000000
28516532266,1647497709,327417,30182476275,327417,30974638259,1665944009,1665944009
119485108087,1641975424,63200,121985108087,63200,275608818484,2500000000,2500000000
159140751464,1641957432,60862,160000000000,56062,160000000000,2000000000,859248536
20230767312,1646993524,55295,21730767312,50495,22828822423,1500000000,1500000000
16993687846,1647510028,67634,18493687846,62834,22557414827,1500000000,1500000000
17603276160,1646549867,329249,19103276160,329249,25027626815,1500000000,1500000000
30923437560,1647853832,340015,32923437560,340015,41611201134,2000000000,2000000000
130579770686,1642264919,67634,132079770686,67634,137401081700,1500000000,1500000000
62130021213,1641199985,319293,63630021213,319293,72436858428,1500000000,1500000000
138115625755,1642001029,67634,139615625755,58034,241257577085,1500000000,1500000000
20165243769,1647950537,56492,21665243769,51692,28953107850,1500000000,1500000000
70112699349,1647916209,56492,71612699349,51692,84459983292,1500000000,1500000000
27951063495,1646972104,317330,29451063495,317330,32998777668,1500000000,1500000000
114779614821,1642249524,60850,116279614821,60850,121138847893,1500000000,1500000000
36676084158,1647971648,67634,38176084158,62834,46850739298,1500000000,1500000000
53610529089,1649703289,67710,55110529089,67710,59289197134,1500000000,1500000000
39963987265,1649720539,323672,40978339247,323672,40978339247,1500000000,1014351982
32530311817,1647557766,67622,34030311817,67622,37222007895,1500000000,1500000000
16733141123,1646549835,306565,17929504879,306565,18178920278,1196363756,1196363756
16733141123,1646549835,60838,18233141123,60838,22728195653,1500000000,1500000000
141948561071,1642218689,346374,143448561071,346374,167313818543,1500000000,1500000000
98063079242,1642258195,67634,99563079242,67634,130512850324,1500000000,1500000000
72216799295,1641198438,60862,73716799295,56062,77651487680,1500000000,1500000000
40535621830,1647873245,56492,42035621830,56492,43112371474,1500000000,1500000000
139896487708,1642224439,60862,141396487708,56062,180756167050,1500000000,1500000000
36272595317,1647945685,314180,37772595317,314180,49283195652,1500000000,1500000000
101704626553,1649693079,60850,103204626553,60850,123950481975,1500000000,1500000000
23028542398,1646533226,67646,24528542398,67646,50000000000,1500000000,1500000000
43186443778,1647029785,67646,100000000000,62846,100000000000,100000000000,56813556222
84751012219,1642285973,332364,86751012219,332364,128310017983,2000000000,2000000000
24469295106,1647966191,67634,25000000000,62834,25000000000,25000000000,530704894
36802828251,1649668108,67646,38302828251,67646,40038078903,1500000000,1500000000
65185350023,1641197548,333688,66685350023,333688,77312570212,1500000000,1500000000
203501855969,1641947638,60850,205001855969,60850,254333806639,1500000000,1500000000
109655226809,1649707516,59970,111155226809,55170,125079831349,1500000000,1500000000
35440921948,1647500006,67622,36940921948,62822,45336096988,1500000000,1500000000
17529526695,1647852732,336909,19029526695,336909,24843510818,1500000000,1500000000
17529526695,1647852732,337452,19029526695,337452,24843510818,1500000000,1500000000
16782590923,1647001710,55680,18282590923,50880,19190211770,1500000000,1500000000
138895940551,1642269920,55705,140395940551,50905,172002274228,1500000000,1500000000
105395488592,1641248247,49495,106895488592,44695,147266712118,1500000000,1500000000
97559521872,1641180690,60850,99059521872,56050,133000000000,1500000000,1500000000
23034968951,1647932592,67634,24534968951,62834,25445494333,1500000000,1500000000
34156785307,1647945584,67622,35656785307,67622,44867383508,1500000000,1500000000
84717520532,1649691569,334314,85717520532,334314,91210196638,1000000000,1000000000
22878195275,1647490587,334360,24378195275,334360,32606433642,1500000000,1500000000
29675923112,1646561962,60862,31175923112,56062,43297864597,1500000000,1500000000
97907765482,1642224244,340645,99407765482,340645,134726421859,1500000000,1500000000
187769085219,1642217569,49507,189269085219,44707,254795158607,1500000000,1500000000
18508255524,1647931941,67646,20008255524,62846,27655064182,1500000000,1500000000
53969220831,1649689877,336897,55469220831,336897,81166405317,1500000000,1500000000
13948104094,1647513495,55584,15448104094,55584,27168571815,1500000000,1500000000
129382658710,1642266363,56492,130882658710,56492,145440138624,1500000000,1500000000
72483353705,1641186936,54800,73983353705,35862,83040098692,1500000000,1500000000
72483353705,1641186936,54788,73983353705,54788,83040098692,1500000000,1500000000
44550395890,1647984011,49483,46050395890,49483,61316744458,1500000000,1500000000
49587758670,1647905494,317312,51087758670,317312,300000000000,1500000000,1500000000
14568121023,1647001727,56480,16568121023,51680,22721318893,2000000000,2000000000
144818853361,1642214297,67646,146318853361,62846,170086494512,1500000000,1500000000
33822304863,1647550623,60838,35322304863,56038,44422592047,1500000000,1500000000
108412682190,1642244165,67634,109912682190,62834,130661465257,1500000000,1500000000
131229184770,1642251139,331139,132729184770,331139,181955072078,1500000000,1500000000
94447070602,1642248086,66802,95947070602,62002,102652176108,1500000000,1500000000
111169644700,1642224145,67634,112669644700,67634,139104259324,1500000000,1500000000
62776993495,1641210588,322492,64276993495,322492,66000000000,1500000000,1500000000
103553056098,1641233582,67634,105053056098,62834,114454426455,1500000000,1500000000
87483090071,1641172168,60862,88983090071,56062,98029012978,1500000000,1500000000
21944548955,1647991225,67622,23444548955,67622,29175285320,1500000000,1500000000
50022617678,1649719174,330499,51522617678,330499,60272539512,1500000000,1500000000
62323264904,1649709340,48651,82813757372,43851,82813757372,63000000000,20490492468
88101286445,1649710357,48603,89601286445,43803,116642958962,1500000000,1500000000
37516551501,1649651930,63200,39016551501,63200,68438041616,1500000000,1500000000
154518702643,1642278094,60850,156018702643,60850,180660753344,1500000000,1500000000
124407681966,1642224580,54836,125907681966,54836,195571798662,1500000000,1500000000
69736988607,1641215254,324778,71236988607,324778,89968207880,1500000000,1500000000
19905023006,1647927701,337472,21555023006,337472,23000000000,1650000000,1650000000
21406472755,1647934225,67634,22906472755,67634,26656537073,1500000000,1500000000
15335978436,1649664090,60926,16835978436,56126,26645338452,1500000000,1500000000
23496640101,1649644273,310884,24996640101,310884,25050139575,1500000000,1500000000
36719930419,1649704930,66850,38219930419,62050,57516770077,1500000000,1500000000
93768519182,1642280813,324826,95268519182,324826,155213181614,1500000000,1500000000
108522641782,1642246120,324804,110022641782,324804,142451791173,1500000000,1500000000
136721369543,1641245664,54837,138221369543,50037,151774357639,1500000000,1500000000
54093067634,1641199546,67622,55593067634,67622,74260222439,1500000000,1500000000
67337020450,1647014428,60862,69337020450,60862,69483509593,2000000000,2000000000
130873631115,1642273271,60850,132373631115,60850,136095098545,1500000000,1500000000
103210280259,1642258186,66826,104710280259,62026,140732582545,1500000000,1500000000
120161276099,1641252934,67646,121661276099,62846,129680439027,1500000000,1500000000
78856188743,1649711026,55656,80356188743,50856,91049023823,1500000000,1500000000
39591505233,1647018882,66826,41091505233,62026,63434054919,1500000000,1500000000
18439301312,1647005396,67634,19939301312,62834,24675379664,1500000000,1500000000
84731156345,1642252633,55636,87231156345,55636,153135146594,2500000000,2500000000
146062295406,1641254217,67622,147562295406,67622,177892584704,1500000000,1500000000
157248523213,1641995258,56576,158748523213,51776,238667790480,1500000000,1500000000
211975417491,1642006560,63200,214475417491,63200,462515801902,2500000000,2500000000
99460036324,1646594283,55720,100960036324,50920,131661260499,1500000000,1500000000
138055602831,1642269780,55705,139555602831,50905,178631835335,1500000000,1500000000
97048483823,1642257015,67646,98548483823,62846,131917202332,1500000000,1500000000
71683726075,1641205778,327946,73183726075,327946,90845106676,1500000000,1500000000
23397446639,1649657985,320499,24897446639,320499,29189807613,1500000000,1500000000
29707651192,1647853955,323553,31207651192,323553,40498781884,1500000000,1500000000
159419239727,1642270116,54848,161244585727,50048,179362131713,1825346000,1825346000
81091012322,1641237230,55693,82591012322,50893,107488610006,1500000000,1500000000
96126114415,1649693422,322949,97626114415,322949,138028430329,1500000000,1500000000
17727704821,1649644175,60874,19227704821,56074,30398295020,1500000000,1500000000
61573690889,1649681933,326119,63073690889,326119,74846029827,1500000000,1500000000
20813119955,1649659180,334314,22313119955,334314,26281577849,1500000000,1500000000
135045456671,1641247094,67646,136545456671,58046,151563459557,1500000000,1500000000
22445539557,1649665684,48579,23945539557,48579,27016749394,1500000000,1500000000
20716849924,1649673272,52916,22216849924,52916,29926026544,1500000000,1500000000
27933289130,1649666912,48603,29433289130,43803,37605220555,1500000000,1500000000
36701570806,1647481968,67634,38201570806,67634,57528508797,1500000000,1500000000
137342989990,1641950346,67634,138842989990,62834,165813237418,1500000000,1500000000
82952481848,1646596280,67634,84277881848,67634,107035636863,1325400000,1325400000
92748560557,1642256959,330529,94248560557,330529,109557023943,1500000000,1500000000
106836793221,1642251595,55580,108336793221,50780,143133022617,1500000000,1500000000
65712955276,1641215533,64741,67212955276,59941,87405296475,1500000000,1500000000
168369648832,1641959504,67634,169869648832,67634,182988339725,1500000000,1500000000
20670083497,1649676007,338754,22170083497,338754,24956826237,1500000000,1500000000
24936631977,1646569265,54861,26132112568,50061,26132112568,1500000000,1195480591
132089518325,1642219664,67634,133589518325,62834,140000000000,1500000000,1500000000
124596109208,1642284737,54676,126096109208,49876,170034319479,1500000000,1500000000
39981625729,1647981671,60862,41481625729,56062,50950123569,1500000000,1500000000
54705307743,1649683079,60938,56205307743,60938,66321862172,1500000000,1500000000
94550285095,1642234415,336899,96201520833,336899,,,
170206811904,1641251526,329203,171706811904,329203,215870286753,1500000000,1500000000
109875237448,1641245531,67634,111375237448,62834,119461029348,1500000000,1500000000
88553229616,1649695755,343211,90053229616,343211,109442396880,1500000000,1500000000
23248169911,1647504389,67634,24748169911,62834,32965659405,1500000000,1500000000
31000644929,1647518429,326826,33000644929,326826,39322171900,2000000000,2000000000
24624631644,1646966467,67634,28000000000,62834,28000000000,28000000000,3375368356
117483497490,1642221002,340057,118983497490,340057,164833943198,1500000000,1500000000
159885104525,1642002835,67646,161385104525,62846,171646792170,1500000000,1500000000
21149912689,1647505368,55668,22649912689,50868,25001948354,1500000000,1500000000
33008290163,1647857750,48651,34508290163,43851,46282977384,1500000000,1500000000
143986232738,1641179395,330461,145486232738,330461,158349204000,1500000000,1500000000
33983141726,1647919923,60862,35483141726,60862,52330636943,1500000000,1500000000
99850839142,1647532501,67622,101350839142,62822,117950257668,1500000000,1500000000
55291367381,1646604518,67646,56791367381,62846,82768117188,1500000000,1500000000
36435509779,1647872919,55660,37935509779,50860,47412584370,1500000000,1500000000
46553157044,1647034170,330507,48053157044,330507,63858296872,1500000000,1500000000
172721229256,1642263586,56516,174221229256,51716,211861276595,1500000000,1500000000
98289703424,1642247982,66730,99789703424,66730,111903782304,1500000000,1500000000
45754409323,1647909739,67634,47254409323,67634,59068736300,1500000000,1500000000
44068315287,1649687555,337490,45449822723,337490,45449822723,1500000000,1381507436
43552515021,1647904709,67634,45052515021,67634,48584240023,1500000000,1500000000
68606584542,1647880025,60850,70106584542,56050,74192392974,1500000000,1500000000
126775423033,1641966295,60862,128275423033,56062,174931349385,1500000000,1500000000
36257256295,1647957561,67634,37757256295,62834,43133251737,1500000000,1500000000
27636994076,1649641485,327958,28799639218,327958,28799639218,1500000000,1162645142
85537960529,1642246624,331075,87037960529,331075,98071354968,1500000000,1500000000
187548151431,1642026444,60850,189048151431,56050,209000656862,1500000000,1500000000
16878482344,1646975160,331169,18000000000,331169,18000000000,1500000000,1121517656
101520135695,1641169701,54848,103020135695,50048,120527571053,1500000000,1500000000
38378180931,1647882921,67646,39878180931,62846,45465050414,1500000000,1500000000
14710979724,1647863801,67646,16210979724,62846,21955673082,1500000000,1500000000
85588221276,1641195410,334344,87088221276,334344,95423972086,1500000000,1500000000
93571367362,1641248581,66778,95071367362,66778,113334200848,1500000000,1500000000
58040796641,1649692771,48615,59540796641,43815,60000000000,1500000000,1500000000
14983350070,1647848194,67622,16483350070,67622,22210202662,1500000000,1500000000
115001150772,1642264443,55636,117501150772,55636,236133441894,2500000000,2500000000
117326595392,1642213064,60850,118826595392,56050,178750025157,1500000000,1500000000
63426885663,1647974629,67646,64926885663,62846,86154268364,1500000000,1500000000
20844982686,1647505696,67634,22344982686,62834,28418795067,1500000000,1500000000
26516919062,1646958515,67634,28000000000,62834,28000000000,25000000000,1483080938
124209722233,1642236892,55592,125709722233,50792,152250366655,1500000000,1500000000
44320941523,1647966401,67622,45760941523,67622,46305607473,1440000000,1440000000
20851707482,1647507091,67634,22351707482,67634,24952080950,1500000000,1500000000
118928660966,1642238556,67658,120428660966,62858,141825955529,1500000000,1500000000
96870579176,1642255780,55648,99370579176,55648,219005356006,2500000000,2500000000
171624888311,1642272100,67634,173624888311,67634,209313614474,2000000000,2000000000
65639849163,1641215072,54703,67139849163,54703,85429634883,1500000000,1500000000
44865306448,1647919332,56492,46365306448,51692,62222595019,1500000000,1500000000
26221371358,1649663449,67634,27721371358,67634,30708262128,1500000000,1500000000
25310528436,1647483421,324216,27310528436,324216,41374102702,2000000000,2000000000
19341133762,1647855160,60862,20841133762,56062,25522639832,1500000000,1500000000
18671286834,1646994583,60850,20171286834,60850,27996802342,1500000000,1500000000
21802308360,1647921093,67634,25000000000,67634,25000000000,25000000000,3197691640
56104594581,1649709929,55668,57604594581,55668,66168177090,1500000000,1500000000
43029205848,1649656967,66754,44529205848,61954,47128553042,1500000000,1500000000
22921926976,1646557942,67634,24421926976,62834,36881481213,1500000000,1500000000
41801694022,1647892242,316620,43301694022,316620,57291187602,1500000000,1500000000
108078643946,1641989066,54848,109488643946,50048,112000000000,1410000000,1410000000
121856869105,1641983665,60850,123356869105,56050,143578191009,1500000000,1500000000
62354386588,1649697015,63200,63854386588,63200,108126800470,1500000000,1500000000
22140870948,1649658272,48723,23640870948,43923,37241369122,1500000000,1500000000
31323371913,1647488810,67634,32823371913,62834,40490116667,1500000000,1500000000
20508596933,1646569466,340055,22508596933,340055,23478618026,2000000000,2000000000
13103206796,1647847870,56504,14603206796,51704,20086151734,1500000000,1500000000
88037292307,1642241043,63188,89537292307,53588,121190876270,1500000000,1500000000
88037292307,1642241043,60862,89537292307,56062,121190876270,1500000000,1500000000
89072194473,1641178818,67646,90572194473,62846,118975068682,1500000000,1500000000
155271227715,1641995795,67634,156921227715,67634,175000000000,1650000000,1650000000
33471905504,1647919972,60850,34971905504,60850,40823222792,1500000000,1500000000
23776156433,1649675638,59970,25276156433,59970,38085684007,1500000000,1500000000
23776156433,1649675638,59970,25276156433,59970,72927643215,1500000000,1500000000
23776156433,1649675638,59970,24776156433,55170,30000000000,1000000000,1000000000
25272075675,1647026790,52916,26772075675,52916,32948390462,1500000000,1500000000
143711592137,1642207390,67634,145211592137,62834,183966209618,1500000000,1500000000
137675387259,1642277571,56504,139175387259,51704,217221894134,1500000000,1500000000
101844426298,1641984045,60850,103344426298,56050,163144649739,1500000000,1500000000
114544057986,1641989671,67634,116044057986,67634,177022519874,1500000000,1500000000
54600893395,1649681879,60950,56100893395,56150,65960054743,1500000000,1500000000
91272470491,1647538799,327970,93272470491,327970,121701301119,2000000000,2000000000
29099011173,1647881628,313377,30599011173,313377,42774196323,1500000000,1500000000
159885336449,1641228599,67622,161385336449,62822,186890724092,1500000000,1500000000
46311818812,1641199717,316594,49311818812,316594,51000000000,3000000000,3000000000
109395340039,1641979148,49483,110895340039,49483,146811490707,1500000000,1500000000
162936578701,1641966035,55580,164436578701,50780,194778020123,1500000000,1500000000
18371279688,1646567466,67646,20371279688,67646,24964273616,2000000000,2000000000
53247504872,1647891576,56504,54747504872,51704,68206802624,1500000000,1500000000
29408059144,1647858122,59994,30908059144,55194,34077557413,1500000000,1500000000
15755822316,1646988094,67622,17255822316,62822,19704017637,1500000000,1500000000
125580435596,1642275575,335592,127080435596,335592,165215920208,1500000000,1500000000
99894670985,1641226154,60862,101394670985,56062,129258961763,1500000000,1500000000
78026120027,1641209588,333720,79526120027,333720,110563106992,1500000000,1500000000
119491475540,1641960542,60850,120991475540,60850,176216340650,1500000000,1500000000
27873615243,1647920675,340017,28375528484,340017,28375528484,1316000000,501913241
37147814941,1649679446,60090,38647814941,55290,39200234780,1500000000,1500000000
24630710989,1647835450,67617,25000000000,67617,25000000000,1500000000,369289011
31806015524,1647025305,60838,33306015524,60838,42165550399,1500000000,1500000000
33305718230,1647947445,67634,34805718230,67634,53442938964,1500000000,1500000000
62946917237,1647968980,324844,64446917237,324844,84545392170,1500000000,1500000000
27915094427,1649674562,310237,29415094427,310237,50000000000,1500000000,1500000000
17908944809,1646535528,67622,19408944809,67622,23246045590,1500000000,1500000000
18474252134,1647848111,333113,19974252134,333113,21028035402,1500000000,1500000000
52631222925,1644413438,314120,54131222925,314120,67977950927,1500000000,1500000000
61080476739,1644100921,334302,62580476739,334302,82934998820,1500000000,1500000000
132145716074,1644426130,316700,133645716074,316700,154348290204,1500000000,1500000000
84426086313,1644418744,77491,85926086313,77491,107120097022,1500000000,1500000000
175940370974,1643208856,335574,177440370974,335574,224930547657,1500000000,1500000000
166777274702,1643242574,322981,168277274702,322981,210009478234,1500000000,1500000000
55419403473,1644411422,55620,56919403473,50820,70787504647,1500000000,1500000000
55419403473,1644411422,55644,57919403473,55644,115249685804,2500000000,2500000000
55861899001,1644043767,56480,57361899001,56480,80840533993,1500000000,1500000000
75150705502,1644369498,67646,76650705502,62846,101357904789,1500000000,1500000000
57315706184,1644405032,67634,58815706184,62834,66180286965,1500000000,1500000000
200411321680,1643305878,330519,201911321680,330519,256012338387,1500000000,1500000000
46274217608,1644399426,55608,47774217608,50808,60295417190,1500000000,1500000000
46129184479,1644404869,55608,47629184479,50808,53478031155,1500000000,1500000000
78878926044,1643164784,60862,80378926044,56062,112023852064,1500000000,1500000000
94896988717,1643258577,349578,96396988717,349578,131826050463,1500000000,1500000000
152039572625,1643330288,310247,153539572625,310247,193054844297,1500000000,1500000000
188784678801,1643317393,331155,190000000000,331155,190000000000,2000000000,1215321199
82535402535,1644035515,67646,84535402535,62846,118188384363,2000000000,2000000000
147987594671,1643221715,62151,149487594671,57351,197674492709,1500000000,1500000000
201881967934,1644444458,326056,203381967934,326056,211818555829,1500000000,1500000000
55907661265,1644376617,340033,56907661265,340033,58000000000,1000000000,1000000000
90107784956,1643262490,67634,91607784956,62834,110978893904,1500000000,1500000000
157441849153,1643316012,314162,158941849153,314162,204068114499,1500000000,1500000000
61625453319,1644045030,55705,63125453319,50905,87494733219,1500000000,1500000000
98062884538,1643197472,319677,99562884538,319677,130653833003,1500000000,1500000000
104675207931,1644439462,54332,106175207931,49532,142627526070,1500000000,1500000000
62708228477,1644402787,55644,65208228477,55644,136608021900,2500000000,2500000000
43467744661,1644040884,305950,44967744661,305950,50000000000,1500000000,1500000000
145663861028,1644442292,60850,147163861028,56050,187500329088,1500000000,1500000000
88072153212,1644030424,336871,89572153212,336871,113352461653,1500000000,1500000000
162035952260,1643205688,67634,163535952260,62834,183363632300,1500000000,1500000000
82454710084,1643261896,329278,97056481789,329278,,,
57854045191,1644062427,52928,59354045191,48128,64623753902,1500000000,1500000000
124233056550,1643281502,59982,125733056550,55182,139545928482,1500000000,1500000000
44641740857,1644381807,296374,45000000000,296374,45000000000,3000000000,358259143
197385117602,1643205844,340069,198885117602,340069,204044940325,1500000000,1500000000
130686384364,1643330376,329887,132186384364,329887,163943765647,1500000000,1500000000
167914480902,1643234128,331420,169414480902,331420,214332975942,1500000000,1500000000
46119511778,1644405060,54332,47619511778,49532,70312978800,1500000000,1500000000
112469097647,1643342229,304628,113969097647,304628,130002082790,1500000000,1500000000
216424635940,1644437675,67634,218266432835,62834,395087032185,1841796895,1841796895
276804401113,1643407846,60850,279229401113,56050,288046652984,2425000000,2425000000
125787049379,1643403281,60850,127287049379,56050,179726202128,1500000000,1500000000
125787049379,1643403281,300184,127287049379,300184,132412098977,1500000000,1500000000
80424754637,1644410631,67634,81924754637,62834,124631971348,1500000000,1500000000
85640969806,1644429048,337522,87140969806,337522,131619519165,1500000000,1500000000
115357159418,1643243149,67634,116857159418,67634,148774558977,1500000000,1500000000
58548961528,1644074234,331119,62003053707,331119,62003053707,62003053707,3454092179
61809185370,1644032960,343181,63309185370,343181,83780137287,1500000000,1500000000
102050355751,1643295246,346991,105085022493,346991,,,
120964390654,1644426175,54332,122464390654,49532,170633823330,1500000000,1500000000
134610169048,1643284475,67634,136110169048,62834,152350523353,1500000000,1500000000
58124083465,1644415737,54332,59624083465,49532,68077411439,1500000000,1500000000
122369737223,1643281792,60862,123869737223,56062,127097978605,1500000000,1500000000
57233247230,1644405858,55608,58733247230,50808,79740495147,1500000000,1500000000
88298163405,1644366784,67646,89798163405,62846,90000000000,1500000000,1500000000
103714970490,1643356049,67634,105214970490,62834,124721560830,1500000000,1500000000
130515120810,1643292909,60862,132015120810,56062,170876090393,1500000000,1500000000
99214394096,1644413012,55648,101714394096,55648,200660070058,2500000000,2500000000
144432142926,1644443085,54332,145932142926,49532,157707593877,1500000000,1500000000
233032170687,1643226193,337508,235032170687,337508,358335376527,2000000000,2000000000
85742042941,1644427606,320352,86987918941,320352,90000000000,1245876000,1245876000
40745237546,1644398157,54308,42745237546,49508,57267503306,2000000000,2000000000
48903560460,1644409442,55644,50403560460,50844,61197508160,1500000000,1500000000
74159545880,1643261794,328767,75659545880,328767,81000000000,1500000000,1500000000
73550980629,1644430276,328312,75050980629,328312,91974613109,1500000000,1500000000
72234500258,1644403287,55668,73734500258,50868,92320981413,1500000000,1500000000
73842346371,1644021747,336861,76020092102,336861,,,
53563224185,1644049527,60850,55063224185,56050,68470381565,1500000000,1500000000
92730187040,1643376985,349590,94380187040,349590,100457465644,1650000000,1650000000
113752045785,1643337423,331109,115252045785,331109,119773865129,1500000000,1500000000
58836580984,1644413984,60850,60336580984,56050,78558718413,1500000000,1500000000
50300017909,1644058394,67622,51800017909,67622,74228161578,1500000000,1500000000
145606056473,1643400793,54884,147106056473,50084,185131338352,1500000000,1500000000
96421183020,1643272754,343205,97921183020,343205,120379388984,1500000000,1500000000
208189653893,1643314478,326102,210189653893,326102,225297673061,2000000000,2000000000
189718371322,1643327661,60862,191218371322,56062,238416088025,1500000000,1500000000
228268627516,1643228108,343821,229768627516,343821,255133298213,1500000000,1500000000
91377049325,1644410846,55584,92877049325,50784,101674285558,1500000000,1500000000
91805236006,1643299226,60850,93305236006,56050,122915170018,1500000000,1500000000
91805236006,1643299226,55705,93305236006,50905,129651703605,1500000000,1500000000
44734099531,1644395563,54332,46234099531,49532,61893735090,1500000000,1500000000
148974365595,1644439008,336883,150474365595,336883,153119071164,1500000000,1500000000
108916269964,1644439595,328809,110416269964,328809,156109343663,1500000000,1500000000
108916269964,1644439595,55632,110416269964,55632,140572671067,1500000000,1500000000
128853195396,1643339858,335158,130353195396,335158,153581775448,1500000000,1500000000
89944039893,1644411015,56564,91444039893,51764,97551771615,1500000000,1500000000
130191150164,1644425915,326663,131691150164,326663,159387064583,1500000000,1500000000
69205887069,1644081409,67634,70000000000,67634,70000000000,70000000000,794112931
74716560281,1644068129,326156,76216560281,326156,103986054942,1500000000,1500000000
125352186287,1644443914,60862,126852186287,56062,129093259407,1500000000,1500000000
101147912664,1643269344,312393,102647912664,312393,133057674310,1500000000,1500000000
85808861118,1644027757,323638,87308861118,323638,113120286133,1500000000,1500000000
53523448749,1644409271,56576,55023448749,51776,73036050124,1500000000,1500000000
86591401726,1643196977,343803,88591401726,343803,102070147678,2000000000,2000000000
138116612023,1643399029,307839,139616612023,307839,167170196318,1500000000,1500000000
60716282667,1644385863,323010,62216282667,323010,68968515508,1500000000,1500000000
60716282667,1644385863,334306,62216282667,334306,76359201669,1500000000,1500000000
119366661573,1643260543,307092,120866661573,307092,143398835317,1500000000,1500000000
76829130727,1644031040,60862,78479130727,56062,105718759917,1650000000,1650000000
91001804562,1644447134,55620,92501804562,55620,113634245177,1500000000,1500000000
45395922822,1644401999,55668,46895922822,50868,52423638633,1500000000,1500000000
87593144146,1644369410,60862,89093144146,56062,112817878519,1500000000,1500000000
87593144146,1644369410,343329,89093144146,312117,92000000000,1500000000,1500000000
60130400261,1644384962,337464,61630400261,337464,83205646583,1500000000,1500000000
60130400261,1644384962,340017,61630400261,340017,79277438889,1500000000,1500000000
64591337206,1644389340,315310,66091337206,315310,80967906533,1500000000,1500000000
72507683847,1644062570,67634,74007683847,62834,105082405495,1500000000,1500000000
46337665675,1644397754,55588,47837665675,50788,73323761683,1500000000,1500000000
91582627818,1643284818,289861,93082627818,289861,121332402188,1500000000,1500000000
152383125044,1643242137,343831,153883125044,343831,206807533784,1500000000,1500000000
51370774102,1644450290,67634,52890774102,62834,62129737588,1520000000,1520000000
98340700125,1643371506,60862,99840700125,56062,100192771390,1500000000,1500000000
94049967581,1644373224,337500,95549967581,337500,109090536723,1500000000,1500000000
71910395770,1644033670,60850,73410395770,56050,78520373814,1500000000,1500000000
71910395770,1644033670,67634,73410395770,62834,78520373814,1500000000,1500000000
49185035361,1644397885,55584,50685035361,50784,54000000000,1500000000,1500000000
187128568398,1643318306,346366,188628568398,346366,221564353547,1500000000,1500000000
164359006462,1643321603,302619,165859006462,302619,180422432150,1500000000,1500000000
83714769024,1643192557,343857,85714769024,343857,95000000000,2000000000,2000000000
67388500082,1643374801,321654,68888500082,321654,92086878650,1500000000,1500000000
153243875437,1643330283,310269,154743875437,310269,156036819199,1500000000,1500000000
106950291524,1643405044,67634,108950291524,62834,139976325073,2000000000,2000000000
47957540751,1644057186,67634,49457540751,67634,71309096725,1500000000,1500000000
127839295393,1644422808,55705,129839295393,50905,160931470627,2000000000,2000000000
181530332340,1643324031,67634,183030332340,62834,224157341243,1500000000,1500000000
102508535525,1643165117,54945,102759101893,50145,102759101893,1500000000,250566368
79700702496,1643259557,54322,81700702496,54322,83000000000,2000000000,2000000000
48911209704,1644371093,340681,50411209704,340681,50732058940,1500000000,1500000000
186182074869,1643316615,52928,187682074869,48128,189875315443,1500000000,1500000000
85894943358,1643280351,60850,87394943358,56050,110589928030,1500000000,1500000000
53295128390,1644378007,49483,54795128390,49483,83161788903,1500000000,1500000000
49601659581,1644406143,55644,52101659581,55644,107525050238,2500000000,2500000000
48314988072,1644395536,54332,49814988072,49532,70389099783,1500000000,1500000000
284300695182,1643303741,67722,285836329316,62922,295641521469,1535634134,1535634134
159812091158,1643309522,67634,161312091158,67634,227822113830,1500000000,1500000000
59041850087,1644062622,67634,60541850087,67634,64623753902,1500000000,1500000000
53393183001,1644407447,314873,54893183001,314873,73596942048,1500000000,1500000000
111276971967,1644030178,54861,113776971967,54861,204808347898,2500000000,2500000000
60268867893,1644049507,67634,61768867893,62834,64020862694,1500000000,1500000000
142025240875,1643354059,333720,143525240875,333720,180232880468,1500000000,1500000000
83487213282,1643375066,67646,84987213282,62846,89031997125,1500000000,1500000000
83738835772,1644093407,54533,85238835772,49733,103913121543,1500000000,1500000000
56425846952,1644044082,60862,57925846952,56062,66374577619,1500000000,1500000000
199982668457,1643303904,340655,201482668457,340655,283898555853,1500000000,1500000000
83627429765,1643191051,67622,85127429765,67622,107621929213,1500000000,1500000000
68372762668,1644449955,331173,69872762668,331173,93774567624,1500000000,1500000000
127226100226,1643272223,329875,128636100226,329875,132274603170,1410000000,1410000000
194584328545,1643409121,55705,196084328545,50905,253222204740,1500000000,1500000000
178484099632,1644444725,54320,179984099632,49520,187350666589,1500000000,1500000000
95440597062,1643202622,326123,96940597062,326123,125403076664,1500000000,1500000000
38544976240,1644401926,55608,40044976240,50808,55492740055,1500000000,1500000000
85400742927,1644410822,55644,87900742927,55644,162778856892,2500000000,2500000000
34089448653,1644398011,55668,35589448653,50868,52349919262,1500000000,1500000000
213733881562,1643300647,321873,215233881562,321873,218603396595,1500000000,1500000000
50050605045,1644414697,316494,51550605045,316494,51961897760,1500000000,1500000000
60094478668,1644382031,322927,61594478668,322927,69255056390,1500000000,1500000000
124432452547,1644446739,67646,126432452547,62846,176485349787,2000000000,2000000000
70199223655,1644368906,54813,71699223655,50013,78699703039,1500000000,1500000000
77160226814,1644082077,52928,78856106052,48128,87897368194,1695879238,1695879238
71813857156,1644043175,55580,73223857156,55580,83085591255,1410000000,1410000000
42781496909,1644386290,55668,44281496909,50868,68312191044,1500000000,1500000000
40159702651,1644373970,67646,48169238634,62846,,,
104966437110,1643160329,332037,106466437110,332037,120000000000,1500000000,1500000000
53569783690,1644393652,309172,55069783690,309172,66130551289,1500000000,1500000000
55790147945,1650569686,67634,57290147945,67634,60713825802,1500000000,1500000000
22559525673,1646457010,52928,24059525673,48128,27630092143,1500000000,1500000000
46913225990,1650733905,67622,48413225990,67622,51205290949,1500000000,1500000000
28058293674,1650703755,55644,29558293674,55644,45848786592,1500000000,1500000000
28058293674,1650703755,67646,29558293674,62846,31948251760,1500000000,1500000000
58836212406,1650573179,317254,60336212406,317254,73055565294,1500000000,1500000000
126643829718,1642891864,322965,128143829718,322965,160493455250,1500000000,1500000000
107028654010,1642868669,298999,108274530010,298999,109133530563,1245876000,1245876000
42404331415,1650733674,64144,43904331415,59344,50849481684,1500000000,1500000000
34928715864,1650720659,334314,36428715864,334314,42728474515,1500000000,1500000000
42692081749,1650527758,67646,44692081749,62846,57517147018,2000000000,2000000000
72999387081,1650573606,60862,74499387081,56062,81657135627,1500000000,1500000000
29831240922,1650117061,340665,31331240922,340665,38285220632,1500000000,1500000000
37151856238,1650083719,330503,38651856238,330503,58325740554,1500000000,1500000000
23690164608,1650075188,340005,25190164608,340005,31255009563,1500000000,1500000000
25163281634,1650121927,59982,26663281634,55182,29459264922,1500000000,1500000000
69292746405,1646452048,55592,70792746405,50792,96872649897,1500000000,1500000000
43882980917,1650739812,67646,45382980917,62846,56347115995,1500000000,1500000000
56621118735,1650557943,59934,58121118735,55134,64185615167,1500000000,1500000000
19572461414,1650716371,67646,21072461414,62846,31284943773,1500000000,1500000000
38743570068,1650694513,67646,40243570068,62846,53007944507,1500000000,1500000000
18007247597,1646471362,322450,19507247597,322450,25581779787,1500000000,1500000000
47139811555,1650735102,321620,48639811555,321620,66943254660,1500000000,1500000000
37621729945,1650549228,60850,39121729945,60850,46718888878,1500000000,1500000000
48228929380,1650551474,60850,49728929380,56050,53390555518,1500000000,1500000000
134042725275,1642876791,336875,137042725275,336875,140000000000,3000000000,3000000000
29068953606,1650137479,334250,30568953606,334250,34394391840,1500000000,1500000000
58835410084,1646442872,52916,60835410084,48116,90825408362,2000000000,2000000000
42480614024,1650694251,67646,43980614024,62846,49290891150,1500000000,1500000000
27707523477,1650531048,55693,29207523477,50893,39201944217,1500000000,1500000000
139442526426,1642828971,67634,140942526426,67634,175772540654,1500000000,1500000000
145721442174,1642875954,64741,147221442174,59941,205921871593,1500000000,1500000000
15400050337,1650113932,55592,16900050337,50792,26616566002,1500000000,1500000000
33864244301,1650128994,55680,35364244301,50880,39691116709,1500000000,1500000000
77966919170,1650559065,67634,79466919170,67634,106481352855,1500000000,1500000000
47286834407,1650546927,60850,48786834407,56050,51000000000,1500000000,1500000000
38632720987,1650523852,60030,39035592288,55230,39035592288,1030624873,402871301
64644245183,1650574680,67734,66144245183,62934,87065280684,1500000000,1500000000
111541125674,1642870247,60838,113041125674,60838,158268373197,1500000000,1500000000
46831722022,1650725603,67646,48331722022,62846,72501448539,1500000000,1500000000
31891992883,1650677546,67646,33015226182,62846,33015226182,1500000000,1123233299
194924461248,1642811104,122041,196924461248,117241,345951632234,2000000000,2000000000
149486798855,1642812275,95126,150000000000,95126,,,
149486798855,1642812275,316610,150366927677,316610,150366927677,1500000000,880128822
22449715833,1650142759,48615,23949715833,43815,31844999527,1500000000,1500000000
37039806909,1650121092,64044,38539806909,64044,38711786243,1500000000,1500000000
21206889462,1650074681,479605,23200000000,319737,,,
42669737083,1646515761,60850,44169737083,56050,44482636179,1500000000,1500000000
23637706410,1650714411,55705,25137706410,50905,31312038123,1500000000,1500000000
29582721744,1650686552,67622,31082721744,67622,56513967448,1500000000,1500000000
44402963395,1650741434,67646,45902963395,62846,52379392850,1500000000,1500000000
46920816123,1650553572,66814,48420816123,62014,67108687738,1500000000,1500000000
55602636044,1650552963,60862,57102636044,56062,70780503292,1500000000,1500000000
73904854844,1650510744,60006,75904854844,55206,122018180046,2000000000,2000000000
57427275062,1650580951,60862,58927275062,56062,62148097683,1500000000,1500000000
27026306011,1650700545,55668,28526306011,50868,32012479597,1500000000,1500000000
39634165028,1650682736,55705,41134165028,50905,58678046938,1500000000,1500000000
25197063532,1650746250,49483,26697063532,44683,32456289687,1500000000,1500000000
182235013236,1642872776,55580,183735013236,55580,201604979312,1500000000,1500000000
30360339525,1650142086,67634,31860339525,62834,36003145819,1500000000,1500000000
29769428994,1650120999,60850,31269428994,56050,46623631428,1500000000,1500000000
29992559875,1650676884,326836,31492559875,326836,36774057668,1500000000,1500000000
83839367643,1650555592,66706,85339367643,66706,116402874797,1500000000,1500000000
137726297146,1642891741,337987,139226297146,331518,171920351614,1500000000,1500000000
19282319481,1650106867,343177,20782319481,343177,22216130070,1500000000,1500000000
31512000759,1650739636,66742,33012000759,61942,38696528243,1500000000,1500000000
77659547892,1650556404,60850,79069547892,56050,80000000000,1410000000,1410000000
18950758159,1650745876,67634,20950758159,67634,28506382099,2000000000,2000000000
52094360681,1646503059,55592,53594360681,50792,59647335020,1500000000,1500000000
107278021761,1650560322,67658,108778021761,62858,120710175090,1500000000,1500000000
33482144142,1650121504,60018,34982144142,55218,48164432833,1500000000,1500000000
21481814546,1650717785,67622,22981814546,62822,30659338523,1500000000,1500000000
46075469011,1650735129,67622,47575469011,62822,60424764444,1500000000,1500000000
80657040920,1650563225,60850,82157040920,56050,93457251734,1500000000,1500000000
228518591002,1642834465,334326,230018591002,334326,310284447890,1500000000,1500000000
228518591002,1642834465,336865,230018591002,336865,310284447890,1500000000,1500000000
139191441680,1642884017,322929,140691441680,322929,175917462510,1500000000,1500000000
38613448277,1650134846,67622,40113448277,67622,48018163645,1500000000,1500000000
29007162973,1646488112,48663,30507162973,48663,36382924189,1500000000,1500000000
29007162973,1646488112,67634,30507162973,67634,32509619724,1500000000,1500000000
132468202416,1642891990,334350,133968202416,334350,178117366875,1500000000,1500000000
216797959416,1642877854,343193,218297959416,343193,233847183907,1500000000,1500000000
23197242570,1650693118,55592,24697242570,50792,26000000000,1500000000,1500000000
46699087243,1650543994,60838,48199087243,60838,54904439797,1500000000,1500000000
48018747456,1650527106,55740,49518747456,50940,59627884682,1500000000,1500000000
139496284958,1642884379,322939,140996284958,322939,177171904234,1500000000,1500000000
122104800429,1642841560,337528,123754800429,337528,125000000000,1650000000,1650000000
21417667978,1650110093,322969,23000000000,322969,23000000000,1600000000,1582332022
25141995330,1646482095,59934,26641995330,55134,32739223032,1500000000,1500000000
42212875417,1650682056,67646,43712875417,62846,49019540242,1500000000,1500000000
131227015535,1642835182,122029,132727015535,122029,146856735118,1500000000,1500000000
23494400117,1650082645,319719,24994400117,319719,38708874465,1500000000,1500000000
40237436066,1650077046,55705,41737436066,50905,43360466149,1500000000,1500000000
71602987235,1650127096,325513,73102987235,325513,98276080464,1500000000,1500000000
75406192918,1650556518,67622,76906192918,62822,98813671432,1500000000,1500000000
100192838834,1642862965,327968,101692838834,327968,106513518870,1500000000,1500000000
32357369097,1650685968,67658,33857369097,62858,34174504068,1500000000,1500000000
32357369097,1650685968,322852,34357369097,322852,35981484231,2000000000,2000000000
22217238819,1650746506,320475,23717238819,320475,29617701038,1500000000,1500000000
91546634935,1650574986,67634,93046634935,62834,110730542789,1500000000,1500000000
126914761262,1642840323,319775,128414761262,319775,201762518187,1500000000,1500000000
172245809688,1642814666,314897,173745809688,314897,195507722113,1500000000,1500000000
23271427792,1650123488,60938,24771427792,56138,37344184795,1500000000,1500000000
29577770621,1650119303,67634,31077770621,62834,46629177069,1500000000,1500000000
24869270629,1650698334,91311,28000000000,56074,,,
33604739016,1650739244,60950,35019713828,56150,,,
30138512951,1650740605,67646,31638512951,62846,36029446948,1500000000,1500000000
55601492825,1650724884,340677,57101492825,340677,65835690760,1500000000,1500000000
28733974099,1650753771,67622,30233974099,67622,41404971394,1500000000,1500000000
103957595084,1650556342,67722,105457595084,62922,156344595802,1500000000,1500000000
103158933993,1642895952,67634,104658933993,67634,167049302040,1500000000,1500000000
21073508925,1650123489,52916,22573508925,52916,33447801360,1500000000,1500000000
39033285556,1650129537,63200,40533285556,63200,87791263226,1500000000,1500000000
60912662434,1650553902,60938,62371648524,56138,62371648524,1500000000,1458986090
113912221394,1642869583,48615,115412221394,43815,154907021360,1500000000,1500000000
55487526852,1650539235,60926,56987526852,60926,63153472102,1500000000,1500000000
71430108818,1650555887,54739,72930108818,49939,111420197379,1500000000,1500000000
42808590504,1650518685,305898,44308590504,305898,64194555684,1500000000,1500000000
28427894049,1650117072,343231,29927894049,343231,40415460835,1500000000,1500000000
20717249372,1650746814,323120,22217249372,323120,27000000000,1500000000,1500000000
22564539391,1650749893,349498,24064539391,349498,26899598455,1500000000,1500000000
48241596452,1650584285,67646,49741596452,62846,69581870993,1500000000,1500000000
53842791168,1650554970,64729,55492791168,59929,200000000000,1650000000,1650000000
41369025690,1650569185,67634,42869025690,67634,70039596032,1500000000,1500000000
52029913434,1650545666,67646,53529913434,62846,59596597764,1500000000,1500000000
28880845132,1650131243,316600,30380845132,316600,34403410135,1500000000,1500000000
24412595827,1650713264,49607,25614973095,44807,25614973095,1500000000,1202377268
20533742298,1650742945,60838,22033742298,60838,27198593285,1500000000,1500000000
31690195198,1650536156,67734,33190195198,62934,44977340923,1500000000,1500000000
45087351099,1650548527,54827,46587351099,50027,59316170004,1500000000,1500000000
57620527140,1650509049,67646,59120527140,62846,65522875145,1500000000,1500000000
28362177730,1650713790,56588,29862177730,51788,33327749789,1500000000,1500000000
155580211890,1642814792,60850,157080211890,56050,198495133994,1500000000,1500000000
37551475340,1650540706,67722,39051475340,67722,61389477504,1500000000,1500000000
28842069404,1650067283,59982,30342069404,55182,32606778352,1500000000,1500000000
27262548558,1650142908,67646,28762548558,62846,33844400729,1500000000,1500000000
18985255673,1650745223,59946,20485255673,55146,25955800558,1500000000,1500000000
26590370651,1650714445,326127,28090370651,326127,31312038123,1500000000,1500000000
83115738923,1650563089,66742,84615738923,61942,110560179724,1500000000,1500000000
20353175964,1650746685,66790,21853175964,66790,34660122840,1500000000,1500000000
24801389988,1650691762,54712,26301389988,49912,33185904375,1500000000,1500000000
22605658170,1650133623,55693,24605658170,50893,33814068817,2000000000,2000000000
26630961604,1650699810,101469,29000000000,62846,,,
28765215281,1646493740,60950,30265215281,56150,40999721858,1500000000,1500000000
30990162232,1650747631,67634,32490162232,67634,35935095553,1500000000,1500000000
37835981544,1650549493,67722,39335981544,67722,54449787385,1500000000,1500000000
30444028024,1650528581,67646,32444028024,62846,51679754804,2000000000,2000000000
56355774526,1650518397,66754,57855774526,61954,71269629987,1500000000,1500000000
35137752588,1650549357,56492,36637752588,56492,44843176159,1500000000,1500000000
56347832830,1650576522,67646,57847832830,62846,62919248399,1500000000,1500000000
67520737708,1650579282,60850,69520737708,60850,101229709018,2000000000,2000000000
26049401872,1646492720,60926,27549401872,60926,38150079250,1500000000,1500000000
41000203846,1650734454,67722,42500203846,67722,55798151214,1500000000,1500000000
200042986809,1642867866,334360,201542986809,334360,216854167654,1500000000,1500000000
200042986809,1642867866,322961,201542986809,322961,216854167654,1500000000,1500000000
39024168465,1650120491,55705,40524168465,50905,44864765930,1500000000,1500000000
34972413243,1646493123,55604,36472413243,50804,47083429548,1500000000,1500000000
132655993467,1642842141,320485,134155993467,320485,136337652839,1500000000,1500000000
24770601940,1650743953,67646,26270601940,67646,33370212993,1500000000,1500000000
59840757498,1650553118,60850,61840757498,60850,64213248051,2000000000,2000000000
41177320837,1650509331,55592,42677320837,50792,46170008517,1500000000,1500000000
22874740184,1650712456,48591,24374740184,48591,28215190414,1500000000,1500000000
22874740184,1650712456,67622,24374740184,67622,28215190414,1500000000,1500000000
128751522587,1642859143,317222,130251522587,317222,135102256912,1500000000,1500000000
128751522587,1642859143,322951,130251522587,322951,135102256912,1500000000,1500000000
25366825259,1646492958,319687,26866825259,319687,28791628683,1500000000,1500000000
48761411786,1650724939,67622,50261411786,67622,72171643829,1500000000,1500000000
60805785836,1650537873,67734,62305785836,62934,64475231918,1500000000,1500000000
37661448426,1650545121,326776,39161448426,326776,50266658293,1500000000,1500000000
37661448426,1650545121,67734,39661448426,67734,52717324625,2000000000,2000000000
32640654129,1650536455,66766,34140654129,61966,50760764140,1500000000,1500000000
61968929971,1650510453,66754,63968929971,66754,85059088683,2000000000,2000000000
38668107203,1650732397,101469,41000000000,62846,,,
35145105039,1650519461,67634,36645105039,67634,50430084818,1500000000,1500000000
132854132338,1642816160,330485,134354132338,330485,161023764684,1500000000,1500000000
23723072451,1650116924,67722,25223072451,67722,27784890494,1500000000,1500000000
22757403665,1646460378,307060,23393870149,307060,23393870149,1000000000,636466484
51763861830,1650724403,67646,53263861830,62846,55876102677,1500000000,1500000000
31120784944,1650682517,60838,32620784944,60838,39343837004,1500000000,1500000000
215642165429,1642867965,52916,217142165429,48116,251553733512,1500000000,1500000000
34907235283,1650685406,60838,36407235283,56038,54751739694,1500000000,1500000000
64054886890,1650557274,60862,65554886890,56062,72672651707,1500000000,1500000000
64054886890,1650557274,60850,65554886890,60850,82133841660,1500000000,1500000000
257939626838,1642878710,66814,259840204485,66814,325171975735,1900577647,1900577647
35445924270,1650739667,59958,36516655315,55158,36516655315,1500000000,1070731045
35637336863,1650533634,54848,37137336863,54848,46758230598,1500000000,1500000000
207136441663,1642847561,67646,208636441663,62846,307907487417,1500000000,1500000000
25156611891,1650738270,55580,26656611891,50780,36206701363,1500000000,1500000000
55985413413,1650510936,67722,57485413413,62922,82594696790,1500000000,1500000000
154658699918,1642833964,330565,156158699918,330565,195395522253,1500000000,1500000000
34065272918,1650679252,60862,35565272918,56062,57053629653,1500000000,1500000000
30694638400,1650680097,55592,32194638400,50792,38728537733,1500000000,1500000000
33636610882,1650532006,55693,35136610882,50893,43351112233,1500000000,1500000000
46219756712,1650545038,323612,47719756712,323612,48097049755,1500000000,1500000000
60501335946,1650585141,83388,64000000000,50792,,,
21051988828,1650080238,54748,22551988828,49948,27546146314,1500000000,1500000000
22916841461,1650075233,334252,24416841461,334252,29890247463,1500000000,1500000000
29230954242,1650735744,67722,30730954242,62922,38733906690,1500000000,1500000000
53074592019,1650583322,60838,54574592019,60838,71518315375,1500000000,1500000000
151138621490,1642837501,318484,152638621490,318484,186810062399,1500000000,1500000000
24791393621,1646488189,313487,26291393621,313487,35393816474,1500000000,1500000000
27918269153,1650683268,55740,29418269153,50940,39032577733,1500000000,1500000000
31355086763,1650691252,67634,32855086763,67634,36354118480,1500000000,1500000000
61438696694,1650575895,67646,62938696694,62846,92069941379,1500000000,1500000000
49432091076,1650552953,67634,50932091076,67634,64520422212,1500000000,1500000000
65950938592,1650558523,55680,67450938592,50880,82031357133,1500000000,1500000000
30431539462,1650683187,66766,31561226397,66766,31561226397,1500000000,1129686935
31839871095,1650534553,56576,33339871095,51776,42583830082,1500000000,1500000000
148119781114,1650561252,67646,149619781114,62846,162088360542,1500000000,1500000000
18648393668,1650111711,55693,20148393668,50893,22602996814,1500000000,1500000000
21036913337,1650747037,67634,22536913337,62834,29881110805,1500000000,1500000000
44703542010,1650534305,66754,46203542010,66754,59095825488,1500000000,1500000000
71314742662,1650567188,67634,72814742662,67634,97525688044,1500000000,1500000000
16293966024,1650103704,67734,17793966024,62934,23620097823,1500000000,1500000000
63410520354,1650558282,67734,64910520354,62934,75741466193,1500000000,1500000000
171258606273,1642842519,321835,172758606273,321835,242789760850,1500000000,1500000000
117978925443,1642863228,323662,119478925443,323662,147500612255,1500000000,1500000000
165461901470,1642876435,337486,166961901470,337486,222362815258,1500000000,1500000000
38279763753,1650694048,339997,39360258617,339997,39360258617,1500000000,1080494864
25726030272,1650699444,340049,27226030272,340049,30934657309,1500000000,1500000000
138039997630,1642877542,340645,139539997630,340645,171738993719,1500000000,1500000000
134323202516,1642821960,325657,135823202516,325657,159401439842,1500000000,1500000000
120432389649,1642866436,326094,121932389649,326094,157194832890,1500000000,1500000000
105313698468,1642873796,340051,106813698468,340051,113100000000,1500000000,1500000000
14436354625,1650109385,60862,15936354625,56062,20989724812,1500000000,1500000000
18907444151,1646467561,67646,20407444151,62846,23228291584,1500000000,1500000000
31220929179,1650727131,54736,32720929179,49936,46890299579,1500000000,1500000000
24235463596,1650705588,67634,25735463596,62834,31063515770,1500000000,1500000000
42219079055,1650569198,67646,43719079055,58046,74096903637,1500000000,1500000000
22139517480,1650753291,67646,24139517480,62846,33453698796,2000000000,2000000000
115976504974,1642864542,319321,117476504974,319321,121000000000,1500000000,1500000000
198584612973,1642877314,64729,200084612973,59929,266686951587,1500000000,1500000000
26171225846,1650718660,336865,27671225846,336865,32253725074,1500000000,1500000000
23160300574,1650710184,67634,24660300574,67634,30232030792,1500000000,1500000000
22489883354,1650718807,343181,23989883354,343181,31549590737,1500000000,1500000000
50921014731,1650573400,49483,52421014731,49483,81164172485,1500000000,1500000000
39279740687,1650546345,60838,40779740687,60838,41000000000,1500000000,1500000000
58446115034,1650510351,60850,59946115034,60850,90717381978,1500000000,1500000000
54087657170,1650584380,60850,55587657170,56050,73899345308,1500000000,1500000000
34179012271,1650118843,59982,35679012271,55182,39428635233,1500000000,1500000000
48582520767,1650727372,60862,50082520767,56062,69850538439,1500000000,1500000000
36809403896,1650696967,67646,38309403896,62846,47455564553,1500000000,1500000000
36809403896,1650696967,60950,38309403896,56150,47455564553,1500000000,1500000000
55632284169,1650552547,55705,57132284169,50905,73694306308,1500000000,1500000000
28139075940,1650721691,67634,29639075940,62834,32784003682,1500000000,1500000000
40456875134,1650694385,55680,41956875134,50880,49792528474,1500000000,1500000000
31339813286,1650736278,67734,32839813286,62934,37066143572,1500000000,1500000000
84652706643,1650510717,48639,86652706643,43839,107020402246,2000000000,2000000000
61589348450,1650580455,60850,63089348450,56050,81019680075,1500000000,1500000000
136001819818,1642840404,67646,137501819818,67646,182240101557,1500000000,1500000000
40921768523,1650724280,340003,42421768523,340003,55228761874,1500000000,1500000000
44812246315,1650547325,339993,46312246315,339993,53100015842,1500000000,1500000000
24766558831,1650096506,331133,26266558831,331133,31896056963,1500000000,1500000000
29912809354,1650128826,67622,31912809354,67622,35729840836,2000000000,2000000000
48086666008,1646497874,55592,49586666008,50792,63536874349,1500000000,1500000000
43683220689,1650548695,336857,45183220689,336857,70818833857,1500000000,1500000000
23702917081,1650075906,67722,25202917081,62922,29635088467,1500000000,1500000000
27228538103,1650097196,334266,28728538103,334266,37836434494,1500000000,1500000000
27228538103,1650097196,59994,29228538103,55194,39789891874,2000000000,2000000000
26030267185,1650696124,326085,27730267185,326085,31189136949,1700000000,1700000000
27993325364,1650744835,340023,29493325364,340023,35312600133,1500000000,1500000000
33315291086,1650698549,60862,34815291086,56062,35197060433,1500000000,1500000000
85101144174,1650542770,60850,86775931056,60850,96297270532,1674786882,1674786882
14830564698,1650109026,48627,16330564698,43827,21490690204,1500000000,1500000000
32337151282,1650120362,55636,33837151282,55636,70553190362,1500000000,1500000000
32813877279,1650703118,67634,34313877279,67634,41062143507,1500000000,1500000000
111635436413,1642825799,60862,113135436413,56062,155901423760,1500000000,1500000000
19311190703,1650149985,349490,20811190703,349490,25551969608,1500000000,1500000000
28073722732,1646465891,316500,30073722732,316500,40428448811,2000000000,2000000000
18627016773,1650710192,67646,20627016773,62846,21000000000,2000000000,2000000000
44405401368,1650519317,323584,45905401368,323584,56015001517,1500000000,1500000000
57964725115,1650552160,67646,59464725115,62846,79322125950,1500000000,1500000000
25848649974,1650115958,67634,27348649974,62834,30222936630,1500000000,1500000000
17122911962,1646477003,300184,18622911962,300184,22893301910,1500000000,1500000000
23093690510,1650690968,336871,24593690510,336871,29627721327,1500000000,1500000000
29572856419,1650740694,67634,31072856419,62834,42631960414,1500000000,1500000000
37052511321,1650533700,55705,38552511321,50905,51607271047,1500000000,1500000000
42705497706,1650527743,321624,44205497706,321624,50966010012,1500000000,1500000000
35793188552,1650119442,49571,37293188552,49571,56005296697,1500000000,1500000000
18995165503,1650150535,343809,20495165503,343809,24949355270,1500000000,1500000000
35168068216,1646450714,55580,36668068216,50780,39000000000,1500000000,1500000000
107030314838,1642856359,322448,108246971703,322448,108246971703,1500000000,1216656865
57976060535,1650571767,67622,59476060535,67622,80344440405,1500000000,1500000000
145259286372,1642872651,122041,147259286372,117241,154303121125,2000000000,2000000000
22763793680,1650090566,49507,24263793680,49507,31334287180,1500000000,1500000000
25563037227,1646494422,55592,26563037227,50792,30007585069,1000000000,1000000000
17714506052,1650711786,55580,19214506052,50780,28078651442,1500000000,1500000000
31105107453,1650687335,60838,32649897054,60838,46861579730,1544789601,1544789601
83709831616,1650566575,67634,85209831616,67634,91410990058,1500000000,1500000000
226385013105,1642845490,333716,227885013105,333716,261520269428,1500000000,1500000000
19702604474,1650097664,60926,21202604474,60926,23596841008,1500000000,1500000000
47736110176,1650684333,66778,49236110176,61978,61643980062,1500000000,1500000000
132997787241,1642827253,67634,134497787241,62834,156135932582,1500000000,1500000000
19624479795,1646460773,60838,21124479795,60838,29209910855,1500000000,1500000000
47347861058,1646521200,67622,48847861058,67622,55812086695,1500000000,1500000000
30756893394,1650692680,333678,32256893394,333678,40021219755,1500000000,1500000000
15087881255,1646476090,317841,16587881255,317841,21580628338,1500000000,1500000000
20402926248,1650707646,67634,21902926248,62834,31701284308,1500000000,1500000000
82091111960,1650559004,300727,84091111960,300727,107256993260,2000000000,2000000000
75331507167,1650550773,60850,77331507167,60850,97370833409,2000000000,2000000000
29572110142,1650747434,66718,31072110142,66718,35394448997,1500000000,1500000000
19379898327,1650704168,60862,20879898327,56062,25000000000,1500000000,1500000000
41579893668,1650522311,64729,43079893668,59929,43620417219,1500000000,1500000000
33759514662,1650069130,343133,35409514662,343133,44635861065,1650000000,1650000000
23703913853,1650089946,67622,25203913853,67622,31054735672,1500000000,1500000000
29567254888,1650698699,59958,31067254888,59958,35065881823,1500000000,1500000000
24839988494,1650737718,60838,25848465414,60838,29754089781,1008476920,1008476920
30225978414,1650696527,67634,31725978414,62834,45129639365,1500000000,1500000000
99280575562,1642862690,312139,100780575562,312139,124103272295,1500000000,1500000000
99280575562,1642862690,305742,100780575562,305742,124103272295,1500000000,1500000000
20995189950,1650102921,60950,22495189950,56150,28731470638,1500000000,1500000000
32005237741,1650686400,67634,33121500477,62834,33121500477,1500000000,1116262736
178707531205,1642832261,122053,180707531205,117253,457130969261,2000000000,2000000000
43181247685,1650735105,55592,48139811555,50792,,,
43181247685,1650735105,67722,47236634522,62922,,,
45495317637,1650728711,320358,46995317637,320358,55536085463,1500000000,1500000000
24294757542,1650674607,60862,25794757542,56062,25826161458,1500000000,1500000000
77524060016,1650553320,67646,79024060016,62846,92518197045,1500000000,1500000000
113023690287,1642885660,340065,114523690287,340065,176236125047,1500000000,1500000000
22013054247,1646485767,67634,23513054247,67634,28375465535,1500000000,1500000000
41313133175,1650547225,60850,42813133175,56050,52171878967,1500000000,1500000000
123067857343,1642841755,343821,124567857343,343821,129372967342,1500000000,1500000000
26890435757,1646480494,52940,28890435757,48140,34000000000,2000000000,2000000000
23522681514,1650713885,67634,25022681514,67634,37629559540,1500000000,1500000000
42171496375,1650680640,54739,43671496375,49939,43772847514,1500000000,1500000000
38633059075,1650520617,60862,38920977922,56062,,,
172460221742,1642842507,60862,173960221742,56062,192166893643,1500000000,1500000000
40239243794,1650525527,55693,41739243794,50893,51667551024,1500000000,1500000000
22545255030,1650702427,67622,24045255030,67622,31135661783,1500000000,1500000000
31015167173,1650741285,67634,32515167173,67634,43628060115,1500000000,1500000000
47583064892,1650680419,67634,49054924575,67634,49054924575,1500000000,1471859683
61892853075,1650554774,56516,63542853075,51716,68284759674,1650000000,1650000000
78882975453,1650563270,67634,80382975453,62834,105769696449,1500000000,1500000000
214302638287,1642882569,319815,215802638287,319815,265093627917,1500000000,1500000000
26590331185,1646489228,48675,28090331185,48675,37897912964,1500000000,1500000000
20476136758,1650746268,60862,21976136758,56062,32996329415,1500000000,1500000000
17593020857,1650711792,60850,19093020857,60850,28078651442,1500000000,1500000000
124917044761,1642831810,323880,126417044761,323880,128031896275,1500000000,1500000000
48389479935,1650732223,60862,49889479935,56062,71082332848,1500000000,1500000000
62842522374,1650503039,64729,64342522374,59929,100512477720,1500000000,1500000000
168553596018,1642838196,325659,170203596018,325659,175000000000,1650000000,1650000000
20273417776,1646474057,336843,21773417776,336843,28543920943,1500000000,1500000000
17091174973,1646477375,67622,18591174973,67622,25100125754,1500000000,1500000000
26020047696,1650690430,60850,27520047696,60850,28856212767,1500000000,1500000000
32430027561,1650692612,60862,33930027561,56062,38755931887,1500000000,1500000000
39796975721,1650547637,67646,41296975721,62846,51472989039,1500000000,1500000000
115494449903,1642831759,337466,116994449903,337466,151526371195,1500000000,1500000000
111079311895,1650125098,60926,113645109462,60926,113645109462,3794797108,2565797567
22315902311,1650118388,64032,23815902311,64032,27849017429,1500000000,1500000000
23303246550,1650077583,55592,24803246550,50792,32488953117,1500000000,1500000000
35871720716,1650734248,60874,37371720716,56074,43801322730,1500000000,1500000000
219284770063,1642811124,336887,220784770063,336887,231713779258,1500000000,1500000000
49592684456,1646501701,49471,51092684456,49471,71249865127,1500000000,1500000000
49247651306,1650581314,60862,50747651306,56062,63986674575,1500000000,1500000000
25502574960,1650688873,67634,27002574960,62834,31617170759,1500000000,1500000000
61470753486,1650552721,60850,62970753486,60850,79143091750,1500000000,1500000000
22352355441,1650683053,67722,23852355441,67722,29618940219,1500000000,1500000000
30823911003,1650686732,322959,32323911003,322959,44403780920,1500000000,1500000000
29974161252,1650686284,60874,31474161252,56074,39969486572,1500000000,1500000000
60541959513,1650576596,60838,62041959513,56038,80696606108,1500000000,1500000000
95185545476,1642821103,437464,96685545476,337464,100000000000,1500000000,1500000000
28066909820,1650122398,327970,30266909820,327970,40484762249,2200000000,2200000000
23318205610,1650124050,67646,24818205610,62846,27263996909,1500000000,1500000000
23318205610,1650124050,52916,24818205610,48116,29539134404,1500000000,1500000000
50872502555,1650543567,436881,52372502555,336881,55000000000,1500000000,1500000000
19523629124,1646494467,55580,21023629124,50780,33532937387,1500000000,1500000000
38165908084,1650735270,60950,39269901084,56150,39269901084,1500000000,1103993000
96055878405,1650730269,340053,97555878405,340053,104436845185,1500000000,1500000000
35875070998,1650732872,67646,37375070998,62846,49407736280,1500000000,1500000000
18030777538,1650711898,55592,19530777538,50792,24481599980,1500000000,1500000000
27580624837,1646454037,67622,29080624837,62822,32938689650,1500000000,1500000000
21529041890,1650751650,60950,23029041890,56150,27114618234,1500000000,1500000000
21890451746,1650096165,340005,23890451746,340005,30057423601,2000000000,2000000000
93050859058,1650125909,67634,94932659058,62834,149033690340,1881800000,1881800000
19971322894,1650710243,60862,21000000000,56062,21000000000,1500000000,1028677106
33649720244,1650681195,67634,33804505588,67634,33804505588,1500000000,154785344
22322866561,1650710869,64056,23822866561,59256,30428668709,1500000000,1500000000
35651644538,1650740865,67734,37151644538,67734,37250985098,1500000000,1500000000
35804734334,1650528539,55705,37304734334,50905,48876053727,1500000000,1500000000
22225954624,1646507454,67646,23532718275,62846,23532718275,1325400000,1306763651
24681249665,1650722456,55580,26181249665,50780,30545578678,1500000000,1500000000
34647278873,1650736321,55592,36147278873,50792,44212344202,1500000000,1500000000
52010881588,1650576905,332336,53510881588,332336,53665270089,1500000000,1500000000
144659443761,1642836328,314063,146159443761,314063,162931015878,1500000000,1500000000
33919778063,1650737349,335645,35419778063,335645,38939420882,1500000000,1500000000
52981444836,1650524735,343805,54481444836,343805,63557471239,1500000000,1500000000
50972370854,1650582605,67646,52472370854,62846,60451793643,1500000000,1500000000
61194355065,1650573935,67622,62694355065,62822,92860091065,1500000000,1500000000
23935505443,1646466549,326076,25435505443,326076,31483240994,1500000000,1500000000
40874468218,1650737055,67634,42374468218,67634,58396092127,1500000000,1500000000
17586029251,1650746380,60838,19086029251,60838,23833505503,1500000000,1500000000
49483540964,1650732189,320374,50983540964,320374,55874039593,1500000000,1500000000
31472073210,1650704495,67646,32972073210,62846,36494812132,1500000000,1500000000
34927374035,1650731935,55705,36927374035,50905,58595080055,2000000000,2000000000
59194230866,1650504404,67634,60694230866,67634,62969128714,1500000000,1500000000
63426281104,1650579587,67634,64926281104,62834,88272569717,1500000000,1500000000
19169869001,1650099446,60938,20669869001,60938,23144451405,1500000000,1500000000
35151449012,1646450773,55592,36651449012,50792,45460085270,1500000000,1500000000
30226208973,1646492705,311247,31726208973,311247,38150079250,1500000000,1500000000
51018028690,1650127489,55717,52518028690,50917,69450859790,1500000000,1500000000
41586675452,1650520701,52408,43086675452,52408,48952351593,1500000000,1500000000
41586675452,1650520701,67646,43086675452,67646,49791323844,1500000000,1500000000
31521654439,1650530451,67646,33021654439,62846,47458704349,1500000000,1500000000
116603811429,1642835951,320481,118103811429,320481,156793649454,1500000000,1500000000
47613777411,1650127593,329939,49113777411,329939,65674501443,1500000000,1500000000
21465042225,1650690290,67646,22965042225,62846,30134370677,1500000000,1500000000
44481868550,1650540419,66754,45981868550,66754,55835894233,1500000000,1500000000
22203955333,1650757482,60850,23703955333,56050,33219936189,1500000000,1500000000
83042695585,1650567489,67710,84542695585,67710,109200108204,1500000000,1500000000
39882240421,1650546166,67634,41382240421,67634,46078974567,1500000000,1500000000
21222113112,1646468183,323080,22722113112,323080,30162334563,1500000000,1500000000
35626876461,1650673711,60850,37126876461,56050,41300126764,1500000000,1500000000
35626876461,1650673711,316522,37126876461,316522,43360008968,1500000000,1500000000
59745788121,1650548470,340639,61245788121,340639,76522060698,1500000000,1500000000
37900915348,1650540941,67634,39400915348,67634,52868574353,1500000000,1500000000
37357004429,1650120967,67622,38857004429,62822,48851408665,1500000000,1500000000
25493268573,1650076046,329183,26993268573,329183,30157469997,1500000000,1500000000
27268691948,1646460528,55592,28712254313,50792,28712254313,1500000000,1443562365
24032541674,1646494775,324750,25532541674,324750,26433691475,1500000000,1500000000
21496006131,1650713158,67646,22996006131,62846,26658662013,1500000000,1500000000
135126098463,1642856699,340695,136626098463,340695,146686911304,1500000000,1500000000
161191654504,1642885115,335538,163191654504,335538,197840654305,2000000000,2000000000
98125772894,1642891021,336891,100000000000,336891,100000000000,2500000000,1874227106
34049990096,1646468971,314116,35549990096,314116,35726954393,1500000000,1500000000
17913718366,1650755459,67634,19413718366,62834,24809040572,1500000000,1500000000
45164641042,1650548581,54812,46664641042,50012,62384030695,1500000000,1500000000
63712193356,1650513276,67722,65212193356,62922,67009749175,1500000000,1500000000
28956430523,1650529462,340623,30000000000,340623,30000000000,1500000000,1043569477
28956430523,1650529462,319783,30000000000,319783,30000000000,1500000000,1043569477
66326541718,1650550652,55680,67826541718,50880,109130375575,1500000000,1500000000
127512554038,1642850068,325629,129012554038,325629,153368540532,1500000000,1500000000
41349373292,1646502946,67646,42849373292,62846,61512172008,1500000000,1500000000
22061299004,1650709281,321903,23561299004,321903,26194005422,1500000000,1500000000
51161125171,1650729747,67646,52661125171,62846,55743832163,1500000000,1500000000
47223912337,1650558174,64741,50223912337,59941,200000000000,3000000000,3000000000
36549224410,1650528139,54664,38049224410,49864,46936158005,1500000000,1500000000
58811818967,1650525850,49583,60311818967,44783,66446082283,1500000000,1500000000
13874618228,1650108380,330577,15374618228,330577,20765149179,1500000000,1500000000
16433764009,1650110353,60850,17933764009,56050,21415155714,1500000000,1500000000
26816436542,1646489334,331163,28316436542,331163,32804851665,1500000000,1500000000
54205807554,1650548394,325653,55705807554,325653,71805783323,1500000000,1500000000
45777541189,1650520989,340039,47277541189,340039,49262614660,1500000000,1500000000
151896123086,1642820046,296246,153896123086,296246,188037543250,2000000000,2000000000
135948233593,1642892649,330300,137448233593,330300,150503209490,1500000000,1500000000
43769254218,1646449287,295287,45269254218,295287,200000000000,1500000000,1500000000
34337580712,1650683845,67634,35837580712,62834,45268405269,1500000000,1500000000
59860735137,1650725724,55580,61360735137,50780,66108151484,1500000000,1500000000
85593698031,1646510667,67646,87093698031,67646,99765175764,1500000000,1500000000
19982925171,1650754226,49495,21922925171,49495,29429029112,1940000000,1940000000
21016224584,1650712077,67646,22516224584,62846,23069355744,1500000000,1500000000
30493481525,1650753417,66754,31993481525,61954,43725537260,1500000000,1500000000
120779401793,1642888452,319753,122279401793,319753,149955458714,1500000000,1500000000
38696543617,1646456201,313518,40196543617,313518,56243152437,1500000000,1500000000
27589380419,1650680860,64044,29089380419,54444,32115346110,1500000000,1500000000
23261556690,1650746839,60862,24761556690,56062,30534244179,1500000000,1500000000
33535145648,1650696491,336897,35035145648,336897,35977265357,1500000000,1500000000
39943288861,1650508580,60862,41443288861,56062,56805384863,1500000000,1500000000
36188460157,1646500496,335613,37688460157,335613,42388444884,1500000000,1500000000
27708551004,1650737732,60838,28708551004,60838,30856578128,1000000000,1000000000
29869694351,1650744985,67622,31369694351,62822,42481056404,1500000000,1500000000
43660911537,1650544940,328813,48477829061,328813,,,
53058614538,1650559952,55792,54558614538,55792,68662987075,1500000000,1500000000
106462168206,1642856081,340053,107695920857,340053,107695920857,1500000000,1233752651
25025299616,1650711345,326836,26525299616,326836,39751750483,1500000000,1500000000
65366532691,1650584121,67634,66866532691,62834,83078316359,1500000000,1500000000
90900740232,1650574834,60950,92400740232,56150,92719519073,1500000000,1500000000
28651184324,1650130285,334304,30061184324,334304,36326138464,1410000000,1410000000
40044323219,1646497431,67634,41544323219,62834,47545483844,1500000000,1500000000
32172861787,1650714904,67646,33672861787,62846,34542907183,1500000000,1500000000
21698510348,1650707086,56516,23198510348,51716,25611859959,1500000000,1500000000
48344525527,1650679178,333714,49844525527,333714,53091777198,1500000000,1500000000
19291978476,1650713205,67634,20791978476,67634,32476061449,1500000000,1500000000
38043939660,1650680363,55580,39543939660,50780,47915598089,1500000000,1500000000
47808339945,1650568751,67734,49308339945,62934,92602392402,1500000000,1500000000
61533145659,1650556864,67646,62555598548,62846,62609922872,1022452889,1022452889
61533145659,1650556864,60862,63033145659,56062,78484337479,1500000000,1500000000
61473064958,1650551815,66778,62973064958,61978,74211530573,1500000000,1500000000
422613674366,1642846645,331127,424613674366,331127,487429242438,2000000000,2000000000
20834004031,1650102601,336873,22000000000,336873,22000000000,1500000000,1165995969
24639021423,1650148527,54824,26139021423,50024,29203992789,1500000000,1500000000
22663553369,1650100719,67722,24163553369,67722,24639575930,1500000000,1500000000
25398247134,1650710022,60850,26898247134,60850,35932143958,1500000000,1500000000
25398247134,1650710022,346396,26898247134,346396,32109693487,1500000000,1500000000
35661423994,1650530091,59982,36855579330,59982,36855579330,1500000000,1194155336
27736547826,1650117214,60850,29236547826,60850,41982586349,1500000000,1500000000
32115369803,1650689940,60850,33615369803,60850,46133380982,1500000000,1500000000
103915427876,1642889661,322963,111000000000,322963,,,
19623344214,1646477270,300196,21123344214,300196,26324001274,1500000000,1500000000
135485707731,1642866474,332422,136985707731,315322,157194832890,1500000000,1500000000
30643358862,1650681226,67646,31000000000,62846,31000000000,2000000000,356641138
27688982232,1650738070,67646,29188982232,62846,37667831728,1500000000,1500000000
25641315707,1650699221,60850,27141315707,60850,33649654808,1500000000,1500000000
53857750331,1646441667,55592,55357750331,50792,60734512395,1500000000,1500000000
33637276740,1650688390,67646,35137276740,62846,51297983240,1500000000,1500000000
56315795110,1650514961,338670,58315795110,338670,74187584650,2000000000,2000000000
60169711811,1650507648,60862,61669711811,56062,80437711078,1500000000,1500000000
19671204652,1650116200,67634,21171204652,67634,25018412473,1500000000,1500000000
58236909850,1650724598,60874,59736909850,56074,72732607113,1500000000,1500000000
26878613714,1650710519,67646,28378613714,62846,36490105620,1500000000,1500000000
28055051287,1650688997,55592,29555051287,50792,36631620193,1500000000,1500000000
68136671245,1650555045,60950,69636671245,56150,77214009443,1500000000,1500000000
54614091031,1650550917,60850,56114091031,60850,76933143130,1500000000,1500000000
19225510151,1650104549,67646,20725510151,62846,23499843920,1500000000,1500000000
35812351921,1650681824,67634,36000000000,62834,36000000000,1500000000,187648079
17284287442,1650756744,60926,18784287442,60926,24521763315,1500000000,1500000000
17284287442,1650756744,67634,18784287442,67634,23273602720,1500000000,1500000000
70224059686,1650517274,67634,71724059686,67634,72423149317,1500000000,1500000000
158195761810,1642864315,327988,159695761810,327988,160850735649,1500000000,1500000000
115568922333,1642852149,122017,117068922333,122017,151343704487,1500000000,1500000000
31128823820,1650677060,54332,32628823820,49532,33183064720,1500000000,1500000000
27640033072,1650743403,55592,29140033072,50792,41713354437,1500000000,1500000000
48766491995,1650537483,55693,50266491995,50893,61119390885,1500000000,1500000000
63785340268,1650508125,60850,65285340268,56050,79618214465,1500000000,1500000000
96079869625,1642821407,320400,97579869625,320400,100000000000,1500000000,1500000000
120985590060,1642822578,66718,122485590060,66718,123978666559,1500000000,1500000000
122334632096,1642835257,315318,123834632096,315318,167850441418,1500000000,1500000000
21301100820,1650079430,59982,22801100820,55182,30673715310,1500000000,1500000000
16491340695,1650149152,55648,17991340695,55648,36967708562,1500000000,1500000000
39505554192,1646449328,310891,41005554192,310891,46466076833,1500000000,1500000000
43703995162,1650730786,101451,46000000000,62834,,,
42983009499,1650724255,67646,44483009499,62846,56044147589,1500000000,1500000000
22270656335,1650721228,60862,23770656335,56062,37582697210,1500000000,1500000000
22228757957,1650144153,60862,23728757957,60862,31889027684,1500000000,1500000000
26251969693,1646461931,55592,27639219564,50792,27639219564,1500000000,1387249871
44370189506,1646442978,55705,45870189506,50905,62485276375,1500000000,1500000000
36586944667,1650673919,60850,38086944667,56050,47910964755,1500000000,1500000000
24098932824,1650736629,337482,25598932824,337482,30000000000,1500000000,1500000000
45119705093,1650539178,67634,46619705093,67634,50835021795,1500000000,1500000000
320666812239,1642847199,312111,322364384019,312111,400231715950,1697571780,1697571780
138337896458,1642870569,327956,139837896458,327956,198785976812,1500000000,1500000000
44133829587,1650674949,60850,45633829587,60850,50541798040,1500000000,1500000000
22635627711,1650709472,325084,24135627711,325084,27088348810,1500000000,1500000000
78230749206,1650507182,55680,79730749206,50880,105012838529,1500000000,1500000000
28426339302,1650142433,60850,29926339302,56050,32047420232,1500000000,1500000000
28426339302,1650142433,60850,30426339302,56050,33769317041,2000000000,2000000000
24683730250,1650738217,333652,26183730250,333652,32610411917,1500000000,1500000000
28414934679,1650678476,60862,29914934679,56062,32039889000,1500000000,1500000000
41912940630,1650732063,322903,43412940630,322903,50612035519,1500000000,1500000000
26371391810,1650707220,64729,27871391810,59929,29693643680,1500000000,1500000000
62738457733,1650556740,60862,64238457733,56062,89492739405,1500000000,1500000000
136770858116,1642828889,336865,138270858116,336865,152321220300,1500000000,1500000000
20994844841,1650115855,67634,22494844841,67634,31492635487,1500000000,1500000000
12342575070,1650151250,67634,13842575070,62834,20163764372,1500000000,1500000000
33383307764,1650676403,48675,34883307764,43875,42745371485,1500000000,1500000000
42092949224,1650523557,67622,43592949224,62822,51604744397,1500000000,1500000000
189889339370,1642813690,316638,194985912342,316638,,,
21217814059,1646460307,330551,22717814059,330551,31145374272,1500000000,1500000000
19977684339,1646479086,67634,21477684339,67634,29679585892,1500000000,1500000000
21262866359,1650097391,66778,22762866359,66778,34785320379,1500000000,1500000000
16522743252,1650755519,60850,17608458641,56050,17715209237,1085715389,1085715389
26088035763,1650753434,340057,27588035763,340057,39100257107,1500000000,1500000000
40099370526,1650541243,60862,41599370526,56062,47527214522,1500000000,1500000000
47700341231,1650506564,60850,49200341231,60850,65123514725,1500000000,1500000000
133603739797,1642819507,314047,135103739797,314047,188272137413,1500000000,1500000000
155921846390,1642838568,322931,157421846390,322931,170359601295,1500000000,1500000000
155921846390,1642838568,313413,157421846390,313413,170359601295,1500000000,1500000000
20350349200,1650710958,67634,21850349200,67634,28203418173,1500000000,1500000000
31297657055,1650528418,51428,32797657055,41828,40048960333,1500000000,1500000000
98523872156,1642869525,322482,100000000000,322482,100000000000,2000000000,1476127844
20515856673,1650105520,66802,22015856673,62002,27512707002,1500000000,1500000000
55048649044,1650512500,67646,56548649044,62846,75973903728,1500000000,1500000000
47094743541,1650547009,55728,49094743541,55728,57026248132,2000000000,2000000000
54985961809,1650515519,60006,56485961809,55206,66269718585,1500000000,1500000000
186613640876,1642891481,318204,188023640876,318204,199494813274,1410000000,1410000000
58095742850,1650573479,49495,59595742850,49495,72348034843,1500000000,1500000000
31070944638,1650710483,55580,32570944638,50780,33559962242,1500000000,1500000000
153545930800,1642844554,54920,155045930800,50120,176756698315,1500000000,1500000000
53439222471,1650726749,343221,54939222471,343221,72906272038,1500000000,1500000000
44355720439,1650552334,60850,46355720439,60850,65320813485,2000000000,2000000000
40741427651,1650536685,332338,42241427651,332338,49442470997,1500000000,1500000000
17466575954,1650111542,55717,18966575954,50917,25636150144,1500000000,1500000000
42375489481,1650129281,60838,43875489481,60838,50431742033,1500000000,1500000000
22738797727,1650719907,67622,24238797727,67622,32825090507,1500000000,1500000000
42931684817,1650683919,67634,44431684817,67634,49785167932,1500000000,1500000000
147714249821,1642820769,52916,149214249821,48116,168152538819,1500000000,1500000000
36998344050,1650678711,59958,38498344050,59958,42091486569,1500000000,1500000000
35615588870,1650684510,60850,37115588870,60850,41279277640,1500000000,1500000000
22474743247,1650744712,66778,24474743247,61978,32931664957,2000000000,2000000000
109234907365,1642826524,314055,110734907365,314055,136059118647,1500000000,1500000000
128467673274,1642872121,308505,129967673274,308505,145872922118,1500000000,1500000000
106220188192,1642857957,60862,108220188192,56062,137097315530,2000000000,2000000000
24590183899,1650105506,67734,25807902687,62934,25807902687,1500000000,1217718788
33702287266,1646454657,327347,35202287266,327347,40444771873,1500000000,1500000000
17156064712,1646476214,60838,18656064712,60838,22262938708,1500000000,1500000000
200603514171,1642845183,67634,202603514171,67634,290000000000,2000000000,2000000000
402607901569,1642846734,313405,404107901569,313405,595717675089,1500000000,1500000000
30953922921,1650124533,331131,34016854162,331131,,,
30953922921,1650124533,322490,34016854162,322490,,,
21892328092,1650718473,67646,23392328092,62846,32854511428,1500000000,1500000000
46725690002,1650581287,55705,48225690002,50905,54056506882,1500000000,1500000000
59289697726,1650515139,66778,60789697726,66778,83004949737,1500000000,1500000000
44873673819,1650585418,67646,46373673819,62846,69891832184,1500000000,1500000000
49240792662,1650549602,64717,50740792662,59917,59959719227,1500000000,1500000000
25321273785,1650067704,330487,26821273785,330487,35997587735,1500000000,1500000000
17306265855,1646487298,67646,18806265855,62846,25683454280,1500000000,1500000000
38599267211,1650521508,67646,40099267211,62846,47209117163,1500000000,1500000000
79086936035,1650504027,67622,80586936035,67622,88218764958,1500000000,1500000000
40411994404,1650526928,67622,41911994404,67622,55394461374,1500000000,1500000000
78641604590,1650511884,55592,80141604590,50792,110558047889,1500000000,1500000000
21945170624,1650096065,55668,23445170624,55668,26473804835,1500000000,1500000000
36062328329,1650675172,67646,37562328329,62846,53980210427,1500000000,1500000000
26923807128,1650693929,55592,28423807128,50792,38066802879,1500000000,1500000000
80655775606,1650563343,55804,82155775606,55804,98055879732,1500000000,1500000000
143839504241,1642869004,323159,145339504241,323159,168211242668,1500000000,1500000000
17903837837,1650111080,54748,19403837837,49948,24880629539,1500000000,1500000000
39443800204,1650733325,346368,42020749279,346368,,,
24389612224,1650708401,56516,26389612224,51716,28610767304,2000000000,2000000000
48084615007,1650583438,67634,49584615007,67634,67944675667,1500000000,1500000000
30012319929,1650542035,67646,31512319929,62846,40460386010,1500000000,1500000000
30012319929,1650542035,59994,31512319929,59994,40460386010,1500000000,1500000000
122972159187,1642888496,334312,124472159187,334312,159650692387,1500000000,1500000000
128983432003,1642840130,328358,130000000000,328358,130000000000,1400000000,1016567997
35437589155,1650136088,60950,36937589155,56150,49070036079,1500000000,1500000000
24439094335,1650691339,67646,25939094335,62846,32425232365,1500000000,1500000000
32987433230,1650069627,325962,34487433230,325962,48702789368,1500000000,1500000000
21076162675,1650756573,335533,22576162675,335533,24064425283,1500000000,1500000000
51515837058,1650518750,323529,53015837058,323529,61443740754,1500000000,1500000000
117089557884,1642862386,67622,118589557884,67622,131613740543,1500000000,1500000000
120588735351,1642817709,55580,122088735351,50780,173138828554,1500000000,1500000000
111201269200,1642850839,337496,112701269200,337496,117894917660,1500000000,1500000000
61600934575,1650557474,60850,63100934575,56050,68372883554,1500000000,1500000000
61600934575,1650557474,67634,63100934575,62834,68535708335,1500000000,1500000000
33060483143,1650541843,67646,34560483143,67646,49260364719,1500000000,1500000000
39691817885,1650733496,67722,41191817885,67722,60278640162,1500000000,1500000000
39289628415,1650731986,60850,40789628415,60850,43306846079,1500000000,1500000000
21785916040,1650722127,101451,26000000000,62834,,,
76369669335,1650577659,49495,77869669335,44695,94590664689,1500000000,1500000000
75047591118,1650571847,67646,76547591118,62846,80673232694,1500000000,1500000000
122353649968,1642888551,312300,124353649968,312300,161863806944,2000000000,2000000000
34131096369,1650118822,67622,35631096369,67622,37791682915,1500000000,1500000000
51822405128,1650733747,314095,53822405128,314095,68986771379,2000000000,2000000000
27006203157,1650749198,49507,28506203157,44707,30697050589,1500000000,1500000000
26166605318,1650714617,67646,27666605318,62846,37261474904,1500000000,1500000000
68593664308,1650566039,55347,70003664308,50547,72906328950,1410000000,1410000000
24447417175,1650709504,320461,25947417175,320461,32048546130,1500000000,1500000000
24447417175,1650709504,326002,26447417175,326002,33770487976,2000000000,2000000000
25737088949,1650736207,334302,27237088949,334302,37680272500,1500000000,1500000000
19983473324,1650746280,56705,21483473324,47105,32996329415,1500000000,1500000000
95429455847,1642862503,338843,97429455847,332374,123923423464,2000000000,2000000000
16734194328,1650152303,329225,18234194328,329225,20598758065,1500000000,1500000000
25489145695,1650080470,55648,26989145695,55648,46826480434,1500000000,1500000000
34126189052,1646500355,67634,35626189052,67634,39419996219,1500000000,1500000000
74918664998,1650565962,60862,76418664998,56062,93033577908,1500000000,1500000000
52302295832,1650582829,67646,55502295832,62846,64591727185,3200000000,3200000000
49570709825,1650583847,67646,51070709825,62846,66659982339,1500000000,1500000000
38424670358,1646447104,60862,39924670358,56062,51946773097,1500000000,1500000000
41489986992,1650694265,55592,43489986992,50792,54600767530,2000000000,2000000000
159045152086,1642834195,314071,160545152086,314071,173719427715,1500000000,1500000000
136374837650,1642866057,315526,137874837650,315526,148319642623,1500000000,1500000000
24831914770,1650738731,55592,29809710537,50792,,,
61166801654,1650558538,60850,63166801654,60850,88589888229,2000000000,2000000000
26053732027,1650130616,67622,27553732027,67622,37998170523,1500000000,1500000000
25252333985,1650142469,60862,26752333985,56062,39069608173,1500000000,1500000000
126766132988,1642890225,67646,128266132988,62846,134845056570,1500000000,1500000000
40745312834,1650728305,67646,42245312834,62846,58353194129,1500000000,1500000000
63187182928,1650576780,67622,64687182928,62822,71715864868,1500000000,1500000000
37156324876,1650684203,60862,38656324876,56062,45215364049,1500000000,1500000000
41234340238,1650119392,48627,42734340238,43827,43091688090,1500000000,1500000000
37176400971,1650119158,64044,38676400971,64044,41814536965,1500000000,1500000000
34505495883,1646455297,60850,36005495883,56050,48527768512,1500000000,1500000000
31018552983,1650728368,59958,32518552983,55158,48566973412,1500000000,1500000000
23015578016,1650691604,67646,24515578016,62846,31657309622,1500000000,1500000000
23176182141,1646474768,55580,24676182141,50780,27054087892,1500000000,1500000000
19547875930,1650754194,67646,21047875930,62846,24000000000,1500000000,1500000000
72745230929,1650502730,67622,74245230929,62822,104515847149,1500000000,1500000000
20171431734,1650714121,67646,21671431734,62846,26569813594,1500000000,1500000000
22922526016,1650119985,49583,24422526016,49583,36988609422,1500000000,1500000000
48456599765,1650723676,67646,49956599765,67646,58769797179,1500000000,1500000000
48456599765,1650723676,67646,49956599765,62846,58769797179,1500000000,1500000000
31029522692,1650700654,67646,32529522692,62846,38430917474,1500000000,1500000000
18592814323,1650754312,67622,20092814323,67622,22161401572,1500000000,1500000000
53797444948,1650516795,333091,55297444948,333091,66358460502,1500000000,1500000000
23751309559,1650696080,67646,25251309559,62846,34254783523,1500000000,1500000000
41415793603,1650553700,54736,43355793603,49936,45282425483,1940000000,1940000000
47080198853,1646502928,334340,48580198853,334340,51909850639,1500000000,1500000000
41412792061,1650724274,67634,42912792061,62834,55028278213,1500000000,1500000000
56875008491,1650725535,331965,58375008491,331965,75223876954,1500000000,1500000000
36848236704,1650687428,67646,38348236704,62846,51543682410,1500000000,1500000000
39324667135,1650730995,56492,40824667135,56492,50148181199,1500000000,1500000000
90269552257,1650567391,67634,91769552257,62834,103407648608,1500000000,1500000000
104225399561,1642857195,67646,105725399561,62846,131252183465,1500000000,1500000000
97654277214,1642858712,60862,99154277214,56062,127952297194,1500000000,1500000000
21272237613,1650711501,67646,22772237613,62846,60000000000,1500000000,1500000000
41324337937,1650739730,67710,42824337937,67710,51340224945,1500000000,1500000000
22688537763,1650675799,54332,24688537763,49532,31661058492,2000000000,2000000000
80014879398,1650543301,60862,81514879398,56062,93037435437,1500000000,1500000000
149423055722,1642830397,319909,150923055722,319909,166560428133,1500000000,1500000000
26033609972,1650701790,68634,27533609972,62834,30666185325,1500000000,1500000000
25204841654,1650678195,309702,26704841654,309702,26803778085,1500000000,1500000000
55864194129,1650556888,60850,57364194129,56050,79995506058,1500000000,1500000000
119134059879,1642867146,343225,121074059879,343225,153759506942,1940000000,1940000000
54922173216,1650549640,67646,56422173216,67646,58476697123,1500000000,1500000000
54330354988,1650558154,66718,55830354988,66718,59318262780,1500000000,1500000000
38376941063,1650546841,67634,40376941063,67634,58703457817,2000000000,2000000000
49270472571,1650552872,67634,50770472571,67634,71023953929,1500000000,1500000000
107713277566,1642850846,336897,109213277566,336897,111345021783,1500000000,1500000000
33673124546,1650120915,48675,35173124546,43875,53471279563,1500000000,1500000000
49491694564,1650728146,67646,50991694564,62846,57856268373,1500000000,1500000000
49491694564,1650728146,54676,50991694564,49876,52724051969,1500000000,1500000000
33422707757,1650686429,340033,35422707757,340033,48956309690,2000000000,2000000000
25793852024,1650700883,67646,27293852024,67646,39873787334,1500000000,1500000000
90343586547,1642858064,334356,91843586547,334356,122836381265,1500000000,1500000000
38559164271,1650128276,48639,40059164271,43839,49876120062,1500000000,1500000000
43395065730,1650729687,67722,44895065730,67722,58031841493,1500000000,1500000000
20530976909,1650709463,320487,22530976909,320487,30533389885,2000000000,2000000000
64899120588,1650576676,67734,66399120588,62934,101610151747,1500000000,1500000000
34798034667,1650530159,67622,36298034667,62822,45866920824,1500000000,1500000000
25163746200,1650087188,333704,27010000000,333704,27010000000,27010000000,1846253800
25051237692,1646470596,67646,26551237692,62846,34169287039,1500000000,1500000000
116089398512,1642851050,311094,117589398512,311094,162900738550,1500000000,1500000000
118066071976,1642871853,325967,119566071976,325967,120763508705,1500000000,1500000000
35014724215,1650683834,55580,36086346507,50780,36086346507,1500000000,1071622292
40873546832,1650519926,66802,42373546832,62002,46917067882,1500000000,1500000000
54978689892,1646503887,55580,56478689892,50780,74757055522,1500000000,1500000000
20021731248,1650706354,67646,21000000000,62846,21000000000,1500000000,978268752
21301069831,1650722180,66766,22801069831,61966,27956092523,1500000000,1500000000
113029286937,1642843260,67646,114529286937,67646,136192633668,1500000000,1500000000
24625490648,1650692203,67634,26125490648,62834,42208137195,1500000000,1500000000
36420611072,1650678776,54736,37920611072,49936,51072894537,1500000000,1500000000
24263943531,1650700904,330511,25763943531,330511,26000000000,1500000000,1500000000
19989134556,1650711737,67634,21489134556,67634,23130960265,1500000000,1500000000
61795875982,1650570210,67634,63295875982,67634,104594529407,1500000000,1500000000
39453570823,1650581585,60850,40953570823,56050,57749663667,1500000000,1500000000
41293521906,1650085248,60850,42793521906,60850,60029293428,1500000000,1500000000
36767140653,1646451254,309215,38267140653,309215,53187755540,1500000000,1500000000
23822336927,1646473201,67634,25322336927,62834,34518283729,1500000000,1500000000
107721290184,1642826324,319813,109221290184,319813,134268498879,1500000000,1500000000
140216831657,1642876005,64741,141716831657,59941,183651802718,1500000000,1500000000
23425636718,1650754918,60850,24925636718,56050,29643311658,1500000000,1500000000
35185317211,1650741675,60850,36685317211,56050,42296270648,1500000000,1500000000
30673702665,1650718420,67646,31824052249,62846,31824052249,1500000000,1150349584
169602273756,1642867086,60862,171102273756,56062,212455074804,1500000000,1500000000
101949985504,1642851084,325681,103449985504,325681,111416532753,1500000000,1500000000
21217755357,1650708335,56576,22717755357,51776,26074008060,1500000000,1500000000
53645314726,1650585156,67634,55145314726,67634,77126669933,1500000000,1500000000
31056156523,1650079817,54748,32556156523,54748,32992054075,1500000000,1500000000
211054258604,1650125520,60950,213013617003,56150,260192918780,1959358399,1959358399
27209829243,1650701947,67710,28709829243,62910,37325195224,1500000000,1500000000
47648239302,1650503253,67710,49648239302,67710,81400056718,2000000000,2000000000
110088882058,1642887328,328328,111588882058,328328,139282655259,1500000000,1500000000
14210680667,1646475564,67622,16210680667,67622,22422799542,2000000000,2000000000
168731132536,1642860429,329412,170231132536,329412,200833092775,1500000000,1500000000
21444672910,1650090940,308964,22944672910,308964,23795451839,1500000000,1500000000
28046810205,1650712747,336827,29546810205,336827,36247287882,1500000000,1500000000
28046810205,1650712747,340069,29546810205,340069,32387431509,1500000000,1500000000
30797509675,1650700068,67634,32297509675,62834,35176931285,1500000000,1500000000
18979984513,1650095974,333674,20000000000,333674,20000000000,1500000000,1020015487
48952394076,1650126432,60850,50452394076,60850,60276748212,1500000000,1500000000
52614322621,1646514729,60838,54114322621,60838,65977095924,1500000000,1500000000
25262686541,1650746650,60850,26762686541,56050,37114511695,1500000000,1500000000
66086081457,1650554959,67646,67586081457,67646,79953915023,1500000000,1500000000
133466147759,1650517591,67634,134966147759,67634,151985566124,1500000000,1500000000
152097629971,1642813827,67646,157775445626,62846,,,
26796497566,1650078471,60862,28296497566,56062,35350868324,1500000000,1500000000
26086346383,1650674697,67634,27586346383,62834,35346125010,1500000000,1500000000
23421540965,1650753174,67646,24921540965,62846,34030641177,1500000000,1500000000
22084665277,1650754683,67646,23584665277,62846,33709093260,1500000000,1500000000
55771228393,1650551196,67634,57271228393,62834,70805823614,1500000000,1500000000
69218138034,1650564083,67634,70718138034,62834,93817226359,1500000000,1500000000
18308021384,1650096655,60914,24715436266,56114,,,
24628029273,1650748989,67622,26128029273,67622,34782563625,1500000000,1500000000
33131604850,1650757103,67622,34631604850,67622,42091808539,1500000000,1500000000
118232270771,1650125822,60042,119949738822,55242,141616223631,1717468051,1717468051
40515753295,1650673749,67646,41300126764,62846,41300126764,1500000000,784373469
58972231726,1650553148,59970,60472231726,55170,76300946873,1500000000,1500000000
18256824513,1650103744,60862,19756824513,56062,21867457530,1500000000,1500000000
25292355639,1650698789,340005,26702355639,340005,29712004672,1410000000,1410000000
30591320032,1650699183,67634,32091320032,67634,38417424442,1500000000,1500000000
69468202080,1650507531,321652,70976428476,321652,106427448215,1508226396,1508226396
114200324448,1642825744,334328,115700324448,334328,147904873404,1500000000,1500000000
52563412192,1650572086,67710,54213412192,67710,82089985256,1650000000,1650000000
45402019525,1650545409,60850,46902019525,60850,47573920679,1500000000,1500000000
16714850763,1650105308,60850,18214850763,56050,25098218124,1500000000,1500000000
32473189255,1650678647,67734,33973189255,62934,42854295848,1500000000,1500000000
44626853505,1650535885,326142,46126853505,326142,53900436165,1500000000,1500000000
137307671735,1642829638,331205,138807671735,331205,179950799642,1500000000,1500000000
194821582985,1642879967,323688,196321582985,323688,214868470249,1500000000,1500000000
19996023212,1650116586,67646,21496023212,62846,29847582537,1500000000,1500000000
21506021605,1646485586,333083,23006021605,333083,23741432348,1500000000,1500000000
50497232690,1650733414,60850,51997232690,56050,66770722204,1500000000,1500000000
22516699600,1650690056,60850,25100701943,56050,,,
91699011249,1642825513,334565,93199011249,334565,125777456177,1500000000,1500000000
28631446597,1650145628,322470,30131446597,322470,39979803254,1500000000,1500000000
28631446597,1650145628,319751,30131446597,319751,40747322620,1500000000,1500000000
18377777374,1650110859,55705,19877777374,50905,27736115750,1500000000,1500000000
42350950229,1650742038,60950,52431634523,56150,,,
42350950229,1650742038,55580,46735227818,50780,,,
121214258733,1642862730,59970,122714258733,55170,125600719453,1500000000,1500000000
96902671097,1642831774,316797,98040003251,316797,101000000000,1137332154,1137332154
38250312539,1650687777,60850,39750312539,56050,46530611252,1500000000,1500000000
21716350962,1650102345,49607,23216350962,44807,29359716087,1500000000,1500000000
32273350271,1650117387,67646,33773350271,62846,41169054827,1500000000,1500000000
35891466500,1650685035,60938,37391466500,60938,54054847844,1500000000,1500000000
25178754846,1650691649,60874,26678754846,56074,29120614179,1500000000,1500000000
41050809468,1650739780,67622,42550809468,67622,58699330732,1500000000,1500000000
86656981900,1650557168,67722,88156981900,67722,111259323047,1500000000,1500000000
112167497674,1642873854,319773,113667497674,319773,140967774528,1500000000,1500000000
18671595063,1650139357,319801,20171595063,319801,31159468767,1500000000,1500000000
49253014185,1650545829,322937,50753014185,322937,60310358358,1500000000,1500000000
100609597671,1650555234,56516,102109597671,51716,200000000000,1500000000,1500000000
178484523255,1642883536,326266,179984523255,326266,205348281008,1500000000,1500000000
37790667292,1646449243,315582,39290667292,315582,200000000000,1500000000,1500000000
37044106333,1650541486,67734,38544106333,62934,53362294853,1500000000,1500000000
50752901531,1650544912,326089,52252901531,326089,65856964595,1500000000,1500000000
103978223706,1642826304,328851,105478223706,328851,142764710887,1500000000,1500000000
52077410496,1650517777,64741,62087410496,59941,200000000000,10010000000,10010000000
24910265050,1650070862,336841,26410265050,336841,26444348203,1500000000,1500000000
20139263991,1650736046,66730,21639263991,61930,27364205674,1500000000,1500000000
58415584727,1650564894,346901,60415584727,346901,76294443247,2000000000,2000000000
103921011946,1642857930,55580,105221716362,55580,122650154033,1300704416,1300704416
103921011946,1642857930,337500,105421011946,337500,119248676067,1500000000,1500000000
27381563514,1646468872,67622,28881563514,67622,30253323977,1500000000,1500000000
71280968476,1646440952,349550,72780968476,349550,88937429072,1500000000,1500000000
34853814382,1650729284,55592,36353814382,50792,38849062760,1500000000,1500000000
41617920765,1650728329,67646,43117920765,58046,53068286556,1500000000,1500000000
41617920765,1650728329,60862,100000000000,56062,100000000000,100000000000,58382079235
90261230668,1650515897,67646,91761230668,62846,112436921100,1500000000,1500000000
106438561575,1642826253,337446,107938561575,337446,147341181120,1500000000,1500000000
20647686131,1650735354,55592,22647686131,55592,23000000000,2000000000,2000000000
30847582322,1650677675,67658,32847582322,62858,45104207799,2000000000,2000000000
52870401442,1650585018,67646,56070401442,62846,69030506538,3200000000,3200000000
51533883521,1650568370,60938,53033883521,56138,61583595268,1500000000,1500000000
16747145979,1650755443,67658,18247145979,67658,24030205867,1500000000,1500000000
22248272173,1650103274,340071,22500000000,340071,22500000000,1400000000,251727827
35797194218,1646487849,334338,37297194218,334338,40000000000,1500000000,1500000000
26112976477,1650677178,331135,27612976477,331135,31560695405,1500000000,1500000000
125444961303,1642821562,333708,126944961303,333708,147853891950,1500000000,1500000000
18640400359,1650092395,346398,20140400359,346398,25821469555,1500000000,1500000000
19289487967,1650707082,66826,20789487967,66826,26035562297,1500000000,1500000000
37502698952,1650742090,66766,39002698952,61966,60472426093,1500000000,1500000000
145292056662,1642828407,334280,146792056662,334280,180640166198,1500000000,1500000000
22276820291,1650106343,67722,23503827888,67722,23503827888,1500000000,1227007597
19950897184,1650114195,55680,21450897184,50880,26369083858,1500000000,1500000000
26109477902,1650750688,67622,27609477902,67622,39379291277,1500000000,1500000000
19436857002,1650714221,67634,20936857002,67634,27026724958,1500000000,1500000000
43463318338,1650544022,60838,44963318338,60838,53408781748,1500000000,1500000000
43682552686,1650581027,101601,65000000000,62934,,,
169637952341,1642865783,340677,171137952341,340677,222708475650,1500000000,1500000000
33651386943,1646492519,60850,35151386943,56050,38892186507,1500000000,1500000000
23367912578,1646494731,343795,24867912578,343795,25373590462,1500000000,1500000000
32814034615,1650542386,49595,34314034615,44795,47083944173,1500000000,1500000000
37550367066,1650530886,60838,39050367066,56038,44399516013,1500000000,1500000000
174941951047,1642888744,312304,176441951047,312304,200087452662,1500000000,1500000000
21362958150,1650094480,64144,26669659719,54544,,,
37302991986,1650675139,310862,38802991986,310862,40252968089,1500000000,1500000000
33680438600,1650520083,52396,35180438600,52396,46260076800,1500000000,1500000000
32781406396,1650525044,336831,34281406396,336831,44066444114,1500000000,1500000000
59058435690,1650511093,56576,60558435690,51776,67122472220,1500000000,1500000000
81254415114,1650507485,339979,82809287687,339979,83867759724,1554872573,1554872573
27072452254,1646461226,67646,28572452254,62846,31186218023,1500000000,1500000000
31466365411,1650736783,60850,32966365411,60850,35385144073,1500000000,1500000000
23264266740,1650751778,60850,24764266740,56050,32316871042,1500000000,1500000000
19992243244,1650718796,60850,21492243244,56050,27499183039,1500000000,1500000000
19992243244,1650718796,343809,21492243244,343809,27499183039,1500000000,1500000000
29865855964,1650702165,67646,31365855964,62846,37338690457,1500000000,1500000000
24082755169,1650133761,67634,26022755169,62834,37605420134,1940000000,1940000000
23379130260,1650700299,67646,24879130260,62846,36774055498,1500000000,1500000000
23379130260,1650700299,325068,25379130260,325068,35050269961,2000000000,2000000000
34616600210,1650734198,60850,36116600210,56050,36200000000,1500000000,1500000000
137281898260,1642890515,122029,139281898260,117229,185931966853,2000000000,2000000000
38918544959,1650730957,332460,40918544959,332460,75989436004,2000000000,2000000000
115516970349,1642826874,60862,117016970349,56062,176304671678,1500000000,1500000000
32527224800,1650085955,63200,34027224800,63200,60562378788,1500000000,1500000000
21123327969,1650695863,60862,22623327969,56062,30727429195,1500000000,1500000000
22127957468,1646454200,60850,23627957468,60850,35000000000,1500000000,1500000000
36504162852,1650685623,67646,37526918044,62846,37526918044,1500000000,1022755192
20082524740,1650735429,336873,21582524740,336873,35931967789,1500000000,1500000000
40847407707,1650742329,67634,42347407707,62834,56606143850,1500000000,1500000000
41842134875,1646522034,55592,43342134875,50792,67235414780,1500000000,1500000000
40815464614,1650542115,67722,42315464614,67722,46855820378,1500000000,1500000000
30997460355,1650674408,52940,32497460355,48140,33000000000,1500000000,1500000000
30056539462,1650728441,60850,31556539462,56050,42289107754,1500000000,1500000000
71815594296,1650510608,66778,73815594296,66778,102007675250,2000000000,2000000000
137861771648,1642824571,67646,139361771648,67646,141312254733,1500000000,1500000000
256294870047,1642845740,122029,258294870047,122029,554774688823,2000000000,2000000000
24142986346,1650758399,55680,25642986346,50880,26986983880,1500000000,1500000000
21596421767,1650695920,60862,23034906904,56062,23034906904,1500000000,1438485137
40119582165,1650532247,337462,41619582165,337462,57697702770,1500000000,1500000000
34273448601,1650523887,67734,35773448601,62934,44353789332,1500000000,1500000000
123899528298,1642825764,336843,125399528298,336843,129604264229,1500000000,1500000000
107695488949,1642851560,67622,109195488949,67622,137113391648,1500000000,1500000000
162935081238,1642877656,303407,164435081238,303407,194202136427,1500000000,1500000000
37331546266,1650121479,67734,38831546266,58134,46429362935,1500000000,1500000000
23862512071,1650711113,67722,25362512071,67722,33684185380,1500000000,1500000000
30574982396,1650703363,55592,32074982396,50792,35000000000,1500000000,1500000000
32150130803,1650676729,66766,33650130803,66766,33821629300,1500000000,1500000000
63042448894,1650730509,67634,64542448894,62834,105739550465,1500000000,1500000000
140462380463,1642860454,59994,141962380463,59994,193898286915,1500000000,1500000000
190839014583,1642865838,322917,192339014583,322917,226556225157,1500000000,1500000000
32503210805,1646458392,55592,34003210805,50792,43458541712,1500000000,1500000000
101276289020,1650575140,67722,102776289020,62922,114758548193,1500000000,1500000000
122546016972,1650556219,67634,124046016972,67634,137672385874,1500000000,1500000000
26635075066,1650692436,60862,28135075066,56062,37123973120,1500000000,1500000000
36926532838,1650548922,67646,38926532838,62846,51586757158,2000000000,2000000000
35164587926,1650534664,334274,36664587926,334274,44662982372,1500000000,1500000000
37908550301,1650581905,101451,44000000000,62834,,,
47998258217,1650544664,67734,49998258217,67734,71759282593,2000000000,2000000000
38628134345,1650683888,60838,40128134345,60838,45268405269,1500000000,1500000000
21445269279,1650691550,54322,22945269279,54322,25000000000,1500000000,1500000000
45031995361,1650727294,67622,46531995361,67622,53222452867,1500000000,1500000000
61786289390,1650558693,60850,63786289390,60850,84266985276,2000000000,2000000000
30706450572,1650705815,67622,32206450572,62822,38803587762,1500000000,1500000000
101541717388,1650567405,49495,103041717388,49495,116132068484,1500000000,1500000000
45136694730,1650129799,60938,46636694730,56138,63442021649,1500000000,1500000000
46178362952,1650750508,54332,47531465013,49532,47531465013,1500000000,1353102061
23107639596,1650706732,48591,24607639596,48591,25011074280,1500000000,1500000000
38585792982,1650581949,67634,40085792982,62834,53705796943,1500000000,1500000000
54776382466,1650553872,67646,56776382466,62846,65306514465,2000000000,2000000000
164514388804,1642871654,330509,166014388804,330509,178562183107,1500000000,1500000000
136701235267,1642874039,326109,138201235267,326109,198534088419,1500000000,1500000000
20213198597,1650142170,67646,21713198597,62846,29436972813,1500000000,1500000000
27337997496,1650075954,323590,28837997496,323590,34831884282,1500000000,1500000000
49986237747,1650733730,327391,51986237747,327391,71757648657,2000000000,2000000000
31706291582,1650735707,67710,33206291582,67710,44911532172,1500000000,1500000000
117481327311,1650556279,67722,118981327311,67722,154682521215,1500000000,1500000000
73842312648,1650507347,350343,75342312648,318494,83000000000,1500000000,1500000000
43074789748,1650734841,319745,44574789748,319745,54156000902,1500000000,1500000000
79444909262,1650730213,67734,80944909262,62934,109916704627,1500000000,1500000000
84543874966,1650563249,55592,86043874966,50792,112171613070,1500000000,1500000000
180056971767,1642848530,317208,181466971767,317208,197343456302,1410000000,1410000000
28425692791,1650729097,67722,29925692791,67722,37618669789,1500000000,1500000000
37911005145,1650535466,67734,39411005145,62934,47739824405,1500000000,1500000000
104236004749,1642850769,326216,105736004749,326216,131184632815,1500000000,1500000000
16702413041,1650109274,60862,18202413041,56062,18292853324,1500000000,1500000000
16702413041,1650109274,67634,18202413041,62834,20469397873,1500000000,1500000000
29306584807,1646523593,67634,30806584807,62834,35651314817,1500000000,1500000000
34689659315,1650541029,64044,36189659315,54444,45200139108,1500000000,1500000000
38089452294,1650681797,67646,39589452294,62846,43677089070,1500000000,1500000000
36371686113,1650731285,55592,37871686113,50792,52060628679,1500000000,1500000000
48119925892,1650504559,332406,49619925892,332406,73149485795,1500000000,1500000000
65559866005,1650559906,67646,67059866005,62846,92314694478,1500000000,1500000000
65559866005,1650559906,55693,67059866005,50893,72197997597,1500000000,1500000000
90110167904,1650572647,67622,92110167904,67622,120000000000,2000000000,2000000000
24316828403,1650073369,67634,25816828403,62834,33501576884,1500000000,1500000000
23259636566,1650718832,320404,24759636566,320404,30270046233,1500000000,1500000000
52317138133,1650503668,67734,54317138133,67734,79324347808,2000000000,2000000000
41333576947,1650730910,67646,42833576947,62846,67102370172,1500000000,1500000000
27111294810,1650689826,67646,28611294810,62846,33331855594,1500000000,1500000000
71315153567,1650511899,67622,72815153567,67622,98946782237,1500000000,1500000000
124761606356,1643206484,55636,127261606356,55636,285692658808,2500000000,2500000000
141770866965,1644433351,67634,143270866965,62834,163391786148,1500000000,1500000000
119741524553,1643207602,56516,121241524553,51716,141404153085,1500000000,1500000000
100198696791,1643203740,67646,101698696791,62846,126862161732,1500000000,1500000000
386625811194,1644435317,55668,406025811194,50868,494081355303,19400000000,19400000000
68236607994,1644450925,54332,69736607994,49532,97259943750,1500000000,1500000000
182650355572,1643210008,67646,184150355572,62846,185886352803,1500000000,1500000000
87665413973,1643190516,330028,88000000000,330028,88000000000,1500000000,334586027
114586103076,1644366758,55608,116086103076,50808,162383051788,1500000000,1500000000
62223718180,1644379779,55668,63723718180,50868,79606559692,1500000000,1500000000
60741138643,1644396815,54308,62741138643,49508,69924100361,2000000000,2000000000
66373206403,1643203308,337486,67873206403,337486,89439149779,1500000000,1500000000
103953417983,1643173306,54945,105453417983,50145,156168379912,1500000000,1500000000
44693382610,1644401725,55632,47193382610,55632,99430694704,2500000000,2500000000
108681182657,1643159673,329354,110181182657,329354,122079872308,1500000000,1500000000
140082512784,1643211176,60850,141632512784,56050,150000000000,1550000000,1550000000
184391522679,1643218229,54909,185891522679,50109,300000000000,1500000000,1500000000
158888243558,1643223580,319743,160388243558,319743,223851014300,1500000000,1500000000
56872142869,1644399847,54332,58000553750,49532,58000553750,1500000000,1128410881
161877941016,1643206955,49495,163377941016,44695,210606669170,1500000000,1500000000
75085835901,1643164879,67658,76585835901,62858,120200032437,1500000000,1500000000
155481046522,1643237192,340631,156981046522,340631,160142597865,1500000000,1500000000
49172093574,1644408665,55584,50672093574,50784,67143770834,1500000000,1500000000
125960460508,1644423343,55705,127460460508,50905,166990218620,1500000000,1500000000
187733583336,1643220905,52904,189233583336,52904,210107142607,1500000000,1500000000
194485629522,1643208869,339837,195985629522,339837,224930547657,1500000000,1500000000
44934138262,1644395692,55668,46434138262,50868,49357021322,1500000000,1500000000
74322543427,1644450990,200000,75732543427,200000,80282648941,1410000000,1410000000
163664453905,1644422985,67622,165664453905,67622,203792620730,2000000000,2000000000
146996506742,1644445530,60862,148496506742,56062,181341626924,1500000000,1500000000
53323739604,1644384809,67622,54823739604,67622,66821352973,1500000000,1500000000
56153862840,1644387540,326812,57653862840,326812,69469946458,1500000000,1500000000
146595673009,1643232047,312132,148595673009,312132,198145198309,2000000000,2000000000
103524503696,1643175538,322975,105024503696,322975,106763353182,1500000000,1500000000
55161002970,1644403774,55608,56661002970,50808,66129194389,1500000000,1500000000
56479552192,1644396415,55644,58979552192,55644,107817491070,2500000000,2500000000
137832902815,1644441564,54296,139332902815,54296,156635607107,1500000000,1500000000
131563107283,1643241326,67634,133063107283,67634,146784674028,1500000000,1500000000
131563107283,1643241326,64044,133063107283,54444,146784674028,1500000000,1500000000
47563145146,1644374087,55584,49063145146,50784,54488412628,1500000000,1500000000
58899488567,1644406727,55608,60399488567,50808,66976973099,1500000000,1500000000
103923641488,1643160896,340623,105423641488,340623,119076746518,1500000000,1500000000
63496209195,1644377227,67646,65496209195,67646,84181518603,2000000000,2000000000
212261460528,1643212760,346422,213761460528,346422,265675949178,1500000000,1500000000
122149886186,1643236080,329292,123649886186,329292,171896979432,1500000000,1500000000
127741490178,1644427200,319761,129241490178,319761,149033455863,1500000000,1500000000
105829738283,1644423635,67658,107829738283,62858,144527238674,2000000000,2000000000
71901851606,1643183752,337468,73401851606,337468,80577685308,1500000000,1500000000
80024931458,1644403238,55632,82024931458,50832,116865684603,2000000000,2000000000
105165684406,1643162878,67634,106665684406,62834,130412565974,1500000000,1500000000
195031127281,1643229296,331193,196531127281,331193,203701382704,1500000000,1500000000
122209730350,1643230944,340055,123209730350,340055,153298294364,1000000000,1000000000
88590265751,1643188513,321674,90090265751,321674,99941109408,1500000000,1500000000
76055860585,1644411095,55668,77555860585,50868,93437573115,1500000000,1500000000
101456181866,1643203829,60862,102956181866,56062,123873495292,1500000000,1500000000
101287248703,1643197491,55717,105000000000,50917,,,
246329844928,1643224985,60850,247829844928,56050,353399778468,1500000000,1500000000
43435969846,1644409452,333155,44935969846,333155,59208971018,1500000000,1500000000
128680247762,1643169291,326109,130180247762,326109,137605710798,1500000000,1500000000
49718771877,1644399950,55668,51218771877,50868,55812171622,1500000000,1500000000
83577243751,1643196746,326856,85077243751,326856,98494532120,1500000000,1500000000
125584767578,1644425632,312320,127084767578,312320,182172676347,1500000000,1500000000
131583260452,1644447796,54296,133083260452,54296,147811008872,1500000000,1500000000
55247169887,1644405166,55584,56747169887,50784,62000000000,1500000000,1500000000
106559889519,1643194384,318078,108059889519,318078,109258091714,1500000000,1500000000
78436920070,1644416415,55620,79936920070,50820,107399751533,1500000000,1500000000
78436920070,1644416415,320479,79936920070,320479,107399751533,1500000000,1500000000
53261929151,1644415721,54332,54761929151,49532,62300873424,1500000000,1500000000
61278072072,1644367255,54296,62778072072,49496,64584106472,1500000000,1500000000
48764055643,1644393667,55644,51264055643,55644,109639567380,2500000000,2500000000
97578363561,1643195485,326123,99078363561,326123,120366974349,1500000000,1500000000
74528519874,1644434763,55632,76028519874,50832,81643344684,1500000000,1500000000
134169625492,1643185192,67634,135669625492,67634,171687537462,1500000000,1500000000
166297612256,1643231323,321634,167797612256,321634,184431635548,1500000000,1500000000
92132249862,1643175323,340045,93632249862,340045,103149854722,1500000000,1500000000
97875214147,1644427544,60850,99375214147,60850,128121194884,1500000000,1500000000
49262621479,1644397774,66718,50762621479,61918,67696665250,1500000000,1500000000
56613552467,1644413375,67622,58113552467,67622,72386641918,1500000000,1500000000
56178310309,1644415225,54332,57678310309,49532,80049027800,1500000000,1500000000
53606394850,1644385454,59934,55106394850,59934,69581999299,1500000000,1500000000
67210195705,1644403382,343235,71210195705,343235,82399506570,4000000000,4000000000
126638328261,1644443512,54308,128138328261,49508,172176277753,1500000000,1500000000
102523309904,1643167905,331987,104023309904,331987,116500000000,1500000000,1500000000
84719801226,1644416392,323545,86219801226,323545,110864158495,1500000000,1500000000
83276899598,1643191523,337542,84276899598,337542,91151496830,1000000000,1000000000
83276899598,1643191523,340075,84276899598,340075,91002956952,1000000000,1000000000
89281827402,1644430793,333678,90931827402,333678,93500000000,1650000000,1650000000
146233450251,1644440832,54332,147849415940,49532,194879773074,1615965689,1615965689
125171059846,1644426166,309090,126671059846,309090,158718645757,1500000000,1500000000
131633218453,1644442676,326067,133133218453,326067,146642554440,1500000000,1500000000
165723164943,1643237530,323601,167223164943,323601,171501221254,1500000000,1500000000
109107534108,1644448762,54308,110607534108,54308,124010901073,1500000000,1500000000
51881010903,1644405092,55668,53381010903,50868,65299249825,1500000000,1500000000
55074466050,1644393162,320358,56574466050,320358,75259318703,1500000000,1500000000
75831333403,1644397067,54332,77331333403,49532,90943171920,1500000000,1500000000
89795530360,1643174653,352735,91295530360,352735,129415824322,1500000000,1500000000
244149349318,1643224406,326123,245649349318,326123,307629830430,1500000000,1500000000
31532758655,1644398798,55668,33000000000,50868,33000000000,1500000000,1467241345
65738494032,1644373294,67622,70157600202,67622,,,
98989508775,1643201392,60850,100489508775,56050,107909912443,1500000000,1500000000
46284705428,1644398153,55644,48784705428,55644,94557016108,2500000000,2500000000
71428438795,1644433745,67622,73428438795,67622,115949691762,2000000000,2000000000
146096524706,1643208912,343847,147596524706,343847,229738158753,1500000000,1500000000
51350981725,1644408381,55608,52850981725,50808,72292644013,1500000000,1500000000
38090290829,1644401566,314907,39090290829,314907,47435979855,1000000000,1000000000
130627374207,1644425664,326097,132127374207,326097,174129754713,1500000000,1500000000
49553718453,1644398264,54332,51053718453,49532,53087200948,1500000000,1500000000
67969754581,1644375554,337464,69469754581,337464,77023965745,1500000000,1500000000
161310262507,1643173050,56516,162210453313,51716,162210453313,1500000000,900190806
70121006665,1644449654,54308,71621006665,54308,79414190205,1500000000,1500000000
135342259011,1643161552,319853,136842259011,319853,137314692187,1500000000,1500000000
81815828486,1643201463,54848,83315828486,50048,130309356740,1500000000,1500000000
109696317383,1643157234,340047,111106317383,340047,111410000000,1410000000,1410000000
109696317383,1643157234,340709,111106317383,340709,111410000000,1410000000,1410000000
75942623894,1643189176,67646,77442623894,62846,93586821804,1500000000,1500000000
144719842873,1643169960,323090,146219842873,323090,187758381689,1500000000,1500000000
90280222336,1643158155,56504,91780222336,51704,116788067284,1500000000,1500000000
50558147886,1644399828,66730,51968147886,66730,52486500590,1410000000,1410000000
83829643263,1643192685,340081,85829643263,340081,92000000000,2000000000,2000000000
109878267359,1643164621,49507,111378267359,44707,129499643082,1500000000,1500000000
63980374638,1644407935,55644,66480374638,55644,153294243130,2500000000,2500000000
91442775375,1643191166,66742,92942775375,66742,132556620507,1500000000,1500000000